"sdate","id","id_sub","id_mr","mrname","b_qty","s_qty","dec_qty","dstatus","trs_percent"
"20230518","1783","0035003300380043","5380",第一金-光復,55,0,55,1,5.10
"20230518","1783","1470","1470",台灣摩根士丹利,0,56,56,-1,5.19
"20230518","1783","8150","8150",台新證券,48,8,40,1,3.71
"20230518","1783","9268","9200",凱基-台北,113,167,54,-1,5.01
"20230518","1783","0031003000340041","1040",臺銀-臺中,20,0,20,1,1.86
"20230518","1783","9623","9600",富邦-台北,5,50,45,-1,4.17
"20230518","1783","003900410039004d","9A00",永豐金-南投,23,5,18,1,1.67
"20230518","1783","1480","1480",美商高盛,12,44,32,-1,2.97
"20230518","1783","9233","9200",凱基-長庚,16,0,16,1,1.48
"20230518","1783","0039004100390067","9A00",永豐金-內湖,0,32,32,-1,2.97
"20230518","1783","0039003800390044","9800",元大-左營,16,0,16,1,1.48
"20230518","1783","1650","1650",新加坡商瑞銀,33,64,31,-1,2.88
"20230518","1783","8711","8710",陽信-石牌,15,0,15,1,1.39
"20230518","1783","1440","1440",美林,4,29,25,-1,2.32
"20230518","1783","9322","9300",華南永昌-公誠,16,1,15,1,1.39
"20230518","1783","003900380039004e","9800",元大-內湖,3,27,24,-1,2.23
"20230518","1783","003900410039005a","9A00",永豐金-復興,15,0,15,1,1.39
"20230518","1783","9800","9800",元大證券,15,38,23,-1,2.13
"20230518","1783","6464","6460",大昌-新店,18,4,14,1,1.30
"20230518","1783","8440","8440",摩根大通,12,24,12,-1,1.11
"20230518","1783","0038003400350052","8450",康和-石牌,14,0,14,1,1.30
"20230518","1783","1560","1560",港商野村,12,23,11,-1,1.02
"20230518","1783","9200","9200",凱基,13,0,13,1,1.21
"20230518","1783","0039003100380045","9100",群益金鼎-南京,0,11,11,-1,1.02
"20230518","1783","9871","9800",元大-忠孝,13,0,13,1,1.21
"20230518","1783","0039003800300064","9800",元大-沙鹿,1,12,11,-1,1.02
"20230518","1783","5382","5380",第一金-台中,11,0,11,1,1.02
"20230518","1783","9302","9300",華南永昌-台中,1,11,10,-1,0.93
"20230518","1783","9303","9300",華南永昌-高雄,12,1,11,1,1.02
"20230518","1783","0037003700390076","7790",國票-台中,0,10,10,-1,0.93
"20230517","1783","9800","9800",元大證券,46,3,43,1,3.06
"20230517","1783","1650","1650",新加坡商瑞銀,60,230,170,-1,12.11
"20230517","1783","8150","8150",台新證券,39,1,38,1,2.71
"20230517","1783","1480","1480",美商高盛,2,156,154,-1,10.97
"20230517","1783","9614","9600",富邦-基隆,30,0,30,1,2.14
"20230517","1783","1470","1470",台灣摩根士丹利,0,127,127,-1,9.05
"20230517","1783","0039003600320047","9600",富邦-斗六,28,0,28,1,1.99
"20230517","1783","8440","8440",摩根大通,1,108,107,-1,7.62
"20230517","1783","1040","1040",臺銀,20,0,20,1,1.42
"20230517","1783","1560","1560",港商野村,0,39,39,-1,2.78
"20230517","1783","0035003900320045","5920",元富-城中,20,0,20,1,1.42
"20230517","1783","9268","9200",凱基-台北,104,126,22,-1,1.57
"20230517","1783","9233","9200",凱基-長庚,21,5,16,1,1.14
"20230517","1783","9312","9300",華南永昌-民權,0,20,20,-1,1.42
"20230517","1783","8888","8880",國泰-敦南,27,13,14,1,1.00
"20230517","1783","6164","6160",中國信託-文心,1,20,19,-1,1.35
"20230517","1783","0035003800350063","5850",統一-仁愛,14,0,14,1,1.00
"20230517","1783","0037003000300058","7000",兆豐-永和,0,11,11,-1,0.78
"20230517","1783","9254","9200",凱基-科園,22,10,12,1,0.85
"20230517","1783","9189","9100",群益金鼎-桃園,2,10,8,-1,0.57
"20230517","1783","9215","9200",凱基-高美館,11,0,11,1,0.78
"20230517","1783","0039004100390036","9A00",永豐金-博愛,4,12,8,-1,0.57
"20230517","1783","0037003700390063","7790",國票-敦北法人,10,0,10,1,0.71
"20230517","1783","1440","1440",美林,35,40,5,-1,0.36
"20230517","1783","003700370039007a","7790",國票-博愛,10,0,10,1,0.71
"20230517","1783","6110","6110",台中銀,0,5,5,-1,0.36
"20230517","1783","8159","8150",台新-台南,13,3,10,1,0.71
"20230517","1783","0037003000300044","7000",兆豐-西螺,0,5,5,-1,0.36
"20230517","1783","9275","9200",凱基-三多,10,0,10,1,0.71
"20230517","1783","8151","8150",台新-建北,0,4,4,-1,0.28
"20230519","1783","8560","8560",新光,94,7,87,1,5.50
"20230519","1783","1470","1470",台灣摩根士丹利,3,158,155,-1,9.79
"20230519","1783","0031003000340041","1040",臺銀-臺中,69,0,69,1,4.36
"20230519","1783","9268","9200",凱基-台北,42,195,153,-1,9.67
"20230519","1783","0038003400350045","8450",康和-澎湖,39,0,39,1,2.46
"20230519","1783","1650","1650",新加坡商瑞銀,28,177,149,-1,9.41
"20230519","1783","003900360031004a","9600",富邦-興業,30,0,30,1,1.90
"20230519","1783","1480","1480",美商高盛,3,146,143,-1,9.03
"20230519","1783","8150","8150",台新證券,35,9,26,1,1.64
"20230519","1783","1440","1440",美林,12,112,100,-1,6.32
"20230519","1783","0031003200360069","1260",宏遠-光隆,25,0,25,1,1.58
"20230519","1783","8440","8440",摩根大通,12,111,99,-1,6.25
"20230519","1783","9614","9600",富邦-基隆,26,2,24,1,1.52
"20230519","1783","0035003300380044","5380",第一金-忠孝,1,57,56,-1,3.54
"20230519","1783","9872","9800",元大-復北,31,10,21,1,1.33
"20230519","1783","003900380039004e","9800",元大-內湖,2,51,49,-1,3.10
"20230519","1783","003900410039005a","9A00",永豐金-復興,18,0,18,1,1.14
"20230519","1783","1111","1110",台灣企銀-台中,0,30,30,-1,1.90
"20230519","1783","9215","9200",凱基-高美館,22,6,16,1,1.01
"20230519","1783","0038003400350052","8450",康和-石牌,0,27,27,-1,1.71
"20230519","1783","0039003800310067","9800",元大-大里,17,1,16,1,1.01
"20230519","1783","1560","1560",港商野村,1,15,14,-1,0.88
"20230519","1783","0037003000300067","7000",兆豐-南門,15,0,15,1,0.95
"20230519","1783","0039004100390031","9A00",永豐金-松山,2,15,13,-1,0.82
"20230519","1783","0039003600310050","9600",富邦-和美,15,0,15,1,0.95
"20230519","1783","9303","9300",華南永昌-高雄,2,12,10,-1,0.63
"20230519","1783","1116","1110",台灣企銀-屏東,14,0,14,1,0.88
"20230519","1783","0039003800310046","9800",元大-福營,2,12,10,-1,0.63
"20230519","1783","0039004100390042","9A00",永豐金-中和,14,0,14,1,0.88
"20230519","1783","8881","8880",國泰-高雄,0,10,10,-1,0.63
"20230516","1783","8450","8450",康和,45,0,45,1,5.11
"20230516","1783","1470","1470",台灣摩根士丹利,0,124,124,-1,14.09
"20230516","1783","8560","8560",新光,45,11,34,1,3.86
"20230516","1783","1650","1650",新加坡商瑞銀,37,145,108,-1,12.27
"20230516","1783","1045","1040",臺銀-新竹,34,0,34,1,3.86
"20230516","1783","1480","1480",美商高盛,8,68,60,-1,6.82
"20230516","1783","9268","9200",凱基-台北,114,93,21,1,2.39
"20230516","1783","8440","8440",摩根大通,0,14,14,-1,1.59
"20230516","1783","9857","9800",元大-東蘆,32,12,20,1,2.27
"20230516","1783","9661","9600",富邦-新店,1,15,14,-1,1.59
"20230516","1783","5387","5380",第一金-澎湖,19,1,18,1,2.05
"20230516","1783","9868","9800",元大-文心,0,14,14,-1,1.59
"20230516","1783","1028","1020",合庫-彰化,16,0,16,1,1.82
"20230516","1783","9302","9300",華南永昌-台中,0,13,13,-1,1.48
"20230516","1783","003800380038004b","8880",國泰-板橋,12,0,12,1,1.36
"20230516","1783","9363","9300",華南永昌-彰化,0,12,12,-1,1.36
"20230516","1783","1440","1440",美林,20,8,12,1,1.36
"20230516","1783","7009","7000",兆豐-景美,2,12,10,-1,1.14
"20230516","1783","0039003100380057","9100",群益金鼎-忠孝,11,0,11,1,1.25
"20230516","1783","0037003700390058","7790",國票-中和,0,10,10,-1,1.14
"20230516","1783","9889","9800",元大-員林,10,0,10,1,1.14
"20230516","1783","7007","7000",兆豐-竹北,2,11,9,-1,1.02
"20230516","1783","0035003800350041","5850",統一-基隆,10,0,10,1,1.14
"20230516","1783","003900410039004c","9A00",永豐金-台中,0,8,8,-1,0.91
"20230516","1783","9327","9300",華南永昌-斗六,10,0,10,1,1.14
"20230516","1783","1041","1040",臺銀-鳳山,0,6,6,-1,0.68
"20230516","1783","9614","9600",富邦-基隆,10,0,10,1,1.14
"20230516","1783","5920","5920",元富,1,7,6,-1,0.68
"20230516","1783","9604","9600",富邦-陽明,8,0,8,1,0.91
"20230516","1783","9324","9300",華南永昌-岡山,0,6,6,-1,0.68
"20230515","1783","1650","1650",新加坡商瑞銀,160,99,61,1,4.36
"20230515","1783","1470","1470",台灣摩根士丹利,0,73,73,-1,5.22
"20230515","1783","8560","8560",新光,67,10,57,1,4.07
"20230515","1783","5850","5850",統一,9,69,60,-1,4.29
"20230515","1783","1480","1480",美商高盛,87,47,40,1,2.86
"20230515","1783","0035003800350055","5850",統一-南京,0,30,30,-1,2.14
"20230515","1783","1233","1230",彰銀-台中,30,0,30,1,2.14
"20230515","1783","0035003900320045","5920",元富-城中,0,30,30,-1,2.14
"20230515","1783","9614","9600",富邦-基隆,25,0,25,1,1.79
"20230515","1783","5380","5380",第一金,0,21,21,-1,1.50
"20230515","1783","5852","5850",統一-敦南,24,0,24,1,1.72
"20230515","1783","9307","9300",華南永昌-大安,17,37,20,-1,1.43
"20230515","1783","0035003800350041","5850",統一-基隆,20,0,20,1,1.43
"20230515","1783","9884","9800",元大-斗信,1,20,19,-1,1.36
"20230515","1783","9857","9800",元大-東蘆,20,2,18,1,1.29
"20230515","1783","1560","1560",港商野村,22,38,16,-1,1.14
"20230515","1783","003900410039004a","9A00",永豐金-板新,15,2,13,1,0.93
"20230515","1783","9202","9200",凱基-中港,0,15,15,-1,1.07
"20230515","1783","8888","8880",國泰-敦南,17,5,12,1,0.86
"20230515","1783","0035003900320050","5920",元富-同大,0,14,14,-1,1.00
"20230515","1783","9891","9800",元大-永和,12,0,12,1,0.86
"20230515","1783","9268","9200",凱基-台北,193,205,12,-1,0.86
"20230515","1783","003800380038004b","8880",國泰-板橋,11,0,11,1,0.79
"20230515","1783","003900410039004d","9A00",永豐金-南投,0,12,12,-1,0.86
"20230515","1783","8150","8150",台新證券,11,1,10,1,0.71
"20230515","1783","9647","9600",富邦-新竹,1,11,10,-1,0.71
"20230515","1783","9867","9800",元大-北成功,10,0,10,1,0.71
"20230515","1783","9317","9300",華南永昌-林口,0,10,10,-1,0.71
"20230515","1783","1045","1040",臺銀-新竹,10,1,9,1,0.64
"20230515","1783","9834","9800",元大-中壢,0,10,10,-1,0.71
"20230512","1783","9614","9600",富邦-基隆,50,0,50,1,3.86
"20230512","1783","1650","1650",新加坡商瑞銀,115,220,105,-1,8.11
"20230512","1783","6464","6460",大昌-新店,26,3,23,1,1.78
"20230512","1783","1470","1470",台灣摩根士丹利,0,94,94,-1,7.26
"20230512","1783","0031003000340044","1040",臺銀-金山,20,0,20,1,1.54
"20230512","1783","8440","8440",摩根大通,0,71,71,-1,5.48
"20230512","1783","8711","8710",陽信-石牌,17,0,17,1,1.31
"20230512","1783","1480","1480",美商高盛,47,100,53,-1,4.09
"20230512","1783","0038003400350045","8450",康和-澎湖,17,2,15,1,1.16
"20230512","1783","1560","1560",港商野村,31,63,32,-1,2.47
"20230512","1783","0037003000300057","7000",兆豐-城中,12,0,12,1,0.93
"20230512","1783","1028","1020",合庫-彰化,1,30,29,-1,2.24
"20230512","1783","9853","9800",元大-南屯,18,6,12,1,0.93
"20230512","1783","0039004100390041","9A00",永豐金-羅東,5,27,22,-1,1.70
"20230512","1783","9867","9800",元大-北成功,10,0,10,1,0.77
"20230512","1783","9268","9200",凱基-台北,131,152,21,-1,1.62
"20230512","1783","0031003000320045","1020",合庫-桃園,10,0,10,1,0.77
"20230512","1783","9636","9600",富邦-中壢,1,21,20,-1,1.54
"20230512","1783","0031003200360069","1260",宏遠-光隆,10,0,10,1,0.77
"20230512","1783","1022","1020",合庫-台南,0,15,15,-1,1.16
"20230512","1783","1440","1440",美林,57,47,10,1,0.77
"20230512","1783","0035003300380059","5380",第一金-中壢,0,12,12,-1,0.93
"20230512","1783","0037003700390076","7790",國票-台中,10,0,10,1,0.77
"20230512","1783","8150","8150",台新證券,5,16,11,-1,0.85
"20230512","1783","9327","9300",華南永昌-斗六,10,0,10,1,0.77
"20230512","1783","9884","9800",元大-斗信,0,10,10,-1,0.77
"20230512","1783","0039003800330057","9800",元大-大里德芳,10,0,10,1,0.77
"20230512","1783","0031003200360051","1260",宏遠-高雄,0,9,9,-1,0.69
"20230512","1783","003800380038004b","8880",國泰-板橋,11,2,9,1,0.69
"20230512","1783","5389","5380",第一金-中山,0,9,9,-1,0.69
"20230511","1783","1480","1480",美商高盛,147,67,80,1,2.81
"20230511","1783","5050","5050",大展,2,164,162,-1,5.69
"20230511","1783","1650","1650",新加坡商瑞銀,298,227,71,1,2.49
"20230511","1783","1028","1020",合庫-彰化,5,160,155,-1,5.44
"20230511","1783","1560","1560",港商野村,110,48,62,1,2.18
"20230511","1783","8440","8440",摩根大通,26,123,97,-1,3.40
"20230511","1783","9278","9200",凱基-永康,39,4,35,1,1.23
"20230511","1783","1470","1470",台灣摩根士丹利,2,49,47,-1,1.65
"20230511","1783","8150","8150",台新證券,58,29,29,1,1.02
"20230511","1783","9268","9200",凱基-台北,213,260,47,-1,1.65
"20230511","1783","0031003200360069","1260",宏遠-光隆,30,1,29,1,1.02
"20230511","1783","0039003800310056","9800",元大-民雄,0,41,41,-1,1.44
"20230511","1783","9853","9800",元大-南屯,31,2,29,1,1.02
"20230511","1783","0039003600320056","9600",富邦-復興,11,46,35,-1,1.23
"20230511","1783","8710","8710",陽信,27,0,27,1,0.95
"20230511","1783","9300","9300",華南永昌,3,35,32,-1,1.12
"20230511","1783","003900380039004e","9800",元大-內湖,28,2,26,1,0.91
"20230511","1783","6913","6910",德信-新營,6,30,24,-1,0.84
"20230511","1783","9206","9200",凱基-高雄,29,3,26,1,0.91
"20230511","1783","1040","1040",臺銀,1,21,20,-1,0.70
"20230511","1783","8846","8840",玉山-板橋,26,2,24,1,0.84
"20230511","1783","0036003100360041","6160",中國信託-中壢,10,28,18,-1,0.63
"20230511","1783","9634","9600",富邦-羅東,24,1,23,1,0.81
"20230511","1783","0037003700390050","7790",國票-九鼎,0,17,17,-1,0.60
"20230511","1783","0038003400350045","8450",康和-澎湖,23,2,21,1,0.74
"20230511","1783","0038003800380041","8880",國泰-館前,2,18,16,-1,0.56
"20230511","1783","7006","7000",兆豐-台南,20,0,20,1,0.70
"20230511","1783","003500390032007a","5920",元富-文心,0,14,14,-1,0.49
"20230511","1783","9322","9300",華南永昌-公誠,20,0,20,1,0.70
"20230511","1783","7000","7000",兆豐證券,1,15,14,-1,0.49
"20230510","1783","9268","9200",凱基-台北,217,112,105,1,4.75
"20230510","1783","8440","8440",摩根大通,0,147,147,-1,6.65
"20230510","1783","8150","8150",台新證券,71,9,62,1,2.81
"20230510","1783","1480","1480",美商高盛,41,167,126,-1,5.70
"20230510","1783","0031003000320045","1020",合庫-桃園,40,0,40,1,1.81
"20230510","1783","1650","1650",新加坡商瑞銀,164,278,114,-1,5.16
"20230510","1783","0039003800310056","9800",元大-民雄,40,0,40,1,1.81
"20230510","1783","5854","5850",統一-城中,0,99,99,-1,4.48
"20230510","1783","6464","6460",大昌-新店,32,1,31,1,1.40
"20230510","1783","1470","1470",台灣摩根士丹利,58,146,88,-1,3.98
"20230510","1783","0038003400350052","8450",康和-石牌,28,2,26,1,1.18
"20230510","1783","5850","5850",統一,3,81,78,-1,3.53
"20230510","1783","9325","9300",華南永昌-忠孝,30,5,25,1,1.13
"20230510","1783","1560","1560",港商野村,3,77,74,-1,3.35
"20230510","1783","1440","1440",美林,60,37,23,1,1.04
"20230510","1783","003900380034004b","9800",元大-館前,0,50,50,-1,2.26
"20230510","1783","9300","9300",華南永昌,24,4,20,1,0.91
"20230510","1783","1028","1020",合庫-彰化,2,31,29,-1,1.31
"20230510","1783","9366","9300",華南永昌-豐原,20,0,20,1,0.91
"20230510","1783","9834","9800",元大-中壢,6,30,24,-1,1.09
"20230510","1783","0038003100350041","8150",台新-高雄,21,3,18,1,0.81
"20230510","1783","9853","9800",元大-南屯,1,20,19,-1,0.86
"20230510","1783","0038003100350053","8150",台新-中壢,18,0,18,1,0.81
"20230510","1783","0039003800320043","9800",元大-六合,0,17,17,-1,0.77
"20230510","1783","8565","8560",新光-桃園,19,2,17,1,0.77
"20230510","1783","003800380034004a","8840",玉山-大里,0,15,15,-1,0.68
"20230510","1783","1111","1110",台灣企銀-台中,16,0,16,1,0.72
"20230510","1783","0039003600320056","9600",富邦-復興,0,15,15,-1,0.68
"20230510","1783","003900410039004b","9A00",永豐金-三重,16,0,16,1,0.72
"20230510","1783","9623","9600",富邦-台北,1,12,11,-1,0.50
"20230522","1783","9268","9200",凱基-台北,147,21,126,1,9.43
"20230522","1783","9654","9600",富邦-永和,0,221,221,-1,16.54
"20230522","1783","6160","6160",中國信託,65,0,65,1,4.87
"20230522","1783","1470","1470",台灣摩根士丹利,0,104,104,-1,7.78
"20230522","1783","003800380038004b","8880",國泰-板橋,22,0,22,1,1.65
"20230522","1783","5854","5850",統一-城中,0,60,60,-1,4.49
"20230522","1783","0037003000300068","7000",兆豐-三民,22,0,22,1,1.65
"20230522","1783","003900380039004e","9800",元大-內湖,10,50,40,-1,2.99
"20230522","1783","0031003000320045","1020",合庫-桃園,21,0,21,1,1.57
"20230522","1783","9800","9800",元大證券,0,32,32,-1,2.40
"20230522","1783","9614","9600",富邦-基隆,20,0,20,1,1.50
"20230522","1783","1480","1480",美商高盛,30,57,27,-1,2.02
"20230522","1783","0035003800350041","5850",統一-基隆,14,0,14,1,1.05
"20230522","1783","9884","9800",元大-斗信,1,20,19,-1,1.42
"20230522","1783","0031003000340044","1040",臺銀-金山,12,0,12,1,0.90
"20230522","1783","003900380033004d","9800",元大-木柵,0,18,18,-1,1.35
"20230522","1783","0039004100360039","9A00",永豐金-屏東,12,0,12,1,0.90
"20230522","1783","0039003800390053","9800",元大-鹿港,1,17,16,-1,1.20
"20230522","1783","0039004100390055","9A00",永豐金-中正,12,0,12,1,0.90
"20230522","1783","1650","1650",新加坡商瑞銀,76,92,16,-1,1.20
"20230522","1783","0036003100360041","6160",中國信託-中壢,10,0,10,1,0.75
"20230522","1783","8881","8880",國泰-高雄,2,15,13,-1,0.97
"20230522","1783","0031003200360069","1260",宏遠-光隆,10,0,10,1,0.75
"20230522","1783","9207","9200",凱基-永和,0,8,8,-1,0.60
"20230522","1783","0037003700390044","7790",國票-台南,10,0,10,1,0.75
"20230522","1783","003500390032004d","5920",元富-彰化,0,5,5,-1,0.37
"20230522","1783","9103","9100",群益金鼎-松山,10,0,10,1,0.75
"20230522","1783","0037003000300058","7000",兆豐-永和,0,5,5,-1,0.37
"20230522","1783","003900380031006d","9800",元大-前金,10,0,10,1,0.75
"20230522","1783","0038003100350042","8150",台新-台中,2,7,5,-1,0.37
"20230509","1783","9235","9200",凱基-永華,130,0,130,1,4.11
"20230509","1783","1560","1560",港商野村,63,144,81,-1,2.56
"20230509","1783","9268","9200",凱基-台北,263,154,109,1,3.45
"20230509","1783","1470","1470",台灣摩根士丹利,109,187,78,-1,2.47
"20230509","1783","0031003000320045","1020",合庫-桃園,71,0,71,1,2.24
"20230509","1783","1650","1650",新加坡商瑞銀,155,216,61,-1,1.93
"20230509","1783","1480","1480",美商高盛,136,69,67,1,2.12
"20230509","1783","8150","8150",台新證券,9,59,50,-1,1.58
"20230509","1783","9867","9800",元大-北成功,65,1,64,1,2.02
"20230509","1783","8440","8440",摩根大通,39,81,42,-1,1.33
"20230509","1783","5920","5920",元富,43,0,43,1,1.36
"20230509","1783","5850","5850",統一,8,47,39,-1,1.23
"20230509","1783","1440","1440",美林,67,30,37,1,1.17
"20230509","1783","8888","8880",國泰-敦南,51,87,36,-1,1.14
"20230509","1783","9623","9600",富邦-台北,58,21,37,1,1.17
"20230509","1783","9100","9100",群益金鼎,5,40,35,-1,1.11
"20230509","1783","0039004100390067","9A00",永豐金-內湖,32,2,30,1,0.95
"20230509","1783","0039003600310047","9600",富邦-成功,1,35,34,-1,1.07
"20230509","1783","9812","9800",元大-台中,19,0,19,1,0.60
"20230509","1783","1028","1020",合庫-彰化,7,40,33,-1,1.04
"20230509","1783","9833","9800",元大-敦化,21,2,19,1,0.60
"20230509","1783","9101","9100",群益金鼎-敦南,7,38,31,-1,0.98
"20230509","1783","9634","9600",富邦-羅東,19,1,18,1,0.57
"20230509","1783","0035003800350052","5850",統一-汐止,0,30,30,-1,0.95
"20230509","1783","8882","8880",國泰-台中,23,6,17,1,0.54
"20230509","1783","0039004100390066","9A00",永豐金-中盛,8,35,27,-1,0.85
"20230509","1783","0035003900320072","5920",元富-城東,16,0,16,1,0.51
"20230509","1783","0036003000310064","6010",(牛牛牛)亞-鑫豐,1,26,25,-1,0.79
"20230509","1783","9800","9800",元大證券,81,65,16,1,0.51
"20230509","1783","9658","9600",富邦-建國,5,30,25,-1,0.79
"20230508","1783","1028","1020",合庫-彰化,255,5,250,1,4.64
"20230508","1783","9676","9600",富邦-仁愛,118,422,304,-1,5.65
"20230508","1783","1470","1470",台灣摩根士丹利,270,81,189,1,3.51
"20230508","1783","9285","9200",凱基-中壢,2,132,130,-1,2.41
"20230508","1783","9268","9200",凱基-台北,492,408,84,1,1.56
"20230508","1783","9235","9200",凱基-永華,0,128,128,-1,2.38
"20230508","1783","5850","5850",統一,118,38,80,1,1.49
"20230508","1783","0039003100330044","9100",群益金鼎-潭子,3,81,78,-1,1.45
"20230508","1783","8150","8150",台新證券,81,11,70,1,1.30
"20230508","1783","8888","8880",國泰-敦南,55,124,69,-1,1.28
"20230508","1783","1480","1480",美商高盛,127,60,67,1,1.24
"20230508","1783","0035003300380041","5380",第一金-新興,1,53,52,-1,0.97
"20230508","1783","1560","1560",港商野村,147,91,56,1,1.04
"20230508","1783","8440","8440",摩根大通,266,318,52,-1,0.97
"20230508","1783","1440","1440",美林,97,53,44,1,0.82
"20230508","1783","0039003800390050","9800",元大-敦南,0,44,44,-1,0.82
"20230508","1783","003500390032006d","5920",元富-成功,44,7,37,1,0.69
"20230508","1783","8884","8880",國泰-台南,1,39,38,-1,0.71
"20230508","1783","1650","1650",新加坡商瑞銀,443,406,37,1,0.69
"20230508","1783","9300","9300",華南永昌,14,40,26,-1,0.48
"20230508","1783","0039003800390044","9800",元大-左營,38,1,37,1,0.69
"20230508","1783","9871","9800",元大-忠孝,4,29,25,-1,0.46
"20230508","1783","9857","9800",元大-東蘆,58,22,36,1,0.67
"20230508","1783","7790","7790",國票證券,5,28,23,-1,0.43
"20230508","1783","5854","5850",統一-城中,59,32,27,1,0.50
"20230508","1783","9238","9200",凱基-士林,0,20,20,-1,0.37
"20230508","1783","9100","9100",群益金鼎,27,1,26,1,0.48
"20230508","1783","0039003600310059","9600",富邦-屏東,11,30,19,-1,0.35
"20230508","1783","9834","9800",元大-中壢,45,20,25,1,0.46
"20230508","1783","9229","9200",凱基-中山,14,32,18,-1,0.33
"20230505","1783","1470","1470",台灣摩根士丹利,687,68,619,1,4.18
"20230505","1783","0039004100300030","9A00",永豐金證券,1118,3139,2021,-1,13.64
"20230505","1783","1650","1650",新加坡商瑞銀,906,500,406,1,2.74
"20230505","1783","9268","9200",凱基-台北,780,934,154,-1,1.04
"20230505","1783","1480","1480",美商高盛,517,141,376,1,2.54
"20230505","1783","6464","6460",大昌-新店,26,156,130,-1,0.88
"20230505","1783","5854","5850",統一-城中,157,26,131,1,0.88
"20230505","1783","8440","8440",摩根大通,320,448,128,-1,0.86
"20230505","1783","0039003800310079","9800",元大-善化,106,5,101,1,0.68
"20230505","1783","0038003400350041","8450",康和-內湖,4,76,72,-1,0.49
"20230505","1783","1440","1440",美林,156,75,81,1,0.55
"20230505","1783","9692","9600",富邦-嘉義,39,97,58,-1,0.39
"20230505","1783","003900380039004e","9800",元大-內湖,96,19,77,1,0.52
"20230505","1783","0031003200360069","1260",宏遠-光隆,5,61,56,-1,0.38
"20230505","1783","0031003000320045","1020",合庫-桃園,80,3,77,1,0.52
"20230505","1783","9852","9800",元大-永春,9,61,52,-1,0.35
"20230505","1783","0035003300380041","5380",第一金-新興,156,103,53,1,0.36
"20230505","1783","9135","9100",群益金鼎-東大,3,53,50,-1,0.34
"20230505","1783","003900380030004b","9800",元大-竹科,80,27,53,1,0.36
"20230505","1783","003900410039004a","9A00",永豐金-板新,12,60,48,-1,0.32
"20230505","1783","0039003800390050","9800",元大-敦南,50,3,47,1,0.32
"20230505","1783","1560","1560",港商野村,71,115,44,-1,0.30
"20230505","1783","9658","9600",富邦-建國,60,16,44,1,0.30
"20230505","1783","9208","9200",凱基-桃園,9,52,43,-1,0.29
"20230505","1783","9302","9300",華南永昌-台中,47,4,43,1,0.29
"20230505","1783","5382","5380",第一金-台中,1,44,43,-1,0.29
"20230505","1783","9101","9100",群益金鼎-敦南,79,39,40,1,0.27
"20230505","1783","0039003800390043","9800",元大-板橋,64,100,36,-1,0.24
"20230505","1783","003900380034004b","9800",元大-館前,57,17,40,1,0.27
"20230505","1783","9623","9600",富邦-台北,30,60,30,-1,0.20
"20230504","1783","0039004100300030","9A00",永豐金證券,2037,28,2009,1,36.15
"20230504","1783","8440","8440",摩根大通,99,265,166,-1,2.99
"20230504","1783","9676","9600",富邦-仁愛,290,19,271,1,4.88
"20230504","1783","9867","9800",元大-北成功,0,141,141,-1,2.54
"20230504","1783","9692","9600",富邦-嘉義,82,23,59,1,1.06
"20230504","1783","9898","9800",元大-新莊,1,109,108,-1,1.94
"20230504","1783","9135","9100",群益金鼎-東大,55,7,48,1,0.86
"20230504","1783","0039003600320043","9600",富邦-東門,0,92,92,-1,1.66
"20230504","1783","1440","1440",美林,129,87,42,1,0.76
"20230504","1783","8710","8710",陽信,0,77,77,-1,1.39
"20230504","1783","9852","9800",元大-永春,53,11,42,1,0.76
"20230504","1783","0039003600320056","9600",富邦-復興,0,67,67,-1,1.21
"20230504","1783","003900410039004a","9A00",永豐金-板新,51,12,39,1,0.70
"20230504","1783","0031003200360069","1260",宏遠-光隆,0,65,65,-1,1.17
"20230504","1783","0039003600310047","9600",富邦-成功,38,3,35,1,0.63
"20230504","1783","9278","9200",凱基-永康,1,61,60,-1,1.08
"20230504","1783","0039004100390067","9A00",永豐金-內湖,35,0,35,1,0.63
"20230504","1783","9105","9100",群益金鼎-高盛,2,56,54,-1,0.97
"20230504","1783","1650","1650",新加坡商瑞銀,178,144,34,1,0.61
"20230504","1783","003800380038004b","8880",國泰-板橋,3,54,51,-1,0.92
"20230504","1783","9623","9600",富邦-台北,34,6,28,1,0.50
"20230504","1783","0039003800310072","9800",元大-屏南,4,49,45,-1,0.81
"20230504","1783","0036003000310064","6010",(牛牛牛)亞-鑫豐,26,4,22,1,0.40
"20230504","1783","9856","9800",元大-花蓮,1,45,44,-1,0.79
"20230504","1783","0038003100350042","8150",台新-台中,34,14,20,1,0.36
"20230504","1783","9268","9200",凱基-台北,154,197,43,-1,0.77
"20230504","1783","9307","9300",華南永昌-大安,20,0,20,1,0.36
"20230504","1783","9322","9300",華南永昌-公誠,5,41,36,-1,0.65
"20230504","1783","0035003800350055","5850",統一-南京,38,19,19,1,0.34
"20230504","1783","9208","9200",凱基-桃園,14,50,36,-1,0.65
"20230503","1783","1650","1650",新加坡商瑞銀,180,101,79,1,3.68
"20230503","1783","8440","8440",摩根大通,21,128,107,-1,4.98
"20230503","1783","003900380039004e","9800",元大-內湖,44,5,39,1,1.82
"20230503","1783","1030","1030",土銀,1,71,70,-1,3.26
"20230503","1783","6160","6160",中國信託,32,0,32,1,1.49
"20230503","1783","003600310036004b","6160",中國信託-高雄,1,60,59,-1,2.75
"20230503","1783","0039004100390066","9A00",永豐金-中盛,39,13,26,1,1.21
"20230503","1783","0039004100390031","9A00",永豐金-松山,0,44,44,-1,2.05
"20230503","1783","6464","6460",大昌-新店,36,11,25,1,1.16
"20230503","1783","1470","1470",台灣摩根士丹利,93,131,38,-1,1.77
"20230503","1783","0038003400350045","8450",康和-澎湖,22,0,22,1,1.02
"20230503","1783","6380","6380",光和,1,26,25,-1,1.16
"20230503","1783","0038003400350041","8450",康和-內湖,20,0,20,1,0.93
"20230503","1783","9623","9600",富邦-台北,4,26,22,-1,1.02
"20230503","1783","9268","9200",凱基-台北,148,128,20,1,0.93
"20230503","1783","5850","5850",統一,2,22,20,-1,0.93
"20230503","1783","1480","1480",美商高盛,56,38,18,1,0.84
"20230503","1783","0037003000300071","7000",兆豐-內湖,0,20,20,-1,0.93
"20230503","1783","0037003000300070","7000",兆豐-復興,15,0,15,1,0.70
"20230503","1783","9852","9800",元大-永春,0,20,20,-1,0.93
"20230503","1783","6012","6010",(牛牛牛)亞-網路,15,1,14,1,0.65
"20230503","1783","5389","5380",第一金-中山,1,20,19,-1,0.88
"20230503","1783","0039004100390041","9A00",永豐金-羅東,14,0,14,1,0.65
"20230503","1783","003900380039004a","9800",元大-彰化民生,7,26,19,-1,0.88
"20230503","1783","9604","9600",富邦-陽明,13,1,12,1,0.56
"20230503","1783","003900360031004d","9600",富邦-木柵,0,15,15,-1,0.70
"20230503","1783","0035003300380045","5380",第一金-自由,11,0,11,1,0.51
"20230503","1783","0039004100390050","9A00",永豐金-竹北,0,14,14,-1,0.65
"20230503","1783","9317","9300",華南永昌-林口,11,0,11,1,0.51
"20230503","1783","0039003600320051","9600",富邦-北高雄,0,12,12,-1,0.56
"20230502","1783","8440","8440",摩根大通,347,142,205,1,4.34
"20230502","1783","003700370039006e","7790",國票-南京,1,95,94,-1,1.99
"20230502","1783","1480","1480",美商高盛,229,30,199,1,4.21
"20230502","1783","9238","9200",凱基-士林,10,100,90,-1,1.90
"20230502","1783","1470","1470",台灣摩根士丹利,200,13,187,1,3.96
"20230502","1783","8560","8560",新光,63,151,88,-1,1.86
"20230502","1783","1650","1650",新加坡商瑞銀,261,137,124,1,2.62
"20230502","1783","7790","7790",國票證券,0,75,75,-1,1.59
"20230502","1783","8888","8880",國泰-敦南,170,63,107,1,2.26
"20230502","1783","9623","9600",富邦-台北,25,93,68,-1,1.44
"20230502","1783","5850","5850",統一,107,11,96,1,2.03
"20230502","1783","9359","9300",華南永昌-中正,0,55,55,-1,1.16
"20230502","1783","1030","1030",土銀,73,2,71,1,1.50
"20230502","1783","0035003900320072","5920",元富-城東,13,66,53,-1,1.12
"20230502","1783","003600310036004b","6160",中國信託-高雄,83,20,63,1,1.33
"20230502","1783","9663","9600",富邦-敦南,6,57,51,-1,1.08
"20230502","1783","8150","8150",台新證券,82,27,55,1,1.16
"20230502","1783","0037003000300071","7000",兆豐-內湖,0,48,48,-1,1.02
"20230502","1783","0038003400350041","8450",康和-內湖,52,0,52,1,1.10
"20230502","1783","9814","9800",元大-大益,0,45,45,-1,0.95
"20230502","1783","9867","9800",元大-北成功,46,0,46,1,0.97
"20230502","1783","0039004100370039","9A00",永豐金-埔里,2,43,41,-1,0.87
"20230502","1783","1440","1440",美林,70,26,44,1,0.93
"20230502","1783","9268","9200",凱基-台北,291,327,36,-1,0.76
"20230502","1783","0039004100390031","9A00",永豐金-松山,43,1,42,1,0.89
"20230502","1783","0039003800310068","9800",元大-屏東民生,6,41,35,-1,0.74
"20230502","1783","003900380039004e","9800",元大-內湖,49,10,39,1,0.83
"20230502","1783","1040","1040",臺銀,2,35,33,-1,0.70
"20230502","1783","5050","5050",大展,81,44,37,1,0.78
"20230502","1783","9208","9200",凱基-桃園,5,35,30,-1,0.63
"20230428","1783","1650","1650",新加坡商瑞銀,224,18,206,1,9.94
"20230428","1783","9676","9600",富邦-仁愛,0,121,121,-1,5.84
"20230428","1783","8440","8440",摩根大通,158,37,121,1,5.84
"20230428","1783","9614","9600",富邦-基隆,0,35,35,-1,1.69
"20230428","1783","5050","5050",大展,120,0,120,1,5.79
"20230428","1783","0039004100390032","9A00",永豐金-萬盛,0,35,35,-1,1.69
"20230428","1783","9285","9200",凱基-中壢,102,1,101,1,4.87
"20230428","1783","5854","5850",統一-城中,9,43,34,-1,1.64
"20230428","1783","8560","8560",新光,109,9,100,1,4.82
"20230428","1783","0039004100390066","9A00",永豐金-中盛,1,32,31,-1,1.50
"20230428","1783","1440","1440",美林,62,13,49,1,2.36
"20230428","1783","0037003000300068","7000",兆豐-三民,0,30,30,-1,1.45
"20230428","1783","0039003800310072","9800",元大-屏南,42,0,42,1,2.03
"20230428","1783","1470","1470",台灣摩根士丹利,10,37,27,-1,1.30
"20230428","1783","0039003600320056","9600",富邦-復興,40,0,40,1,1.93
"20230428","1783","0039003600320047","9600",富邦-斗六,0,21,21,-1,1.01
"20230428","1783","0039003800310068","9800",元大-屏東民生,39,4,35,1,1.69
"20230428","1783","0039003800310047","9800",元大-彰化,0,21,21,-1,1.01
"20230428","1783","8150","8150",台新證券,38,4,34,1,1.64
"20230428","1783","1021","1020",合庫-台中,1,18,17,-1,0.82
"20230428","1783","9268","9200",凱基-台北,202,168,34,1,1.64
"20230428","1783","5320","5320",高橋,0,17,17,-1,0.82
"20230428","1783","0039004100390073","9A00",永豐金-彰化,24,0,24,1,1.16
"20230428","1783","0038003400350041","8450",康和-內湖,4,21,17,-1,0.82
"20230428","1783","1560","1560",港商野村,53,30,23,1,1.11
"20230428","1783","0035003800350063","5850",統一-仁愛,0,16,16,-1,0.77
"20230428","1783","003700300030006b","7000",兆豐-員林,14,0,14,1,0.68
"20230428","1783","0039003800320042","9800",元大-博愛,1,17,16,-1,0.77
"20230428","1783","9100","9100",群益金鼎,16,4,12,1,0.58
"20230428","1783","9872","9800",元大-復北,0,15,15,-1,0.72
"20230427","1783","1470","1470",台灣摩根士丹利,43,10,33,1,4.56
"20230427","1783","9268","9200",凱基-台北,57,103,46,-1,6.35
"20230427","1783","1480","1480",美商高盛,34,4,30,1,4.14
"20230427","1783","9100","9100",群益金鼎,0,23,23,-1,3.18
"20230427","1783","0038003400350041","8450",康和-內湖,25,8,17,1,2.35
"20230427","1783","1560","1560",港商野村,4,25,21,-1,2.90
"20230427","1783","003900380039004a","9800",元大-彰化民生,17,1,16,1,2.21
"20230427","1783","9215","9200",凱基-高美館,2,19,17,-1,2.35
"20230427","1783","9233","9200",凱基-長庚,15,2,13,1,1.80
"20230427","1783","1440","1440",美林,2,15,13,-1,1.80
"20230427","1783","9654","9600",富邦-永和,12,0,12,1,1.66
"20230427","1783","0037003000300070","7000",兆豐-復興,3,15,12,-1,1.66
"20230427","1783","8440","8440",摩根大通,48,37,11,1,1.52
"20230427","1783","9623","9600",富邦-台北,0,10,10,-1,1.38
"20230427","1783","0035003300380059","5380",第一金-中壢,10,0,10,1,1.38
"20230427","1783","0039004100390032","9A00",永豐金-萬盛,1,10,9,-1,1.24
"20230427","1783","9833","9800",元大-敦化,10,0,10,1,1.38
"20230427","1783","1043","1040",臺銀-民權,0,8,8,-1,1.10
"20230427","1783","0039003800340043","9800",元大-新店中正,10,0,10,1,1.38
"20230427","1783","003900320030004d","9200",凱基-宜蘭,0,7,7,-1,0.97
"20230427","1783","6464","6460",大昌-新店,10,0,10,1,1.38
"20230427","1783","5854","5850",統一-城中,0,6,6,-1,0.83
"20230427","1783","0039003800320042","9800",元大-博愛,9,2,7,1,0.97
"20230427","1783","0039003100330044","9100",群益金鼎-潭子,1,7,6,-1,0.83
"20230427","1783","0037003000300077","7000",兆豐-新莊,6,0,6,1,0.83
"20230427","1783","9315","9300",華南永昌-苑裡,1,7,6,-1,0.83
"20230427","1783","0038003100350041","8150",台新-高雄,7,1,6,1,0.83
"20230427","1783","0039003800390047","9800",元大-大同,0,6,6,-1,0.83
"20230427","1783","0031003000340041","1040",臺銀-臺中,5,0,5,1,0.69
"20230427","1783","8560","8560",新光,1,7,6,-1,0.83
"20230426","1783","9268","9200",凱基-台北,97,60,37,1,4.31
"20230426","1783","0038003400350041","8450",康和-內湖,0,30,30,-1,3.49
"20230426","1783","1650","1650",新加坡商瑞銀,100,70,30,1,3.49
"20230426","1783","8440","8440",摩根大通,21,48,27,-1,3.14
"20230426","1783","1560","1560",港商野村,29,2,27,1,3.14
"20230426","1783","9226","9200",凱基-汐止,0,20,20,-1,2.33
"20230426","1783","1470","1470",台灣摩根士丹利,28,8,20,1,2.33
"20230426","1783","9208","9200",凱基-桃園,0,18,18,-1,2.10
"20230426","1783","9800","9800",元大證券,25,9,16,1,1.86
"20230426","1783","9229","9200",凱基-中山,0,18,18,-1,2.10
"20230426","1783","1480","1480",美商高盛,25,13,12,1,1.40
"20230426","1783","0038003800380041","8880",國泰-館前,3,18,15,-1,1.75
"20230426","1783","003900380030004b","9800",元大-竹科,12,0,12,1,1.40
"20230426","1783","5269","5260",美好-台中,0,14,14,-1,1.63
"20230426","1783","003900310038004b","9100",群益金鼎-東湖,11,0,11,1,1.28
"20230426","1783","9215","9200",凱基-高美館,3,14,11,-1,1.28
"20230426","1783","0039004100390032","9A00",永豐金-萬盛,10,0,10,1,1.16
"20230426","1783","9347","9300",華南永昌-敦南,0,10,10,-1,1.16
"20230426","1783","6380","6380",光和,10,1,9,1,1.05
"20230426","1783","9386","9300",華南永昌-東昇,0,10,10,-1,1.16
"20230426","1783","0037003000300068","7000",兆豐-三民,10,1,9,1,1.05
"20230426","1783","0039004100390067","9A00",永豐金-內湖,0,10,10,-1,1.16
"20230426","1783","9100","9100",群益金鼎,9,1,8,1,0.93
"20230426","1783","003500330038006a","5380",第一金-安和,0,8,8,-1,0.93
"20230426","1783","8560","8560",新光,9,3,6,1,0.70
"20230426","1783","9306","9300",華南永昌-台南,0,8,8,-1,0.93
"20230426","1783","8881","8880",國泰-高雄,17,11,6,1,0.70
"20230426","1783","003900380031004e","9800",元大-金門,0,8,8,-1,0.93
"20230426","1783","9315","9300",華南永昌-苑裡,6,0,6,1,0.70
"20230426","1783","9852","9800",元大-永春,0,8,8,-1,0.93
"20230425","1783","1470","1470",台灣摩根士丹利,98,4,94,1,5.12
"20230425","1783","1650","1650",新加坡商瑞銀,35,146,111,-1,6.05
"20230425","1783","1560","1560",港商野村,74,15,59,1,3.22
"20230425","1783","8440","8440",摩根大通,21,101,80,-1,4.36
"20230425","1783","5854","5850",統一-城中,39,0,39,1,2.13
"20230425","1783","1480","1480",美商高盛,21,93,72,-1,3.92
"20230425","1783","0038003400350041","8450",康和-內湖,32,2,30,1,1.63
"20230425","1783","9359","9300",華南永昌-中正,6,59,53,-1,2.89
"20230425","1783","003900380033004e","9800",元大-大安,25,0,25,1,1.36
"20230425","1783","9873","9800",元大-西門,0,50,50,-1,2.72
"20230425","1783","003900410039004d","9A00",永豐金-南投,21,1,20,1,1.09
"20230425","1783","1440","1440",美林,4,45,41,-1,2.23
"20230425","1783","1021","1020",合庫-台中,18,1,17,1,0.93
"20230425","1783","5269","5260",美好-台中,0,40,40,-1,2.18
"20230425","1783","9100","9100",群益金鼎,17,1,16,1,0.87
"20230425","1783","8150","8150",台新證券,2,39,37,-1,2.02
"20230425","1783","0039003100380044","9100",群益金鼎-東門,24,8,16,1,0.87
"20230425","1783","9200","9200",凱基,0,30,30,-1,1.63
"20230425","1783","6160","6160",中國信託,15,1,14,1,0.76
"20230425","1783","9872","9800",元大-復北,0,22,22,-1,1.20
"20230425","1783","0035003900320062","5920",元富-板橋,12,0,12,1,0.65
"20230425","1783","9216","9200",凱基-信義,0,20,20,-1,1.09
"20230425","1783","9655","9600",富邦-板橋,12,0,12,1,0.65
"20230425","1783","9692","9600",富邦-嘉義,2,22,20,-1,1.09
"20230425","1783","5320","5320",高橋,13,2,11,1,0.60
"20230425","1783","9302","9300",華南永昌-台中,3,18,15,-1,0.82
"20230425","1783","6464","6460",大昌-新店,12,1,11,1,0.60
"20230425","1783","9800","9800",元大證券,22,37,15,-1,0.82
"20230425","1783","0039003800310046","9800",元大-福營,11,0,11,1,0.60
"20230425","1783","0039003800310072","9800",元大-屏南,0,15,15,-1,0.82
"20230424","1783","1470","1470",台灣摩根士丹利,374,68,306,1,10.76
"20230424","1783","8150","8150",台新證券,7,88,81,-1,2.85
"20230424","1783","1650","1650",新加坡商瑞銀,302,144,158,1,5.56
"20230424","1783","0039004100300030","9A00",永豐金證券,7,87,80,-1,2.81
"20230424","1783","1480","1480",美商高盛,152,26,126,1,4.43
"20230424","1783","9359","9300",華南永昌-中正,0,71,71,-1,2.50
"20230424","1783","9676","9600",富邦-仁愛,64,2,62,1,2.18
"20230424","1783","5854","5850",統一-城中,0,54,54,-1,1.90
"20230424","1783","1560","1560",港商野村,60,8,52,1,1.83
"20230424","1783","0037003000300057","7000",兆豐-城中,2,36,34,-1,1.20
"20230424","1783","9268","9200",凱基-台北,226,177,49,1,1.72
"20230424","1783","0039003800390056","9800",元大-北三重,0,34,34,-1,1.20
"20230424","1783","003900380039004e","9800",元大-內湖,43,3,40,1,1.41
"20230424","1783","9100","9100",群益金鼎,6,39,33,-1,1.16
"20230424","1783","8440","8440",摩根大通,113,80,33,1,1.16
"20230424","1783","9658","9600",富邦-建國,9,38,29,-1,1.02
"20230424","1783","9200","9200",凱基,30,0,30,1,1.06
"20230424","1783","9614","9600",富邦-基隆,0,20,20,-1,0.70
"20230424","1783","003700370039005a","7790",國票-安和,22,2,20,1,0.70
"20230424","1783","0039004100390055","9A00",永豐金-中正,1,21,20,-1,0.70
"20230424","1783","9800","9800",元大證券,65,45,20,1,0.70
"20230424","1783","5380","5380",第一金,1,20,19,-1,0.67
"20230424","1783","9871","9800",元大-忠孝,23,3,20,1,0.70
"20230424","1783","0039004100390059","9A00",永豐金-板盛,0,18,18,-1,0.63
"20230424","1783","0039004100390057","9A00",永豐金-市政,19,2,17,1,0.60
"20230424","1783","9872","9800",元大-復北,9,27,18,-1,0.63
"20230424","1783","0037003000300070","7000",兆豐-復興,16,0,16,1,0.56
"20230424","1783","1440","1440",美林,35,52,17,-1,0.60
"20230424","1783","0035003800350063","5850",統一-仁愛,16,1,15,1,0.53
"20230424","1783","0039004100390032","9A00",永豐金-萬盛,12,28,16,-1,0.56
"20230421","1783","0039004100300030","9A00",永豐金證券,81,4,77,1,2.32
"20230421","1783","8150","8150",台新證券,9,86,77,-1,2.32
"20230421","1783","1480","1480",美商高盛,140,64,76,1,2.29
"20230421","1783","5920","5920",元富,0,66,66,-1,1.99
"20230421","1783","7790","7790",國票證券,45,0,45,1,1.36
"20230421","1783","9268","9200",凱基-台北,194,248,54,-1,1.63
"20230421","1783","1650","1650",新加坡商瑞銀,153,109,44,1,1.33
"20230421","1783","9893","9800",元大-大天母,0,49,49,-1,1.48
"20230421","1783","9676","9600",富邦-仁愛,43,1,42,1,1.27
"20230421","1783","1440","1440",美林,54,99,45,-1,1.36
"20230421","1783","1560","1560",港商野村,91,50,41,1,1.23
"20230421","1783","5923","5920",元富-三重,0,41,41,-1,1.23
"20230421","1783","8440","8440",摩根大通,199,159,40,1,1.20
"20230421","1783","9871","9800",元大-忠孝,2,43,41,-1,1.23
"20230421","1783","1470","1470",台灣摩根士丹利,98,61,37,1,1.11
"20230421","1783","003600310036004b","6160",中國信託-高雄,2,31,29,-1,0.87
"20230421","1783","9692","9600",富邦-嘉義,31,10,21,1,0.63
"20230421","1783","0039003800390042","9800",元大-台中中港,0,25,25,-1,0.75
"20230421","1783","9614","9600",富邦-基隆,20,0,20,1,0.60
"20230421","1783","5854","5850",統一-城中,2,26,24,-1,0.72
"20230421","1783","9347","9300",華南永昌-敦南,19,0,19,1,0.57
"20230421","1783","003700300030006a","7000",兆豐-大安,0,22,22,-1,0.66
"20230421","1783","0039003800390043","9800",元大-板橋,20,1,19,1,0.57
"20230421","1783","8159","8150",台新-台南,2,23,21,-1,0.63
"20230421","1783","0039004100390032","9A00",永豐金-萬盛,25,7,18,1,0.54
"20230421","1783","003500380035004a","5850",統一-三重,6,27,21,-1,0.63
"20230421","1783","0038003100350042","8150",台新-台中,21,5,16,1,0.48
"20230421","1783","0039004100390057","9A00",永豐金-市政,13,33,20,-1,0.60
"20230421","1783","0039003100330044","9100",群益金鼎-潭子,37,22,15,1,0.45
"20230421","1783","8888","8880",國泰-敦南,31,50,19,-1,0.57
"20230420","1783","9623","9600",富邦-台北,185,66,119,1,1.33
"20230420","1783","9268","9200",凱基-台北,602,836,234,-1,2.61
"20230420","1783","9800","9800",元大證券,156,46,110,1,1.23
"20230420","1783","1470","1470",台灣摩根士丹利,133,353,220,-1,2.46
"20230420","1783","9238","9200",凱基-士林,104,4,100,1,1.12
"20230420","1783","8440","8440",摩根大通,181,395,214,-1,2.39
"20230420","1783","003700370039006e","7790",國票-南京,99,4,95,1,1.06
"20230420","1783","9239","9200",凱基-市政,1,104,103,-1,1.15
"20230420","1783","5854","5850",統一-城中,98,9,89,1,0.99
"20230420","1783","5850","5850",統一,27,126,99,-1,1.10
"20230420","1783","9867","9800",元大-北成功,100,18,82,1,0.92
"20230420","1783","8150","8150",台新證券,57,150,93,-1,1.04
"20230420","1783","0037003000300071","7000",兆豐-內湖,146,77,69,1,0.77
"20230420","1783","9672","9600",富邦-員林,1,91,90,-1,1.00
"20230420","1783","9359","9300",華南永昌-中正,66,6,60,1,0.67
"20230420","1783","0039003100330044","9100",群益金鼎-潭子,8,84,76,-1,0.85
"20230420","1783","9898","9800",元大-新莊,107,60,47,1,0.52
"20230420","1783","9256","9200",凱基-南崁,3,48,45,-1,0.50
"20230420","1783","1560","1560",港商野村,78,33,45,1,0.50
"20230420","1783","1650","1650",新加坡商瑞銀,210,254,44,-1,0.49
"20230420","1783","0039004100370039","9A00",永豐金-埔里,45,1,44,1,0.49
"20230420","1783","003900380031006a","9800",元大-士林,7,46,39,-1,0.44
"20230420","1783","003800380038004b","8880",國泰-板橋,65,24,41,1,0.46
"20230420","1783","0037003000300068","7000",兆豐-三民,9,47,38,-1,0.42
"20230420","1783","5923","5920",元富-三重,43,7,36,1,0.40
"20230420","1783","7792","7790",國票-北投,2,38,36,-1,0.40
"20230420","1783","9658","9600",富邦-建國,62,26,36,1,0.40
"20230420","1783","8887","8880",國泰-忠孝,1,31,30,-1,0.33
"20230420","1783","9663","9600",富邦-敦南,41,8,33,1,0.37
"20230420","1783","0039004100390067","9A00",永豐金-內湖,3,30,27,-1,0.30
"20230419","1783","9100","9100",群益金鼎,456,38,418,1,7.32
"20230419","1783","7790","7790",國票證券,3,102,99,-1,1.73
"20230419","1783","8440","8440",摩根大通,252,15,237,1,4.15
"20230419","1783","1560","1560",港商野村,124,201,77,-1,1.35
"20230419","1783","9359","9300",華南永昌-中正,128,10,118,1,2.07
"20230419","1783","003900380039004a","9800",元大-彰化民生,2,79,77,-1,1.35
"20230419","1783","9239","9200",凱基-市政,105,0,105,1,1.84
"20230419","1783","0039003200300046","9200",凱基-站前,11,73,62,-1,1.09
"20230419","1783","9672","9600",富邦-員林,134,41,93,1,1.63
"20230419","1783","5854","5850",統一-城中,0,45,45,-1,0.79
"20230419","1783","0037003700390075","7790",國票-長城,69,0,69,1,1.21
"20230419","1783","8563","8560",新光-新竹,3,45,42,-1,0.74
"20230419","1783","1440","1440",美林,187,119,68,1,1.19
"20230419","1783","0035003800350044","5850",統一-新台中,21,56,35,-1,0.61
"20230419","1783","0039003100330044","9100",群益金鼎-潭子,72,5,67,1,1.17
"20230419","1783","8888","8880",國泰-敦南,49,83,34,-1,0.60
"20230419","1783","5920","5920",元富,66,1,65,1,1.14
"20230419","1783","9898","9800",元大-新莊,5,38,33,-1,0.58
"20230419","1783","1650","1650",新加坡商瑞銀,168,110,58,1,1.02
"20230419","1783","9278","9200",凱基-永康,2,35,33,-1,0.58
"20230419","1783","9623","9600",富邦-台北,60,16,44,1,0.77
"20230419","1783","003700370039005a","7790",國票-安和,16,48,32,-1,0.56
"20230419","1783","0037003000300068","7000",兆豐-三民,68,32,36,1,0.63
"20230419","1783","1039","1030",土銀-士林,0,30,30,-1,0.53
"20230419","1783","9692","9600",富邦-嘉義,49,16,33,1,0.58
"20230419","1783","9614","9600",富邦-基隆,0,30,30,-1,0.53
"20230419","1783","9852","9800",元大-永春,40,8,32,1,0.56
"20230419","1783","0039003600320043","9600",富邦-東門,3,31,28,-1,0.49
"20230419","1783","0039003800390042","9800",元大-台中中港,28,2,26,1,0.46
"20230419","1783","0035003900320049","5920",元富-嘉義,2,27,25,-1,0.44
"20230418","1783","7790","7790",國票證券,100,0,100,1,8.76
"20230418","1783","1480","1480",美商高盛,9,61,52,-1,4.55
"20230418","1783","0039004100390032","9A00",永豐金-萬盛,23,0,23,1,2.01
"20230418","1783","8560","8560",新光,16,64,48,-1,4.20
"20230418","1783","0037003700390063","7790",國票-敦北法人,21,0,21,1,1.84
"20230418","1783","003700300030004c","7000",兆豐-天母,3,50,47,-1,4.12
"20230418","1783","9206","9200",凱基-高雄,19,0,19,1,1.66
"20230418","1783","1440","1440",美林,1,32,31,-1,2.71
"20230418","1783","8710","8710",陽信,17,2,15,1,1.31
"20230418","1783","1560","1560",港商野村,1,27,26,-1,2.28
"20230418","1783","1470","1470",台灣摩根士丹利,69,54,15,1,1.31
"20230418","1783","0039003200300046","9200",凱基-站前,0,20,20,-1,1.75
"20230418","1783","8888","8880",國泰-敦南,24,11,13,1,1.14
"20230418","1783","0039003100380044","9100",群益金鼎-東門,0,20,20,-1,1.75
"20230418","1783","6464","6460",大昌-新店,12,1,11,1,0.96
"20230418","1783","9871","9800",元大-忠孝,2,16,14,-1,1.23
"20230418","1783","003900410039004b","9A00",永豐金-三重,11,0,11,1,0.96
"20230418","1783","9236","9200",凱基-虎尾,0,12,12,-1,1.05
"20230418","1783","003900410039004d","9A00",永豐金-南投,11,0,11,1,0.96
"20230418","1783","9103","9100",群益金鼎-松山,0,11,11,-1,0.96
"20230418","1783","6010","6010",(牛牛牛)亞證券,10,0,10,1,0.88
"20230418","1783","1040","1040",臺銀,0,11,11,-1,0.96
"20230418","1783","0039004100390067","9A00",永豐金-內湖,9,0,9,1,0.79
"20230418","1783","8880","8880",國泰證券,0,10,10,-1,0.88
"20230418","1783","9349","9300",華南永昌-板橋,8,0,8,1,0.70
"20230418","1783","0039004100390062","9A00",永豐金-虎尾,0,10,10,-1,0.88
"20230418","1783","003500390032006d","5920",元富-成功,9,1,8,1,0.70
"20230418","1783","003900380030004b","9800",元大-竹科,0,10,10,-1,0.88
"20230418","1783","8562","8560",新光-高雄,13,5,8,1,0.70
"20230418","1783","8456","8450",康和-新竹,0,9,9,-1,0.79
"20230417","1783","5850","5850",統一,101,0,101,1,4.78
"20230417","1783","1470","1470",台灣摩根士丹利,63,144,81,-1,3.83
"20230417","1783","0039003200300046","9200",凱基-站前,101,10,91,1,4.31
"20230417","1783","0031003000340041","1040",臺銀-臺中,0,69,69,-1,3.27
"20230417","1783","8560","8560",新光,67,13,54,1,2.56
"20230417","1783","5854","5850",統一-城中,0,63,63,-1,2.98
"20230417","1783","6464","6460",大昌-新店,64,14,50,1,2.37
"20230417","1783","9867","9800",元大-北成功,0,37,37,-1,1.75
"20230417","1783","003700300030004c","7000",兆豐-天母,48,0,48,1,2.27
"20230417","1783","9309","9300",華南永昌-古亭,0,36,36,-1,1.70
"20230417","1783","9268","9200",凱基-台北,84,38,46,1,2.18
"20230417","1783","8888","8880",國泰-敦南,11,44,33,-1,1.56
"20230417","1783","003700370039005a","7790",國票-安和,39,0,39,1,1.85
"20230417","1783","0039003800330066","9800",元大-竹東,0,30,30,-1,1.42
"20230417","1783","8563","8560",新光-新竹,41,4,37,1,1.75
"20230417","1783","0037003700390063","7790",國票-敦北法人,0,21,21,-1,0.99
"20230417","1783","5269","5260",美好-台中,38,2,36,1,1.70
"20230417","1783","8152","8150",台新-新莊,1,20,19,-1,0.90
"20230417","1783","9893","9800",元大-大天母,31,0,31,1,1.47
"20230417","1783","9206","9200",凱基-高雄,0,19,19,-1,0.90
"20230417","1783","9692","9600",富邦-嘉義,30,1,29,1,1.37
"20230417","1783","0039004100300030","9A00",永豐金證券,8,25,17,-1,0.80
"20230417","1783","0039004100390067","9A00",永豐金-內湖,31,2,29,1,1.37
"20230417","1783","0039003800310067","9800",元大-大里,2,18,16,-1,0.76
"20230417","1783","8440","8440",摩根大通,72,46,26,1,1.23
"20230417","1783","8882","8880",國泰-台中,4,19,15,-1,0.71
"20230417","1783","1650","1650",新加坡商瑞銀,63,40,23,1,1.09
"20230417","1783","9831","9800",元大-四維,2,16,14,-1,0.66
"20230417","1783","0039004100390032","9A00",永豐金-萬盛,56,35,21,1,0.99
"20230417","1783","003900380039004a","9800",元大-彰化民生,0,13,13,-1,0.62
"20230523","1783","0039003600310043","9600",富邦-南京,37,0,37,1,2.17
"20230523","1783","003900380039004e","9800",元大-內湖,8,113,105,-1,6.16
"20230523","1783","003900380031004c","9800",元大-莒光,26,0,26,1,1.53
"20230523","1783","0031003000340041","1040",臺銀-臺中,3,76,73,-1,4.28
"20230523","1783","0039003100330059","9100",群益金鼎-館前,25,0,25,1,1.47
"20230523","1783","9268","9200",凱基-台北,90,139,49,-1,2.88
"20230523","1783","1560","1560",港商野村,21,0,21,1,1.23
"20230523","1783","8440","8440",摩根大通,28,71,43,-1,2.52
"20230523","1783","8888","8880",國泰-敦南,25,5,20,1,1.17
"20230523","1783","8150","8150",台新證券,2,44,42,-1,2.46
"20230523","1783","5920","5920",元富,22,2,20,1,1.17
"20230523","1783","9872","9800",元大-復北,1,33,32,-1,1.88
"20230523","1783","8157","8150",台新-左楠,18,2,16,1,0.94
"20230523","1783","5850","5850",統一,14,40,26,-1,1.53
"20230523","1783","9300","9300",華南永昌,20,6,14,1,0.82
"20230523","1783","1480","1480",美商高盛,22,47,25,-1,1.47
"20230523","1783","6110","6110",台中銀,15,2,13,1,0.76
"20230523","1783","9800","9800",元大證券,25,47,22,-1,1.29
"20230523","1783","9208","9200",凱基-桃園,21,8,13,1,0.76
"20230523","1783","0039003800390044","9800",元大-左營,1,22,21,-1,1.23
"20230523","1783","003900380039006b","9800",元大-古亭,14,1,13,1,0.76
"20230523","1783","0039004100370039","9A00",永豐金-埔里,0,20,20,-1,1.17
"20230523","1783","0031003000340044","1040",臺銀-金山,12,0,12,1,0.70
"20230523","1783","0039003800330057","9800",元大-大里德芳,1,20,19,-1,1.12
"20230523","1783","8560","8560",新光,17,6,11,1,0.65
"20230523","1783","8881","8880",國泰-高雄,0,15,15,-1,0.88
"20230523","1783","0038003100350042","8150",台新-台中,12,1,11,1,0.65
"20230523","1783","0039003200320043","9200",凱基-屏東,0,13,13,-1,0.76
"20230406","1783","8150","8150",台新證券,108,40,68,1,5.41
"20230406","1783","9800","9800",元大證券,0,39,39,-1,3.11
"20230406","1783","1560","1560",港商野村,57,0,57,1,4.54
"20230406","1783","9856","9800",元大-花蓮,1,31,30,-1,2.39
"20230406","1783","9659","9600",富邦-高雄,30,0,30,1,2.39
"20230406","1783","0039004100380046","9A00",永豐金-敦南,0,20,20,-1,1.59
"20230406","1783","8440","8440",摩根大通,42,16,26,1,2.07
"20230406","1783","003900380033006a","9800",元大-仁愛,0,18,18,-1,1.43
"20230406","1783","0039004100390072","9A00",永豐金-北高雄,30,5,25,1,1.99
"20230406","1783","9863","9800",元大-和平,0,17,17,-1,1.35
"20230406","1783","1440","1440",美林,23,0,23,1,1.83
"20230406","1783","1028","1020",合庫-彰化,0,15,15,-1,1.19
"20230406","1783","5859","5850",統一-屏東,20,0,20,1,1.59
"20230406","1783","0035003900320065","5920",元富-古亭,0,12,12,-1,0.96
"20230406","1783","1470","1470",台灣摩根士丹利,127,109,18,1,1.43
"20230406","1783","9217","9200",凱基-松山,4,16,12,-1,0.96
"20230406","1783","0039003800300064","9800",元大-沙鹿,36,20,16,1,1.27
"20230406","1783","5854","5850",統一-城中,4,15,11,-1,0.88
"20230406","1783","9215","9200",凱基-高美館,13,0,13,1,1.04
"20230406","1783","0035003900320075","5920",元富-世貿,0,11,11,-1,0.88
"20230406","1783","9831","9800",元大-四維,13,0,13,1,1.04
"20230406","1783","0031003100310045","1110",台灣企銀-桃園,0,10,10,-1,0.80
"20230406","1783","5382","5380",第一金-台中,12,0,12,1,0.96
"20230406","1783","0039004100390052","9A00",永豐金-信義,0,10,10,-1,0.80
"20230406","1783","003700300030005a","7000",兆豐-高雄,13,1,12,1,0.96
"20230406","1783","9237","9200",凱基-敦北,0,9,9,-1,0.72
"20230406","1783","0039003800310072","9800",元大-屏南,12,0,12,1,0.96
"20230406","1783","8843","8840",玉山-高雄,2,10,8,-1,0.64
"20230407","1783","5382","5380",第一金-台中,19,0,19,1,4.08
"20230407","1783","1480","1480",美商高盛,0,60,60,-1,12.88
"20230407","1783","9831","9800",元大-四維,17,2,15,1,3.22
"20230407","1783","8440","8440",摩根大通,0,25,25,-1,5.36
"20230407","1783","003800380038004b","8880",國泰-板橋,13,0,13,1,2.79
"20230407","1783","0039003800300064","9800",元大-沙鹿,1,17,16,-1,3.43
"20230407","1783","9800","9800",元大證券,16,5,11,1,2.36
"20230407","1783","1650","1650",新加坡商瑞銀,7,21,14,-1,3.00
"20230407","1783","0031003000340041","1040",臺銀-臺中,10,0,10,1,2.15
"20230407","1783","0039003800310067","9800",元大-大里,2,14,12,-1,2.58
"20230407","1783","003900360032004b","9600",富邦-中和,10,0,10,1,2.15
"20230407","1783","0038003100350042","8150",台新-台中,0,10,10,-1,2.15
"20230407","1783","0039003800310068","9800",元大-屏東民生,10,0,10,1,2.15
"20230407","1783","1560","1560",港商野村,0,9,9,-1,1.93
"20230407","1783","8888","8880",國泰-敦南,11,2,9,1,1.93
"20230407","1783","1470","1470",台灣摩根士丹利,3,12,9,-1,1.93
"20230407","1783","1440","1440",美林,10,1,9,1,1.93
"20230407","1783","8560","8560",新光,3,10,7,-1,1.50
"20230407","1783","0031003000330046","1030",土銀-南港,20,12,8,1,1.72
"20230407","1783","9888","9800",元大-鑫永和,0,5,5,-1,1.07
"20230407","1783","003900380036004b","9800",元大-基隆孝二,8,0,8,1,1.72
"20230407","1783","9898","9800",元大-新莊,0,5,5,-1,1.07
"20230407","1783","003500390032004c","5920",元富-中壢,5,0,5,1,1.07
"20230407","1783","9328","9300",華南永昌-潮州,0,5,5,-1,1.07
"20230407","1783","8152","8150",台新-新莊,5,0,5,1,1.07
"20230407","1783","003700370039004a","7790",國票-北高雄,0,5,5,-1,1.07
"20230407","1783","0039003200300046","9200",凱基-站前,5,0,5,1,1.07
"20230407","1783","0038003800380041","8880",國泰-館前,1,6,5,-1,1.07
"20230410","1783","9268","9200",凱基-台北,86,66,20,1,2.61
"20230410","1783","5268","5260",美好-台南,0,31,31,-1,4.04
"20230410","1783","5921","5920",元富-高雄,20,0,20,1,2.61
"20230410","1783","003900380031004d","9800",元大-苗栗,0,25,25,-1,3.26
"20230410","1783","0039003800330066","9800",元大-竹東,20,0,20,1,2.61
"20230410","1783","1470","1470",台灣摩根士丹利,7,30,23,-1,3.00
"20230410","1783","8150","8150",台新證券,22,3,19,1,2.48
"20230410","1783","5859","5850",統一-屏東,0,20,20,-1,2.61
"20230410","1783","6380","6380",光和,17,0,17,1,2.22
"20230410","1783","003900380039005a","9800",元大-小港,1,15,14,-1,1.83
"20230410","1783","9256","9200",凱基-南崁,15,0,15,1,1.96
"20230410","1783","8888","8880",國泰-敦南,4,17,13,-1,1.69
"20230410","1783","0039004100300030","9A00",永豐金證券,11,0,11,1,1.43
"20230410","1783","1480","1480",美商高盛,3,15,12,-1,1.56
"20230410","1783","0037003000300049","7000",兆豐-北高雄,11,0,11,1,1.43
"20230410","1783","8440","8440",摩根大通,3,15,12,-1,1.56
"20230410","1783","0031003200360044","1260",宏遠-台南,10,0,10,1,1.30
"20230410","1783","5603","5600",永興-台中,0,10,10,-1,1.30
"20230410","1783","8381","8380",安泰-大發,10,0,10,1,1.30
"20230410","1783","9655","9600",富邦-板橋,0,8,8,-1,1.04
"20230410","1783","9853","9800",元大-南屯,10,0,10,1,1.30
"20230410","1783","1650","1650",新加坡商瑞銀,22,29,7,-1,0.91
"20230410","1783","003900380036004b","9800",元大-基隆孝二,10,0,10,1,1.30
"20230410","1783","003900360032004a","9600",富邦-三峽,0,7,7,-1,0.91
"20230410","1783","003900380039004a","9800",元大-彰化民生,10,0,10,1,1.30
"20230410","1783","9856","9800",元大-花蓮,11,17,6,-1,0.78
"20230410","1783","0031003000340041","1040",臺銀-臺中,10,0,10,1,1.30
"20230410","1783","0039003800390041","9800",元大-北投,2,8,6,-1,0.78
"20230411","1783","8560","8560",新光,25,5,20,1,3.10
"20230411","1783","9268","9200",凱基-台北,10,52,42,-1,6.50
"20230411","1783","6380","6380",光和,17,0,17,1,2.63
"20230411","1783","1650","1650",新加坡商瑞銀,7,48,41,-1,6.35
"20230411","1783","8150","8150",台新證券,18,3,15,1,2.32
"20230411","1783","0039003600320050","9600",富邦-頭份,0,40,40,-1,6.19
"20230411","1783","003900410039004d","9A00",永豐金-南投,14,0,14,1,2.17
"20230411","1783","8440","8440",摩根大通,5,25,20,-1,3.10
"20230411","1783","9217","9200",凱基-松山,13,1,12,1,1.86
"20230411","1783","1440","1440",美林,17,36,19,-1,2.94
"20230411","1783","9339","9300",華南永昌-竹北,11,0,11,1,1.70
"20230411","1783","9209","9200",凱基-岡山,0,14,14,-1,2.17
"20230411","1783","0031003000340041","1040",臺銀-臺中,10,0,10,1,1.55
"20230411","1783","9856","9800",元大-花蓮,0,13,13,-1,2.01
"20230411","1783","0031003000330046","1030",土銀-南港,46,36,10,1,1.55
"20230411","1783","1480","1480",美商高盛,7,19,12,-1,1.86
"20230411","1783","0037003000300063","7000",兆豐-民生,10,0,10,1,1.55
"20230411","1783","9207","9200",凱基-永和,0,11,11,-1,1.70
"20230411","1783","9103","9100",群益金鼎-松山,10,0,10,1,1.55
"20230411","1783","0037003000300055","7000",兆豐-桃鶯,0,10,10,-1,1.55
"20230411","1783","0039003100380057","9100",群益金鼎-忠孝,10,0,10,1,1.55
"20230411","1783","0039003800310068","9800",元大-屏東民生,0,10,10,-1,1.55
"20230411","1783","9831","9800",元大-四維,10,0,10,1,1.55
"20230411","1783","7001","7000",兆豐-嘉義,1,9,8,-1,1.24
"20230411","1783","0039003600320047","9600",富邦-斗六,10,1,9,1,1.39
"20230411","1783","1470","1470",台灣摩根士丹利,5,11,6,-1,0.93
"20230411","1783","003900380036004b","9800",元大-基隆孝二,9,0,9,1,1.39
"20230411","1783","5854","5850",統一-城中,0,5,5,-1,0.77
"20230412","1783","9268","9200",凱基-台北,102,55,47,1,4.83
"20230412","1783","0039003800330066","9800",元大-竹東,0,25,25,-1,2.57
"20230412","1783","9692","9600",富邦-嘉義,35,0,35,1,3.60
"20230412","1783","003900410039004d","9A00",永豐金-南投,0,21,21,-1,2.16
"20230412","1783","1560","1560",港商野村,28,2,26,1,2.67
"20230412","1783","003800380038004b","8880",國泰-板橋,1,20,19,-1,1.95
"20230412","1783","9339","9300",華南永昌-竹北,19,0,19,1,1.95
"20230412","1783","0039003100380067","9100",群益金鼎-大甲,0,15,15,-1,1.54
"20230412","1783","0035003800350052","5850",統一-汐止,17,0,17,1,1.75
"20230412","1783","1025","1020",合庫-基隆,0,12,12,-1,1.23
"20230412","1783","6160","6160",中國信託,36,19,17,1,1.75
"20230412","1783","0039003100330049","9100",群益金鼎-萬華,1,13,12,-1,1.23
"20230412","1783","8151","8150",台新-建北,14,0,14,1,1.44
"20230412","1783","003900380039006b","9800",元大-古亭,0,12,12,-1,1.23
"20230412","1783","1480","1480",美商高盛,23,10,13,1,1.34
"20230412","1783","0035003300380045","5380",第一金-自由,0,11,11,-1,1.13
"20230412","1783","1650","1650",新加坡商瑞銀,39,27,12,1,1.23
"20230412","1783","003500390032006e","5920",元富-西松,1,11,10,-1,1.03
"20230412","1783","8440","8440",摩根大通,28,16,12,1,1.23
"20230412","1783","9103","9100",群益金鼎-松山,0,10,10,-1,1.03
"20230412","1783","1020","1020",合庫證券,11,0,11,1,1.13
"20230412","1783","6012","6010",(牛牛牛)亞-網路,0,10,10,-1,1.03
"20230412","1783","0039004100390078","9A00",永豐金-桃園,11,0,11,1,1.13
"20230412","1783","0039004100300030","9A00",永豐金證券,0,10,10,-1,1.03
"20230412","1783","0037003700390063","7790",國票-敦北法人,10,0,10,1,1.03
"20230412","1783","0037003000300049","7000",兆豐-北高雄,2,10,8,-1,0.82
"20230412","1783","0031003000320047","1020",合庫-三重,10,0,10,1,1.03
"20230412","1783","8152","8150",台新-新莊,0,7,7,-1,0.72
"20230413","1783","8440","8440",摩根大通,59,8,51,1,6.09
"20230413","1783","1480","1480",美商高盛,5,38,33,-1,3.94
"20230413","1783","0039004100390055","9A00",永豐金-中正,31,1,30,1,3.58
"20230413","1783","003500390032004c","5920",元富-中壢,3,32,29,-1,3.46
"20230413","1783","1650","1650",新加坡商瑞銀,35,10,25,1,2.98
"20230413","1783","1470","1470",台灣摩根士丹利,23,46,23,-1,2.74
"20230413","1783","0039003800330066","9800",元大-竹東,25,0,25,1,2.98
"20230413","1783","0039003600360046","9600",富邦-左營,0,18,18,-1,2.15
"20230413","1783","0031003000330046","1030",土銀-南港,20,0,20,1,2.39
"20230413","1783","0039004100300030","9A00",永豐金證券,3,20,17,-1,2.03
"20230413","1783","0039003800300064","9800",元大-沙鹿,12,0,12,1,1.43
"20230413","1783","9884","9800",元大-斗信,0,16,16,-1,1.91
"20230413","1783","9268","9200",凱基-台北,69,58,11,1,1.31
"20230413","1783","5854","5850",統一-城中,0,15,15,-1,1.79
"20230413","1783","1116","1110",台灣企銀-屏東,11,0,11,1,1.31
"20230413","1783","9209","9200",凱基-岡山,0,15,15,-1,1.79
"20230413","1783","0035003800350044","5850",統一-新台中,10,0,10,1,1.19
"20230413","1783","9692","9600",富邦-嘉義,0,15,15,-1,1.79
"20230413","1783","9328","9300",華南永昌-潮州,10,1,9,1,1.07
"20230413","1783","1560","1560",港商野村,0,11,11,-1,1.31
"20230413","1783","0037003700390063","7790",國票-敦北法人,16,8,8,1,0.95
"20230413","1783","0039003100380067","9100",群益金鼎-大甲,0,11,11,-1,1.31
"20230413","1783","0039003800310068","9800",元大-屏東民生,8,0,8,1,0.95
"20230413","1783","0038003100350041","8150",台新-高雄,1,11,10,-1,1.19
"20230413","1783","003900380031004e","9800",元大-金門,8,0,8,1,0.95
"20230413","1783","6161","6160",中國信託-三重,0,9,9,-1,1.07
"20230413","1783","0039003800310067","9800",元大-大里,7,0,7,1,0.84
"20230413","1783","8561","8560",新光-台中,0,7,7,-1,0.84
"20230414","1783","1260","1260",宏遠證券,25,0,25,1,3.52
"20230414","1783","1480","1480",美商高盛,9,38,29,-1,4.08
"20230414","1783","1560","1560",港商野村,29,5,24,1,3.38
"20230414","1783","9268","9200",凱基-台北,18,47,29,-1,4.08
"20230414","1783","9801","9800",元大-城東,20,0,20,1,2.82
"20230414","1783","9655","9600",富邦-板橋,0,20,20,-1,2.82
"20230414","1783","8152","8150",台新-新莊,13,0,13,1,1.83
"20230414","1783","0039004100300030","9A00",永豐金證券,1,20,19,-1,2.68
"20230414","1783","9815","9800",元大-大灣,11,0,11,1,1.55
"20230414","1783","9692","9600",富邦-嘉義,0,19,19,-1,2.68
"20230414","1783","003900410039004d","9A00",永豐金-南投,11,0,11,1,1.55
"20230414","1783","9834","9800",元大-中壢,0,15,15,-1,2.11
"20230414","1783","5321","5320",高橋-龍潭,10,0,10,1,1.41
"20230414","1783","0031003000320047","1020",合庫-三重,0,10,10,-1,1.41
"20230414","1783","9103","9100",群益金鼎-松山,10,0,10,1,1.41
"20230414","1783","0039003200300046","9200",凱基-站前,0,10,10,-1,1.41
"20230414","1783","9272","9200",凱基-竹科,10,0,10,1,1.41
"20230414","1783","0039004100390042","9A00",永豐金-中和,0,10,10,-1,1.41
"20230414","1783","8888","8880",國泰-敦南,9,2,7,1,0.99
"20230414","1783","003500390032004c","5920",元富-中壢,0,9,9,-1,1.27
"20230414","1783","8840","8840",玉山證券,8,1,7,1,0.99
"20230414","1783","003500390032006e","5920",元富-西松,1,9,8,-1,1.13
"20230414","1783","0039003800310067","9800",元大-大里,6,0,6,1,0.85
"20230414","1783","9875","9800",元大-土城永寧,0,8,8,-1,1.13
"20230414","1783","6461","6460",大昌-樹林,6,0,6,1,0.85
"20230414","1783","6464","6460",大昌-新店,14,21,7,-1,0.99
"20230414","1783","0039004100390078","9A00",永豐金-桃園,6,0,6,1,0.85
"20230414","1783","0037003000300063","7000",兆豐-民生,0,7,7,-1,0.99
"20230301","1783","9100","9100",群益金鼎,150,2,148,1,5.14
"20230301","1783","9216","9200",凱基-信義,1,141,140,-1,4.87
"20230301","1783","9268","9200",凱基-台北,200,85,115,1,4.00
"20230301","1783","6160","6160",中國信託,3,90,87,-1,3.02
"20230301","1783","1480","1480",美商高盛,92,8,84,1,2.92
"20230301","1783","9272","9200",凱基-竹科,1,59,58,-1,2.02
"20230301","1783","1440","1440",美林,91,8,83,1,2.88
"20230301","1783","5854","5850",統一-城中,0,49,49,-1,1.70
"20230301","1783","5920","5920",元富,64,1,63,1,2.19
"20230301","1783","0037003700390063","7790",國票-敦北法人,1,45,44,-1,1.53
"20230301","1783","0031003000340041","1040",臺銀-臺中,63,4,59,1,2.05
"20230301","1783","8561","8560",新光-台中,4,44,40,-1,1.39
"20230301","1783","0035003900320061","5920",元富-松德,53,0,53,1,1.84
"20230301","1783","0037003000300069","7000",兆豐-松德,4,35,31,-1,1.08
"20230301","1783","8560","8560",新光,81,30,51,1,1.77
"20230301","1783","003900410039004d","9A00",永豐金-南投,0,29,29,-1,1.01
"20230301","1783","8440","8440",摩根大通,64,16,48,1,1.67
"20230301","1783","9300","9300",華南永昌,1,28,27,-1,0.94
"20230301","1783","1650","1650",新加坡商瑞銀,80,36,44,1,1.53
"20230301","1783","9636","9600",富邦-中壢,1,28,27,-1,0.94
"20230301","1783","0039004100390047","9A00",永豐金-天母,34,3,31,1,1.08
"20230301","1783","5858","5850",統一-嘉義,1,27,26,-1,0.90
"20230301","1783","0038003800340045","8840",玉山-城中,31,1,30,1,1.04
"20230301","1783","8882","8880",國泰-台中,9,31,22,-1,0.76
"20230301","1783","0039003100380046","9100",群益金鼎-新店,30,0,30,1,1.04
"20230301","1783","8150","8150",台新證券,5,27,22,-1,0.76
"20230301","1783","003900380039004e","9800",元大-內湖,28,0,28,1,0.97
"20230301","1783","9324","9300",華南永昌-岡山,0,21,21,-1,0.73
"20230302","1783","1440","1440",美林,134,18,116,1,3.35
"20230302","1783","9200","9200",凱基,7,136,129,-1,3.72
"20230302","1783","1560","1560",港商野村,133,29,104,1,3.00
"20230302","1783","0039004100390066","9A00",永豐金-中盛,3,46,43,-1,1.24
"20230302","1783","1480","1480",美商高盛,119,28,91,1,2.63
"20230302","1783","8843","8840",玉山-高雄,1,37,36,-1,1.04
"20230302","1783","1650","1650",新加坡商瑞銀,155,70,85,1,2.45
"20230302","1783","0037003700390063","7790",國票-敦北法人,1,33,32,-1,0.92
"20230302","1783","8440","8440",摩根大通,70,18,52,1,1.50
"20230302","1783","6451","6450",永全-南崁,0,31,31,-1,0.89
"20230302","1783","9800","9800",元大證券,88,36,52,1,1.50
"20230302","1783","8710","8710",陽信,0,30,30,-1,0.87
"20230302","1783","5925","5920",元富-台中,50,0,50,1,1.44
"20230302","1783","0039003600320043","9600",富邦-東門,1,25,24,-1,0.69
"20230302","1783","0039004100390032","9A00",永豐金-萬盛,57,12,45,1,1.30
"20230302","1783","8882","8880",國泰-台中,18,41,23,-1,0.66
"20230302","1783","9268","9200",凱基-台北,114,75,39,1,1.13
"20230302","1783","0031003100310045","1110",台灣企銀-桃園,0,23,23,-1,0.66
"20230302","1783","003900310033004e","9100",群益金鼎-土城,28,0,28,1,0.81
"20230302","1783","5854","5850",統一-城中,21,43,22,-1,0.63
"20230302","1783","9661","9600",富邦-新店,31,6,25,1,0.72
"20230302","1783","0039003600310048","9600",富邦-新板,1,22,21,-1,0.61
"20230302","1783","0039003200300046","9200",凱基-站前,21,0,21,1,0.61
"20230302","1783","003800380038004b","8880",國泰-板橋,4,23,19,-1,0.55
"20230302","1783","0037003700390075","7790",國票-長城,20,0,20,1,0.58
"20230302","1783","1117","1110",台灣企銀-竹北,0,18,18,-1,0.52
"20230302","1783","1031","1030",土銀-台中,20,1,19,1,0.55
"20230302","1783","003900380031004e","9800",元大-金門,0,18,18,-1,0.52
"20230303","1783","9333","9300",華南永昌-長虹,193,9,184,1,3.72
"20230303","1783","003900360031004b","9600",富邦-七賢,4,106,102,-1,2.06
"20230303","1783","0039004100300030","9A00",永豐金證券,172,6,166,1,3.36
"20230303","1783","9300","9300",華南永昌,1,97,96,-1,1.94
"20230303","1783","9268","9200",凱基-台北,347,209,138,1,2.79
"20230303","1783","0037003000300069","7000",兆豐-松德,35,104,69,-1,1.40
"20230303","1783","003900380039004e","9800",元大-內湖,105,7,98,1,1.98
"20230303","1783","8560","8560",新光,60,118,58,-1,1.17
"20230303","1783","9200","9200",凱基,86,0,86,1,1.74
"20230303","1783","9661","9600",富邦-新店,6,43,37,-1,0.75
"20230303","1783","7000","7000",兆豐證券,90,11,79,1,1.60
"20230303","1783","5854","5850",統一-城中,51,88,37,-1,0.75
"20230303","1783","8880","8880",國泰證券,54,6,48,1,0.97
"20230303","1783","0039003800390064","9800",元大-北屯,0,32,32,-1,0.65
"20230303","1783","1260","1260",宏遠證券,58,10,48,1,0.97
"20230303","1783","0039003800330057","9800",元大-大里德芳,19,50,31,-1,0.63
"20230303","1783","9227","9200",凱基-城中,62,14,48,1,0.97
"20230303","1783","0037003700390075","7790",國票-長城,1,30,29,-1,0.59
"20230303","1783","8561","8560",新光-台中,58,25,33,1,0.67
"20230303","1783","0035003900320072","5920",元富-城東,7,34,27,-1,0.55
"20230303","1783","1440","1440",美林,36,5,31,1,0.63
"20230303","1783","0039003800310053","9800",元大-崇德,3,28,25,-1,0.51
"20230303","1783","1470","1470",台灣摩根士丹利,60,44,16,1,0.32
"20230303","1783","5853","5850",統一-中壢,11,36,25,-1,0.51
"20230303","1783","9101","9100",群益金鼎-敦南,30,16,14,1,0.28
"20230303","1783","1020","1020",合庫證券,2,24,22,-1,0.44
"20230303","1783","0038003400350041","8450",康和-內湖,18,5,13,1,0.26
"20230303","1783","9206","9200",凱基-高雄,0,22,22,-1,0.44
"20230306","1783","0039004100390066","9A00",永豐金-中盛,180,105,75,1,1.00
"20230306","1783","1470","1470",台灣摩根士丹利,80,443,363,-1,4.82
"20230306","1783","8880","8880",國泰證券,92,21,71,1,0.94
"20230306","1783","9268","9200",凱基-台北,205,460,255,-1,3.39
"20230306","1783","8888","8880",國泰-敦南,151,90,61,1,0.81
"20230306","1783","8451","8450",康和-延平,4,250,246,-1,3.27
"20230306","1783","5850","5850",統一,52,0,52,1,0.69
"20230306","1783","7000","7000",兆豐證券,20,215,195,-1,2.59
"20230306","1783","0037003000300067","7000",兆豐-南門,53,2,51,1,0.68
"20230306","1783","1480","1480",美商高盛,21,203,182,-1,2.42
"20230306","1783","003500390032007a","5920",元富-文心,48,4,44,1,0.58
"20230306","1783","1650","1650",新加坡商瑞銀,147,325,178,-1,2.36
"20230306","1783","0039004100390055","9A00",永豐金-中正,56,13,43,1,0.57
"20230306","1783","1440","1440",美林,8,151,143,-1,1.90
"20230306","1783","0031003000340041","1040",臺銀-臺中,63,23,40,1,0.53
"20230306","1783","9676","9600",富邦-仁愛,9,112,103,-1,1.37
"20230306","1783","8882","8880",國泰-台中,41,4,37,1,0.49
"20230306","1783","0031003000330046","1030",土銀-南港,5,102,97,-1,1.29
"20230306","1783","9103","9100",群益金鼎-松山,34,0,34,1,0.45
"20230306","1783","1560","1560",港商野村,0,90,90,-1,1.19
"20230306","1783","9654","9600",富邦-永和,36,2,34,1,0.45
"20230306","1783","5920","5920",元富,3,64,61,-1,0.81
"20230306","1783","9636","9600",富邦-中壢,35,8,27,1,0.36
"20230306","1783","9604","9600",富邦-陽明,17,76,59,-1,0.78
"20230306","1783","9600","9600",富邦證券,27,0,27,1,0.36
"20230306","1783","003900380030004b","9800",元大-竹科,11,69,58,-1,0.77
"20230306","1783","003900380039004e","9800",元大-內湖,29,3,26,1,0.35
"20230306","1783","6160","6160",中國信託,20,74,54,-1,0.72
"20230307","1783","0031003000330046","1030",土銀-南港,60,0,60,1,1.72
"20230307","1783","0035003900320072","5920",元富-城東,8,173,165,-1,4.74
"20230307","1783","8880","8880",國泰證券,40,3,37,1,1.06
"20230307","1783","9200","9200",凱基,0,157,157,-1,4.51
"20230307","1783","003500390032007a","5920",元富-文心,33,2,31,1,0.89
"20230307","1783","1650","1650",新加坡商瑞銀,76,196,120,-1,3.45
"20230307","1783","0039003800300064","9800",元大-沙鹿,30,3,27,1,0.78
"20230307","1783","003900320030004e","9200",凱基-湖口,3,66,63,-1,1.81
"20230307","1783","9206","9200",凱基-高雄,29,2,27,1,0.78
"20230307","1783","6160","6160",中國信託,8,61,53,-1,1.52
"20230307","1783","8887","8880",國泰-忠孝,66,40,26,1,0.75
"20230307","1783","1470","1470",台灣摩根士丹利,115,166,51,-1,1.47
"20230307","1783","0039003800390059","9800",元大-基隆,25,3,22,1,0.63
"20230307","1783","0038003800380041","8880",國泰-館前,7,51,44,-1,1.26
"20230307","1783","9800","9800",元大證券,68,49,19,1,0.55
"20230307","1783","003900380039006b","9800",元大-古亭,0,40,40,-1,1.15
"20230307","1783","6380","6380",光和,17,0,17,1,0.49
"20230307","1783","1480","1480",美商高盛,35,72,37,-1,1.06
"20230307","1783","003900310038004d","9100",群益金鼎-嘉義,16,0,16,1,0.46
"20230307","1783","1440","1440",美林,67,102,35,-1,1.01
"20230307","1783","003900360032004c","9600",富邦-雙和,17,1,16,1,0.46
"20230307","1783","003900310038004b","9100",群益金鼎-東湖,2,33,31,-1,0.89
"20230307","1783","0039004100300030","9A00",永豐金證券,23,7,16,1,0.46
"20230307","1783","8561","8560",新光-台中,10,37,27,-1,0.78
"20230307","1783","0035003800350046","5850",統一-彰化,15,0,15,1,0.43
"20230307","1783","0039003200300046","9200",凱基-站前,5,25,20,-1,0.57
"20230307","1783","9278","9200",凱基-永康,14,0,14,1,0.40
"20230307","1783","5854","5850",統一-城中,0,19,19,-1,0.55
"20230308","1783","9206","9200",凱基-高雄,31,0,31,1,1.98
"20230308","1783","9268","9200",凱基-台北,54,116,62,-1,3.96
"20230308","1783","6380","6380",光和,24,0,24,1,1.53
"20230308","1783","1480","1480",美商高盛,13,71,58,-1,3.70
"20230308","1783","6464","6460",大昌-新店,21,0,21,1,1.34
"20230308","1783","1470","1470",台灣摩根士丹利,9,54,45,-1,2.87
"20230308","1783","1440","1440",美林,48,28,20,1,1.28
"20230308","1783","9692","9600",富邦-嘉義,2,46,44,-1,2.81
"20230308","1783","8880","8880",國泰證券,20,0,20,1,1.28
"20230308","1783","0039003800300064","9800",元大-沙鹿,0,37,37,-1,2.36
"20230308","1783","0037003000300077","7000",兆豐-新莊,17,0,17,1,1.08
"20230308","1783","9216","9200",凱基-信義,3,31,28,-1,1.79
"20230308","1783","0039003100330049","9100",群益金鼎-萬華,14,1,13,1,0.83
"20230308","1783","1650","1650",新加坡商瑞銀,26,53,27,-1,1.72
"20230308","1783","9856","9800",元大-花蓮,18,5,13,1,0.83
"20230308","1783","5854","5850",統一-城中,2,27,25,-1,1.60
"20230308","1783","0037003700390050","7790",國票-九鼎,14,2,12,1,0.77
"20230308","1783","003900380039004e","9800",元大-內湖,2,27,25,-1,1.60
"20230308","1783","8883","8880",國泰-松江,11,0,11,1,0.70
"20230308","1783","0039004100300030","9A00",永豐金證券,6,26,20,-1,1.28
"20230308","1783","9300","9300",華南永昌,14,3,11,1,0.70
"20230308","1783","9208","9200",凱基-桃園,3,19,16,-1,1.02
"20230308","1783","003900380030004b","9800",元大-竹科,12,1,11,1,0.70
"20230308","1783","0037003000300058","7000",兆豐-永和,2,16,14,-1,0.89
"20230308","1783","003900380031006a","9800",元大-士林,42,32,10,1,0.64
"20230308","1783","9800","9800",元大證券,16,28,12,-1,0.77
"20230308","1783","003900360032004a","9600",富邦-三峽,10,0,10,1,0.64
"20230308","1783","5262","5260",美好-楊梅,0,10,10,-1,0.64
"20230309","1783","0031003000340041","1040",臺銀-臺中,21,0,21,1,2.30
"20230309","1783","1470","1470",台灣摩根士丹利,14,60,46,-1,5.03
"20230309","1783","8880","8880",國泰證券,20,0,20,1,2.19
"20230309","1783","9333","9300",華南永昌-長虹,1,44,43,-1,4.70
"20230309","1783","0039003600320044","9600",富邦-新莊,12,0,12,1,1.31
"20230309","1783","0039003100380046","9100",群益金鼎-新店,0,40,40,-1,4.37
"20230309","1783","0039003800310051","9800",元大-太平,11,0,11,1,1.20
"20230309","1783","0039004100390069","9A00",永豐金-新店,0,25,25,-1,2.73
"20230309","1783","6160","6160",中國信託,10,0,10,1,1.09
"20230309","1783","6380","6380",光和,0,20,20,-1,2.19
"20230309","1783","8888","8880",國泰-敦南,16,6,10,1,1.09
"20230309","1783","9268","9200",凱基-台北,24,40,16,-1,1.75
"20230309","1783","8882","8880",國泰-台中,10,0,10,1,1.09
"20230309","1783","0039003800300064","9800",元大-沙鹿,0,16,16,-1,1.75
"20230309","1783","1480","1480",美商高盛,10,0,10,1,1.09
"20230309","1783","7007","7000",兆豐-竹北,1,14,13,-1,1.42
"20230309","1783","5262","5260",美好-楊梅,10,0,10,1,1.09
"20230309","1783","0039003100380065","9100",群益金鼎-大安,0,13,13,-1,1.42
"20230309","1783","0037003000300067","7000",兆豐-南門,10,0,10,1,1.09
"20230309","1783","003500380035004a","5850",統一-三重,0,11,11,-1,1.20
"20230309","1783","0039003100380044","9100",群益金鼎-東門,10,0,10,1,1.09
"20230309","1783","5854","5850",統一-城中,0,10,10,-1,1.09
"20230309","1783","0039003800390059","9800",元大-基隆,10,0,10,1,1.09
"20230309","1783","9103","9100",群益金鼎-松山,0,10,10,-1,1.09
"20230309","1783","0037003700390075","7790",國票-長城,10,1,9,1,0.98
"20230309","1783","0039003800310061","9800",元大-歸仁,0,10,10,-1,1.09
"20230309","1783","9215","9200",凱基-高美館,9,0,9,1,0.98
"20230309","1783","9871","9800",元大-忠孝,0,10,10,-1,1.09
"20230310","1783","1650","1650",新加坡商瑞銀,210,14,196,1,9.63
"20230310","1783","9800","9800",元大證券,19,119,100,-1,4.91
"20230310","1783","1440","1440",美林,167,0,167,1,8.21
"20230310","1783","9692","9600",富邦-嘉義,2,56,54,-1,2.65
"20230310","1783","1470","1470",台灣摩根士丹利,137,58,79,1,3.88
"20230310","1783","8150","8150",台新證券,5,58,53,-1,2.60
"20230310","1783","1480","1480",美商高盛,87,20,67,1,3.29
"20230310","1783","5850","5850",統一,6,48,42,-1,2.06
"20230310","1783","1560","1560",港商野村,48,0,48,1,2.36
"20230310","1783","003700370039005a","7790",國票-安和,0,33,33,-1,1.62
"20230310","1783","8560","8560",新光,38,7,31,1,1.52
"20230310","1783","0039003800320041","9800",元大-羅東,15,47,32,-1,1.57
"20230310","1783","0038003800340048","8840",玉山-新竹,30,0,30,1,1.47
"20230310","1783","9853","9800",元大-南屯,1,31,30,-1,1.47
"20230310","1783","6380","6380",光和,23,1,22,1,1.08
"20230310","1783","7000","7000",兆豐證券,0,25,25,-1,1.23
"20230310","1783","9856","9800",元大-花蓮,20,1,19,1,0.93
"20230310","1783","9333","9300",華南永昌-長虹,2,27,25,-1,1.23
"20230310","1783","0037003000300058","7000",兆豐-永和,20,4,16,1,0.79
"20230310","1783","9332","9300",華南永昌-楠梓,0,22,22,-1,1.08
"20230310","1783","9206","9200",凱基-高雄,15,0,15,1,0.74
"20230310","1783","1035","1030",土銀-新竹,0,20,20,-1,0.98
"20230310","1783","0039003800390053","9800",元大-鹿港,12,0,12,1,0.59
"20230310","1783","1117","1110",台灣企銀-竹北,0,20,20,-1,0.98
"20230310","1783","5261","5260",美好-蘆洲,11,0,11,1,0.54
"20230310","1783","6168","6160",中國信託-嘉義,0,20,20,-1,0.98
"20230310","1783","0035003900320065","5920",元富-古亭,11,0,11,1,0.54
"20230310","1783","0037003000300077","7000",兆豐-新莊,1,17,16,-1,0.79
"20230313","1783","1440","1440",美林,154,17,137,1,8.23
"20230313","1783","0039004100300030","9A00",永豐金證券,3,86,83,-1,4.99
"20230313","1783","9268","9200",凱基-台北,266,152,114,1,6.85
"20230313","1783","003900380039004e","9800",元大-內湖,2,52,50,-1,3.00
"20230313","1783","1470","1470",台灣摩根士丹利,124,26,98,1,5.89
"20230313","1783","5850","5850",統一,0,40,40,-1,2.40
"20230313","1783","9327","9300",華南永昌-斗六,20,0,20,1,1.20
"20230313","1783","8150","8150",台新證券,5,38,33,-1,1.98
"20230313","1783","1560","1560",港商野村,64,44,20,1,1.20
"20230313","1783","9256","9200",凱基-南崁,0,30,30,-1,1.80
"20230313","1783","8440","8440",摩根大通,35,16,19,1,1.14
"20230313","1783","0035003900320061","5920",元富-松德,2,25,23,-1,1.38
"20230313","1783","0039003600330041","9600",富邦-八德,15,0,15,1,0.90
"20230313","1783","9636","9600",富邦-中壢,5,28,23,-1,1.38
"20230313","1783","0039003100380044","9100",群益金鼎-東門,11,0,11,1,0.66
"20230313","1783","0039004100390041","9A00",永豐金-羅東,0,23,23,-1,1.38
"20230313","1783","9667","9600",富邦-台南,11,0,11,1,0.66
"20230313","1783","9200","9200",凱基,0,22,22,-1,1.32
"20230313","1783","0039003800300064","9800",元大-沙鹿,9,0,9,1,0.54
"20230313","1783","1260","1260",宏遠證券,0,20,20,-1,1.20
"20230313","1783","9856","9800",元大-花蓮,9,0,9,1,0.54
"20230313","1783","9377","9300",華南永昌-虎尾,0,16,16,-1,0.96
"20230313","1783","9800","9800",元大證券,57,49,8,1,0.48
"20230313","1783","0035003300380049","5380",第一金-頭份,0,15,15,-1,0.90
"20230313","1783","8560","8560",新光,22,15,7,1,0.42
"20230313","1783","9853","9800",元大-南屯,2,16,14,-1,0.84
"20230313","1783","8562","8560",新光-高雄,7,0,7,1,0.42
"20230313","1783","003800380034004d","8840",玉山-數位,0,10,10,-1,0.60
"20230314","1783","1470","1470",台灣摩根士丹利,92,35,57,1,3.76
"20230314","1783","1650","1650",新加坡商瑞銀,65,174,109,-1,7.19
"20230314","1783","9614","9600",富邦-基隆,40,0,40,1,2.64
"20230314","1783","1440","1440",美林,18,85,67,-1,4.42
"20230314","1783","0035003900320049","5920",元富-嘉義,29,0,29,1,1.91
"20230314","1783","1480","1480",美商高盛,3,69,66,-1,4.35
"20230314","1783","0031003000340041","1040",臺銀-臺中,61,37,24,1,1.58
"20230314","1783","8560","8560",新光,8,43,35,-1,2.31
"20230314","1783","0039003800320041","9800",元大-羅東,18,0,18,1,1.19
"20230314","1783","0038003800340048","8840",玉山-新竹,0,30,30,-1,1.98
"20230314","1783","003900380039004a","9800",元大-彰化民生,16,0,16,1,1.05
"20230314","1783","003500380035004a","5850",統一-三重,0,29,29,-1,1.91
"20230314","1783","0039004100390050","9A00",永豐金-竹北,18,3,15,1,0.99
"20230314","1783","0039004100390031","9A00",永豐金-松山,0,25,25,-1,1.65
"20230314","1783","003500390032006e","5920",元富-西松,14,1,13,1,0.86
"20230314","1783","1560","1560",港商野村,10,34,24,-1,1.58
"20230314","1783","0038003400350045","8450",康和-澎湖,12,0,12,1,0.79
"20230314","1783","5854","5850",統一-城中,1,21,20,-1,1.32
"20230314","1783","9215","9200",凱基-高美館,12,2,10,1,0.66
"20230314","1783","9871","9800",元大-忠孝,0,20,20,-1,1.32
"20230314","1783","9328","9300",華南永昌-潮州,10,0,10,1,0.66
"20230314","1783","0039003800390059","9800",元大-基隆,2,20,18,-1,1.19
"20230314","1783","9817","9800",元大-東泰,14,4,10,1,0.66
"20230314","1783","7001","7000",兆豐-嘉義,0,15,15,-1,0.99
"20230314","1783","9829","9800",元大-永康,10,0,10,1,0.66
"20230314","1783","0038003400350055","8450",康和-台北,0,15,15,-1,0.99
"20230314","1783","9856","9800",元大-花蓮,10,0,10,1,0.66
"20230314","1783","9859","9800",元大-新竹經國,0,14,14,-1,0.92
"20230315","1783","9604","9600",富邦-陽明,35,1,34,1,3.89
"20230315","1783","5850","5850",統一,0,50,50,-1,5.71
"20230315","1783","1470","1470",台灣摩根士丹利,33,9,24,1,2.74
"20230315","1783","1260","1260",宏遠證券,1,45,44,-1,5.03
"20230315","1783","003900410039004d","9A00",永豐金-南投,22,0,22,1,2.51
"20230315","1783","003900380039004e","9800",元大-內湖,0,25,25,-1,2.86
"20230315","1783","0039003800300064","9800",元大-沙鹿,30,9,21,1,2.40
"20230315","1783","003900380031004e","9800",元大-金門,0,24,24,-1,2.74
"20230315","1783","0031003000330046","1030",土銀-南港,40,20,20,1,2.29
"20230315","1783","0039004100300030","9A00",永豐金證券,2,25,23,-1,2.63
"20230315","1783","8150","8150",台新證券,18,3,15,1,1.71
"20230315","1783","0038003100350059","8150",台新-新營,0,19,19,-1,2.17
"20230315","1783","0039004100390059","9A00",永豐金-板盛,11,0,11,1,1.26
"20230315","1783","003700300030004b","7000",兆豐-新營,0,18,18,-1,2.06
"20230315","1783","0039003800310045","9800",元大-發財,11,0,11,1,1.26
"20230315","1783","5854","5850",統一-城中,0,15,15,-1,1.71
"20230315","1783","0037003000300056","7000",兆豐-新竹,10,0,10,1,1.14
"20230315","1783","9889","9800",元大-員林,0,15,15,-1,1.71
"20230315","1783","1560","1560",港商野村,10,1,9,1,1.03
"20230315","1783","0039003100380041","9100",群益金鼎-中壢,0,14,14,-1,1.60
"20230315","1783","0037003000300063","7000",兆豐-民生,9,0,9,1,1.03
"20230315","1783","003900360031005a","9600",富邦-永康,0,14,14,-1,1.60
"20230315","1783","0039003600310045","9600",富邦-府城,9,0,9,1,1.03
"20230315","1783","9800","9800",元大證券,5,19,14,-1,1.60
"20230315","1783","0031003200360044","1260",宏遠-台南,8,0,8,1,0.91
"20230315","1783","1480","1480",美商高盛,2,13,11,-1,1.26
"20230315","1783","1650","1650",新加坡商瑞銀,32,25,7,1,0.80
"20230315","1783","8880","8880",國泰證券,0,10,10,-1,1.14
"20230316","1783","1470","1470",台灣摩根士丹利,181,0,181,1,10.46
"20230316","1783","003900380039004e","9800",元大-內湖,2,77,75,-1,4.33
"20230316","1783","003900360031004b","9600",富邦-七賢,101,1,100,1,5.78
"20230316","1783","0039004100300030","9A00",永豐金證券,4,75,71,-1,4.10
"20230316","1783","8440","8440",摩根大通,50,0,50,1,2.89
"20230316","1783","9268","9200",凱基-台北,129,162,33,-1,1.91
"20230316","1783","1560","1560",港商野村,41,0,41,1,2.37
"20230316","1783","9604","9600",富邦-陽明,4,36,32,-1,1.85
"20230316","1783","8560","8560",新光,32,3,29,1,1.68
"20230316","1783","0039003800300064","9800",元大-沙鹿,2,32,30,-1,1.73
"20230316","1783","1480","1480",美商高盛,48,20,28,1,1.62
"20230316","1783","9667","9600",富邦-台南,3,29,26,-1,1.50
"20230316","1783","8882","8880",國泰-台中,20,0,20,1,1.16
"20230316","1783","9600","9600",富邦證券,0,25,25,-1,1.44
"20230316","1783","9800","9800",元大證券,40,21,19,1,1.10
"20230316","1783","8451","8450",康和-延平,0,25,25,-1,1.44
"20230316","1783","1440","1440",美林,21,5,16,1,0.92
"20230316","1783","003900410039004d","9A00",永豐金-南投,0,23,23,-1,1.33
"20230316","1783","9867","9800",元大-北成功,15,1,14,1,0.81
"20230316","1783","8880","8880",國泰證券,0,22,22,-1,1.27
"20230316","1783","8561","8560",新光-台中,15,2,13,1,0.75
"20230316","1783","9103","9100",群益金鼎-松山,0,22,22,-1,1.27
"20230316","1783","9215","9200",凱基-高美館,16,3,13,1,0.75
"20230316","1783","0039003200320048","9200",凱基-復興,0,20,20,-1,1.16
"20230316","1783","0039003600360046","9600",富邦-左營,13,0,13,1,0.75
"20230316","1783","9363","9300",華南永昌-彰化,0,20,20,-1,1.16
"20230316","1783","0035003900320071","5920",元富-屏東,11,1,10,1,0.58
"20230316","1783","5850","5850",統一,1,20,19,-1,1.10
"20230317","1783","003900360031004b","9600",富邦-七賢,28,0,28,1,3.48
"20230317","1783","1650","1650",新加坡商瑞銀,9,72,63,-1,7.84
"20230317","1783","9614","9600",富邦-基隆,20,0,20,1,2.49
"20230317","1783","1470","1470",台灣摩根士丹利,15,63,48,-1,5.97
"20230317","1783","1440","1440",美林,22,4,18,1,2.24
"20230317","1783","8440","8440",摩根大通,18,38,20,-1,2.49
"20230317","1783","1480","1480",美商高盛,17,1,16,1,1.99
"20230317","1783","8150","8150",台新證券,7,26,19,-1,2.36
"20230317","1783","1560","1560",港商野村,15,0,15,1,1.87
"20230317","1783","6110","6110",台中銀,0,15,15,-1,1.87
"20230317","1783","0037003000300063","7000",兆豐-民生,13,0,13,1,1.62
"20230317","1783","9801","9800",元大-城東,0,10,10,-1,1.24
"20230317","1783","0035003900320050","5920",元富-同大,12,0,12,1,1.49
"20230317","1783","1116","1110",台灣企銀-屏東,0,9,9,-1,1.12
"20230317","1783","6380","6380",光和,12,0,12,1,1.49
"20230317","1783","7005","7000",兆豐-台中港,3,8,5,-1,0.62
"20230317","1783","9871","9800",元大-忠孝,12,1,11,1,1.37
"20230317","1783","7007","7000",兆豐-竹北,0,5,5,-1,0.62
"20230317","1783","0039004100390066","9A00",永豐金-中盛,12,2,10,1,1.24
"20230317","1783","0038003800340048","8840",玉山-新竹,0,5,5,-1,0.62
"20230317","1783","6461","6460",大昌-樹林,12,2,10,1,1.24
"20230317","1783","0039003100380063","9100",群益金鼎-鳳山,1,6,5,-1,0.62
"20230317","1783","003700370039004a","7790",國票-北高雄,10,0,10,1,1.24
"20230317","1783","9333","9300",華南永昌-長虹,0,5,5,-1,0.62
"20230317","1783","9872","9800",元大-復北,10,0,10,1,1.24
"20230317","1783","003900380031004d","9800",元大-苗栗,5,10,5,-1,0.62
"20230317","1783","0039003800390044","9800",元大-左營,10,0,10,1,1.24
"20230317","1783","0039003800310072","9800",元大-屏南,0,5,5,-1,0.62
"20230320","1783","1560","1560",港商野村,58,0,58,1,5.07
"20230320","1783","003900380039004e","9800",元大-內湖,0,75,75,-1,6.56
"20230320","1783","0038003400350044","8450",康和-板橋,50,0,50,1,4.37
"20230320","1783","1470","1470",台灣摩根士丹利,25,82,57,-1,4.99
"20230320","1783","8440","8440",摩根大通,54,11,43,1,3.76
"20230320","1783","0037003000300058","7000",兆豐-永和,0,19,19,-1,1.66
"20230320","1783","8560","8560",新光,49,6,43,1,3.76
"20230320","1783","0039003800310045","9800",元大-發財,0,13,13,-1,1.14
"20230320","1783","9268","9200",凱基-台北,205,165,40,1,3.50
"20230320","1783","0039003800390059","9800",元大-基隆,0,13,13,-1,1.14
"20230320","1783","1480","1480",美商高盛,40,0,40,1,3.50
"20230320","1783","9322","9300",華南永昌-公誠,2,14,12,-1,1.05
"20230320","1783","1440","1440",美林,29,11,18,1,1.57
"20230320","1783","0036003000310064","6010",(牛牛牛)亞-鑫豐,0,10,10,-1,0.87
"20230320","1783","0038003100350059","8150",台新-新營,18,0,18,1,1.57
"20230320","1783","0038003100350041","8150",台新-高雄,0,8,8,-1,0.70
"20230320","1783","9654","9600",富邦-永和,18,0,18,1,1.57
"20230320","1783","9686","9600",富邦-宜蘭,0,7,7,-1,0.61
"20230320","1783","0039004100390042","9A00",永豐金-中和,11,0,11,1,0.96
"20230320","1783","1117","1110",台灣企銀-竹北,0,5,5,-1,0.44
"20230320","1783","9692","9600",富邦-嘉義,10,0,10,1,0.87
"20230320","1783","6163","6160",中國信託-永康,0,5,5,-1,0.44
"20230320","1783","9204","9200",凱基-台中,9,0,9,1,0.79
"20230320","1783","8562","8560",新光-高雄,1,6,5,-1,0.44
"20230320","1783","003900380039004a","9800",元大-彰化民生,9,0,9,1,0.79
"20230320","1783","9131","9100",群益金鼎-民權,0,5,5,-1,0.44
"20230320","1783","0037003000300063","7000",兆豐-民生,8,1,7,1,0.61
"20230320","1783","003900380031004d","9800",元大-苗栗,0,5,5,-1,0.44
"20230321","1783","9209","9200",凱基-岡山,60,6,54,1,4.29
"20230321","1783","1470","1470",台灣摩根士丹利,4,109,105,-1,8.35
"20230321","1783","0039003800300064","9800",元大-沙鹿,53,0,53,1,4.21
"20230321","1783","8440","8440",摩根大通,6,43,37,-1,2.94
"20230321","1783","5268","5260",美好-台南,26,0,26,1,2.07
"20230321","1783","9268","9200",凱基-台北,137,165,28,-1,2.23
"20230321","1783","1440","1440",美林,33,8,25,1,1.99
"20230321","1783","0039004100390031","9A00",永豐金-松山,0,20,20,-1,1.59
"20230321","1783","8888","8880",國泰-敦南,25,3,22,1,1.75
"20230321","1783","1560","1560",港商野村,8,26,18,-1,1.43
"20230321","1783","8560","8560",新光,23,2,21,1,1.67
"20230321","1783","1650","1650",新加坡商瑞銀,38,51,13,-1,1.03
"20230321","1783","6110","6110",台中銀,20,0,20,1,1.59
"20230321","1783","9871","9800",元大-忠孝,0,12,12,-1,0.95
"20230321","1783","6010","6010",(牛牛牛)亞證券,17,0,17,1,1.35
"20230321","1783","0039003800390044","9800",元大-左營,0,11,11,-1,0.87
"20230321","1783","0037003700390065","7790",國票-南科,15,0,15,1,1.19
"20230321","1783","6461","6460",大昌-樹林,2,12,10,-1,0.79
"20230321","1783","0039003800300061","9800",元大-承德,16,1,15,1,1.19
"20230321","1783","8841","8840",玉山-雙和,1,11,10,-1,0.79
"20230321","1783","0038003100350059","8150",台新-新營,12,0,12,1,0.95
"20230321","1783","0039004100390057","9A00",永豐金-市政,6,14,8,-1,0.64
"20230321","1783","8562","8560",新光-高雄,16,4,12,1,0.95
"20230321","1783","0035003900320047","5920",元富-新竹,0,8,8,-1,0.64
"20230321","1783","1040","1040",臺銀,10,0,10,1,0.79
"20230321","1783","9600","9600",富邦證券,0,8,8,-1,0.64
"20230321","1783","5850","5850",統一,10,0,10,1,0.79
"20230321","1783","9692","9600",富邦-嘉義,2,10,8,-1,0.64
"20230322","1783","9859","9800",元大-新竹經國,30,0,30,1,3.37
"20230322","1783","1480","1480",美商高盛,2,51,49,-1,5.50
"20230322","1783","8840","8840",玉山證券,20,0,20,1,2.24
"20230322","1783","1650","1650",新加坡商瑞銀,11,55,44,-1,4.94
"20230322","1783","6160","6160",中國信託,17,0,17,1,1.91
"20230322","1783","003900380039004e","9800",元大-內湖,4,39,35,-1,3.93
"20230322","1783","8560","8560",新光,19,5,14,1,1.57
"20230322","1783","0039004100300030","9A00",永豐金證券,0,35,35,-1,3.93
"20230322","1783","003800380034004d","8840",玉山-數位,12,0,12,1,1.35
"20230322","1783","0031003000340041","1040",臺銀-臺中,3,29,26,-1,2.92
"20230322","1783","9868","9800",元大-文心,12,0,12,1,1.35
"20230322","1783","1440","1440",美林,4,22,18,-1,2.02
"20230322","1783","0038003400350044","8450",康和-板橋,10,0,10,1,1.12
"20230322","1783","0039003800300061","9800",元大-承德,0,16,16,-1,1.80
"20230322","1783","9233","9200",凱基-長庚,10,0,10,1,1.12
"20230322","1783","0039003800300064","9800",元大-沙鹿,0,13,13,-1,1.46
"20230322","1783","8881","8880",國泰-高雄,8,0,8,1,0.90
"20230322","1783","0039004100390031","9A00",永豐金-松山,0,10,10,-1,1.12
"20230322","1783","8883","8880",國泰-松江,8,0,8,1,0.90
"20230322","1783","003700370039004a","7790",國票-北高雄,1,10,9,-1,1.01
"20230322","1783","8440","8440",摩根大通,19,12,7,1,0.79
"20230322","1783","8562","8560",新光-高雄,1,10,9,-1,1.01
"20230322","1783","9217","9200",凱基-松山,8,1,7,1,0.79
"20230322","1783","0038003100350059","8150",台新-新營,0,9,9,-1,1.01
"20230322","1783","9300","9300",華南永昌,7,0,7,1,0.79
"20230322","1783","1560","1560",港商野村,0,8,8,-1,0.90
"20230322","1783","9874","9800",元大-雙和,7,0,7,1,0.79
"20230322","1783","9227","9200",凱基-城中,2,10,8,-1,0.90
"20230323","1783","5854","5850",統一-城中,224,65,159,1,8.98
"20230323","1783","9268","9200",凱基-台北,146,221,75,-1,4.24
"20230323","1783","9676","9600",富邦-仁愛,34,4,30,1,1.69
"20230323","1783","1480","1480",美商高盛,9,72,63,-1,3.56
"20230323","1783","003700370039004a","7790",國票-北高雄,23,0,23,1,1.30
"20230323","1783","0039004100300030","9A00",永豐金證券,3,50,47,-1,2.66
"20230323","1783","0031003000340041","1040",臺銀-臺中,22,0,22,1,1.24
"20230323","1783","1440","1440",美林,20,61,41,-1,2.32
"20230323","1783","9256","9200",凱基-南崁,22,1,21,1,1.19
"20230323","1783","003900380039004e","9800",元大-內湖,3,42,39,-1,2.20
"20230323","1783","0035003900320077","5920",元富-佳里,20,0,20,1,1.13
"20230323","1783","1560","1560",港商野村,0,37,37,-1,2.09
"20230323","1783","0031003000330046","1030",土銀-南港,42,23,19,1,1.07
"20230323","1783","003900380031006a","9800",元大-士林,0,30,30,-1,1.69
"20230323","1783","003900360035004b","9600",富邦-台中,18,0,18,1,1.02
"20230323","1783","5268","5260",美好-台南,0,27,27,-1,1.53
"20230323","1783","0039003100380043","9100",群益金鼎-古亭,15,2,13,1,0.73
"20230323","1783","8561","8560",新光-台中,3,30,27,-1,1.53
"20230323","1783","0039003800310067","9800",元大-大里,18,6,12,1,0.68
"20230323","1783","9853","9800",元大-南屯,0,20,20,-1,1.13
"20230323","1783","1470","1470",台灣摩根士丹利,94,83,11,1,0.62
"20230323","1783","0037003000300063","7000",兆豐-民生,0,19,19,-1,1.07
"20230323","1783","5850","5850",統一,10,0,10,1,0.56
"20230323","1783","8888","8880",國泰-敦南,8,23,15,-1,0.85
"20230323","1783","003500330038004e","5380",第一金-豐原,10,0,10,1,0.56
"20230323","1783","9233","9200",凱基-長庚,1,14,13,-1,0.73
"20230323","1783","8380","8380",安泰,10,0,10,1,0.56
"20230323","1783","1040","1040",臺銀,0,10,10,-1,0.56
"20230324","1783","9655","9600",富邦-板橋,31,0,31,1,3.15
"20230324","1783","1650","1650",新加坡商瑞銀,15,73,58,-1,5.89
"20230324","1783","8150","8150",台新證券,32,3,29,1,2.95
"20230324","1783","1480","1480",美商高盛,9,58,49,-1,4.98
"20230324","1783","9300","9300",華南永昌,29,0,29,1,2.95
"20230324","1783","1560","1560",港商野村,0,39,39,-1,3.96
"20230324","1783","5268","5260",美好-台南,28,1,27,1,2.74
"20230324","1783","0039003800300064","9800",元大-沙鹿,0,30,30,-1,3.05
"20230324","1783","0039003800390056","9800",元大-北三重,21,0,21,1,2.13
"20230324","1783","5854","5850",統一-城中,1,26,25,-1,2.54
"20230324","1783","0039004100390041","9A00",永豐金-羅東,16,0,16,1,1.63
"20230324","1783","9268","9200",凱基-台北,83,105,22,-1,2.24
"20230324","1783","9853","9800",元大-南屯,10,0,10,1,1.02
"20230324","1783","003900380031006a","9800",元大-士林,0,20,20,-1,2.03
"20230324","1783","6160","6160",中國信託,12,4,8,1,0.81
"20230324","1783","9189","9100",群益金鼎-桃園,0,14,14,-1,1.42
"20230324","1783","0038003800380041","8880",國泰-館前,8,0,8,1,0.81
"20230324","1783","0039004100390042","9A00",永豐金-中和,0,12,12,-1,1.22
"20230324","1783","9337","9300",華南永昌-內壢,8,0,8,1,0.81
"20230324","1783","0035003900320077","5920",元富-佳里,0,11,11,-1,1.12
"20230324","1783","0031003000330046","1030",土銀-南港,7,0,7,1,0.71
"20230324","1783","9676","9600",富邦-仁愛,22,33,11,-1,1.12
"20230324","1783","5385","5380",第一金-桃園,7,0,7,1,0.71
"20230324","1783","1260","1260",宏遠證券,1,10,9,-1,0.91
"20230324","1783","003900380031004e","9800",元大-金門,6,0,6,1,0.61
"20230324","1783","9868","9800",元大-文心,1,10,9,-1,0.91
"20230324","1783","003900410039004c","9A00",永豐金-台中,8,2,6,1,0.61
"20230324","1783","5857","5850",統一-新竹,0,8,8,-1,0.81
"20230327","1783","1440","1440",美林,49,10,39,1,5.71
"20230327","1783","9227","9200",凱基-城中,0,40,40,-1,5.86
"20230327","1783","8440","8440",摩根大通,35,0,35,1,5.12
"20230327","1783","1022","1020",合庫-台南,0,20,20,-1,2.93
"20230327","1783","1480","1480",美商高盛,30,2,28,1,4.10
"20230327","1783","6110","6110",台中銀,0,20,20,-1,2.93
"20230327","1783","1650","1650",新加坡商瑞銀,35,11,24,1,3.51
"20230327","1783","0038003100350059","8150",台新-新營,0,20,20,-1,2.93
"20230327","1783","8150","8150",台新證券,25,3,22,1,3.22
"20230327","1783","8843","8840",玉山-高雄,0,15,15,-1,2.20
"20230327","1783","1560","1560",港商野村,23,4,19,1,2.78
"20230327","1783","8882","8880",國泰-台中,2,16,14,-1,2.05
"20230327","1783","003900380039005a","9800",元大-小港,15,1,14,1,2.05
"20230327","1783","5603","5600",永興-台中,0,10,10,-1,1.46
"20230327","1783","003800380034004a","8840",玉山-大里,15,1,14,1,2.05
"20230327","1783","6167","6160",中國信託-松江,5,15,10,-1,1.46
"20230327","1783","1025","1020",合庫-基隆,10,0,10,1,1.46
"20230327","1783","9317","9300",華南永昌-林口,0,10,10,-1,1.46
"20230327","1783","0039004100390058","9A00",永豐金-竹科,10,0,10,1,1.46
"20230327","1783","0039003800320041","9800",元大-羅東,1,11,10,-1,1.46
"20230327","1783","8560","8560",新光,14,7,7,1,1.02
"20230327","1783","003500390032006c","5920",元富-大裕,0,9,9,-1,1.32
"20230327","1783","5268","5260",美好-台南,8,1,7,1,1.02
"20230327","1783","8848","8840",玉山-嘉義,0,8,8,-1,1.17
"20230327","1783","0038003800380041","8880",國泰-館前,9,2,7,1,1.02
"20230327","1783","9676","9600",富邦-仁愛,3,10,7,-1,1.02
"20230327","1783","003900410039004d","9A00",永豐金-南投,7,0,7,1,1.02
"20230327","1783","8710","8710",陽信,0,6,6,-1,0.88
"20230328","1783","8440","8440",摩根大通,73,11,62,1,8.39
"20230328","1783","9209","9200",凱基-岡山,2,40,38,-1,5.14
"20230328","1783","1440","1440",美林,41,8,33,1,4.47
"20230328","1783","8840","8840",玉山證券,1,18,17,-1,2.30
"20230328","1783","0035003800350044","5850",統一-新台中,15,0,15,1,2.03
"20230328","1783","9676","9600",富邦-仁愛,0,14,14,-1,1.89
"20230328","1783","1560","1560",港商野村,18,4,14,1,1.89
"20230328","1783","9337","9300",華南永昌-內壢,0,12,12,-1,1.62
"20230328","1783","8560","8560",新光,16,3,13,1,1.76
"20230328","1783","9829","9800",元大-永康,0,11,11,-1,1.49
"20230328","1783","0031003000340041","1040",臺銀-臺中,10,0,10,1,1.35
"20230328","1783","0035003900320049","5920",元富-嘉義,0,10,10,-1,1.35
"20230328","1783","8843","8840",玉山-高雄,10,0,10,1,1.35
"20230328","1783","9300","9300",華南永昌,0,10,10,-1,1.35
"20230328","1783","9324","9300",華南永昌-岡山,10,0,10,1,1.35
"20230328","1783","0039003600320044","9600",富邦-新莊,0,10,10,-1,1.35
"20230328","1783","9237","9200",凱基-敦北,9,0,9,1,1.22
"20230328","1783","0039004100390031","9A00",永豐金-松山,0,10,10,-1,1.35
"20230328","1783","9309","9300",華南永昌-古亭,8,0,8,1,1.08
"20230328","1783","0039004100390041","9A00",永豐金-羅東,2,12,10,-1,1.35
"20230328","1783","0039004100300030","9A00",永豐金證券,8,0,8,1,1.08
"20230328","1783","0039004100390069","9A00",永豐金-新店,0,10,10,-1,1.35
"20230328","1783","1470","1470",台灣摩根士丹利,13,7,6,1,0.81
"20230328","1783","0037003700390050","7790",國票-九鼎,1,9,8,-1,1.08
"20230328","1783","0038003100350041","8150",台新-高雄,9,3,6,1,0.81
"20230328","1783","0039003800300065","9800",元大-清水,0,8,8,-1,1.08
"20230328","1783","9255","9200",凱基-和平,8,2,6,1,0.81
"20230328","1783","0035003800350046","5850",統一-彰化,0,7,7,-1,0.95
"20230329","1783","1470","1470",台灣摩根士丹利,73,4,69,1,8.25
"20230329","1783","9268","9200",凱基-台北,63,103,40,-1,4.78
"20230329","1783","1650","1650",新加坡商瑞銀,52,16,36,1,4.31
"20230329","1783","8560","8560",新光,2,17,15,-1,1.79
"20230329","1783","1480","1480",美商高盛,32,2,30,1,3.59
"20230329","1783","0039004100390078","9A00",永豐金-桃園,0,13,13,-1,1.56
"20230329","1783","9863","9800",元大-和平,18,0,18,1,2.15
"20230329","1783","0035003900320049","5920",元富-嘉義,0,12,12,-1,1.44
"20230329","1783","0031003000340041","1040",臺銀-臺中,12,2,10,1,1.20
"20230329","1783","5386","5380",第一金-彰化,0,11,11,-1,1.32
"20230329","1783","0035003900320075","5920",元富-世貿,10,0,10,1,1.20
"20230329","1783","003900360032004a","9600",富邦-三峽,0,10,10,-1,1.20
"20230329","1783","0039003600310057","9600",富邦-東花蓮,10,0,10,1,1.20
"20230329","1783","0039003800310049","9800",元大-天母,0,10,10,-1,1.20
"20230329","1783","9215","9200",凱基-高美館,9,1,8,1,0.96
"20230329","1783","9829","9800",元大-永康,0,10,10,-1,1.20
"20230329","1783","8150","8150",台新證券,9,1,8,1,0.96
"20230329","1783","003900360035004b","9600",富邦-台中,1,10,9,-1,1.08
"20230329","1783","8440","8440",摩根大通,15,7,8,1,0.96
"20230329","1783","8843","8840",玉山-高雄,0,8,8,-1,0.96
"20230329","1783","0039003800300075","9800",元大-府城,8,0,8,1,0.96
"20230329","1783","9237","9200",凱基-敦北,0,8,8,-1,0.96
"20230329","1783","9302","9300",華南永昌-台中,17,10,7,1,0.84
"20230329","1783","5852","5850",統一-敦南,0,7,7,-1,0.84
"20230329","1783","9676","9600",富邦-仁愛,18,11,7,1,0.84
"20230329","1783","9817","9800",元大-東泰,1,8,7,-1,0.84
"20230329","1783","003500330038006a","5380",第一金-安和,7,1,6,1,0.72
"20230329","1783","0039003800310079","9800",元大-善化,0,7,7,-1,0.84
"20230330","1783","7798","7790",國票-內壢,11,0,11,1,1.89
"20230330","1783","1440","1440",美林,10,47,37,-1,6.37
"20230330","1783","8560","8560",新光,12,1,11,1,1.89
"20230330","1783","1650","1650",新加坡商瑞銀,16,42,26,-1,4.48
"20230330","1783","003800380038004b","8880",國泰-板橋,10,0,10,1,1.72
"20230330","1783","1480","1480",美商高盛,1,25,24,-1,4.13
"20230330","1783","0031003000320045","1020",合庫-桃園,10,0,10,1,1.72
"20230330","1783","0035003800350044","5850",統一-新台中,0,15,15,-1,2.58
"20230330","1783","003900380030004b","9800",元大-竹科,10,0,10,1,1.72
"20230330","1783","9206","9200",凱基-高雄,0,15,15,-1,2.58
"20230330","1783","0039004100390032","9A00",永豐金-萬盛,9,0,9,1,1.55
"20230330","1783","9332","9300",華南永昌-楠梓,0,13,13,-1,2.24
"20230330","1783","0039003600330042","9600",富邦-北宜蘭,8,0,8,1,1.38
"20230330","1783","8150","8150",台新證券,34,46,12,-1,2.07
"20230330","1783","6380","6380",光和,7,0,7,1,1.20
"20230330","1783","9604","9600",富邦-陽明,2,13,11,-1,1.89
"20230330","1783","003900380039004c","9800",元大-成功,7,0,7,1,1.20
"20230330","1783","8881","8880",國泰-高雄,1,11,10,-1,1.72
"20230330","1783","8888","8880",國泰-敦南,6,0,6,1,1.03
"20230330","1783","8842","8840",玉山-新莊,0,9,9,-1,1.55
"20230330","1783","0039003800310053","9800",元大-崇德,7,1,6,1,1.03
"20230330","1783","9676","9600",富邦-仁愛,0,8,8,-1,1.38
"20230330","1783","003900380031005a","9800",元大-潮州,6,0,6,1,1.03
"20230330","1783","9302","9300",華南永昌-台中,2,9,7,-1,1.20
"20230330","1783","0039004100390036","9A00",永豐金-博愛,6,0,6,1,1.03
"20230330","1783","9108","9100",群益金鼎-海山,1,6,5,-1,0.86
"20230330","1783","0035003900320049","5920",元富-嘉義,5,0,5,1,0.86
"20230330","1783","9874","9800",元大-雙和,0,5,5,-1,0.86
"20230331","1783","003900380036004b","9800",元大-基隆孝二,34,0,34,1,5.70
"20230331","1783","0038003100350041","8150",台新-高雄,4,30,26,-1,4.36
"20230331","1783","0039003600320047","9600",富邦-斗六,20,0,20,1,3.35
"20230331","1783","8440","8440",摩根大通,6,26,20,-1,3.35
"20230331","1783","0039004100380046","9A00",永豐金-敦南,20,0,20,1,3.35
"20230331","1783","9327","9300",華南永昌-斗六,0,20,20,-1,3.35
"20230331","1783","8150","8150",台新證券,17,1,16,1,2.68
"20230331","1783","7798","7790",國票-內壢,0,11,11,-1,1.84
"20230331","1783","1480","1480",美商高盛,40,24,16,1,2.68
"20230331","1783","0039003600330041","9600",富邦-八德,0,10,10,-1,1.68
"20230331","1783","0035003900320065","5920",元富-古亭,12,0,12,1,2.01
"20230331","1783","003900380030004b","9800",元大-竹科,1,10,9,-1,1.51
"20230331","1783","6012","6010",(牛牛牛)亞-網路,10,0,10,1,1.68
"20230331","1783","0039003800310053","9800",元大-崇德,0,8,8,-1,1.34
"20230331","1783","1024","1020",合庫-嘉義,10,0,10,1,1.68
"20230331","1783","003900380039004c","9800",元大-成功,2,10,8,-1,1.34
"20230331","1783","0038003400350055","8450",康和-台北,10,0,10,1,1.68
"20230331","1783","8888","8880",國泰-敦南,4,12,8,-1,1.34
"20230331","1783","0039004100390052","9A00",永豐金-信義,20,10,10,1,1.68
"20230331","1783","9666","9600",富邦-南屯,0,6,6,-1,1.01
"20230331","1783","0038003100350042","8150",台新-台中,9,1,8,1,1.34
"20230331","1783","0037003000300070","7000",兆豐-復興,0,5,5,-1,0.84
"20230331","1783","003500390032004c","5920",元富-中壢,8,0,8,1,1.34
"20230331","1783","9817","9800",元大-東泰,0,5,5,-1,0.84
"20230331","1783","1041","1040",臺銀-鳳山,7,2,5,1,0.84
"20230331","1783","0038003100350059","8150",台新-新營,2,7,5,-1,0.84
"20230331","1783","0039003200300046","9200",凱基-站前,16,11,5,1,0.84
"20230331","1783","9604","9600",富邦-陽明,1,6,5,-1,0.84
"20230524","1783","003900380031005a","9800",元大-潮州,45,0,45,1,3.03
"20230524","1783","1650","1650",新加坡商瑞銀,18,233,215,-1,14.49
"20230524","1783","9867","9800",元大-北成功,30,0,30,1,2.02
"20230524","1783","1470","1470",台灣摩根士丹利,9,193,184,-1,12.40
"20230524","1783","9800","9800",元大證券,36,14,22,1,1.48
"20230524","1783","1480","1480",美商高盛,9,121,112,-1,7.55
"20230524","1783","9302","9300",華南永昌-台中,21,0,21,1,1.42
"20230524","1783","1440","1440",美林,16,81,65,-1,4.38
"20230524","1783","9667","9600",富邦-台南,16,0,16,1,1.08
"20230524","1783","8711","8710",陽信-石牌,0,50,50,-1,3.37
"20230524","1783","0039003800310079","9800",元大-善化,16,0,16,1,1.08
"20230524","1783","8440","8440",摩根大通,10,48,38,-1,2.56
"20230524","1783","8882","8880",國泰-台中,16,1,15,1,1.01
"20230524","1783","9636","9600",富邦-中壢,0,15,15,-1,1.01
"20230524","1783","003700300030004d","7000",兆豐-桃園,15,0,15,1,1.01
"20230524","1783","0036003100360041","6160",中國信託-中壢,5,20,15,-1,1.01
"20230524","1783","003900380039005a","9800",元大-小港,14,0,14,1,0.94
"20230524","1783","9208","9200",凱基-桃園,1,13,12,-1,0.81
"20230524","1783","8560","8560",新光,20,6,14,1,0.94
"20230524","1783","0039003800300068","9800",元大-台北,0,10,10,-1,0.67
"20230524","1783","003900380039004a","9800",元大-彰化民生,14,0,14,1,0.94
"20230524","1783","6160","6160",中國信託,0,8,8,-1,0.54
"20230524","1783","8888","8880",國泰-敦南,17,4,13,1,0.88
"20230524","1783","0039004100390071","9A00",永豐金-潮州,2,10,8,-1,0.54
"20230524","1783","6464","6460",大昌-新店,29,16,13,1,0.88
"20230524","1783","0035003900320050","5920",元富-同大,1,8,7,-1,0.47
"20230524","1783","0039003800310072","9800",元大-屏南,13,0,13,1,0.88
"20230524","1783","9136","9100",群益金鼎-西松,3,10,7,-1,0.47
"20230201","1783","9268","9200",凱基-台北,138,46,92,1,5.29
"20230201","1783","9658","9600",富邦-建國,1,153,152,-1,8.75
"20230201","1783","1560","1560",港商野村,91,16,75,1,4.32
"20230201","1783","0035003300380043","5380",第一金-光復,0,80,80,-1,4.60
"20230201","1783","1470","1470",台灣摩根士丹利,60,6,54,1,3.11
"20230201","1783","9296","9200",凱基-頭份,0,39,39,-1,2.24
"20230201","1783","9871","9800",元大-忠孝,50,0,50,1,2.88
"20230201","1783","0039003600310043","9600",富邦-南京,1,35,34,-1,1.96
"20230201","1783","1480","1480",美商高盛,52,4,48,1,2.76
"20230201","1783","8882","8880",國泰-台中,10,34,24,-1,1.38
"20230201","1783","1650","1650",新加坡商瑞銀,80,52,28,1,1.61
"20230201","1783","9208","9200",凱基-桃園,0,22,22,-1,1.27
"20230201","1783","8440","8440",摩根大通,82,60,22,1,1.27
"20230201","1783","0039003200300046","9200",凱基-站前,0,19,19,-1,1.09
"20230201","1783","5603","5600",永興-台中,20,0,20,1,1.15
"20230201","1783","0038003800340045","8840",玉山-城中,10,25,15,-1,0.86
"20230201","1783","0035003900320065","5920",元富-古亭,21,1,20,1,1.15
"20230201","1783","9211","9200",凱基-台南,0,13,13,-1,0.75
"20230201","1783","8150","8150",台新證券,24,5,19,1,1.09
"20230201","1783","0039003800390053","9800",元大-鹿港,0,12,12,-1,0.69
"20230201","1783","9813","9800",元大-八德,21,2,19,1,1.09
"20230201","1783","9377","9300",華南永昌-虎尾,0,11,11,-1,0.63
"20230201","1783","9856","9800",元大-花蓮,16,0,16,1,0.92
"20230201","1783","0039003800390059","9800",元大-基隆,0,11,11,-1,0.63
"20230201","1783","0035003900320045","5920",元富-城中,15,0,15,1,0.86
"20230201","1783","0039004100390037","9A00",永豐金-新竹,1,12,11,-1,0.63
"20230201","1783","0038003400350045","8450",康和-澎湖,15,0,15,1,0.86
"20230201","1783","0039004100390064","9A00",永豐金-古亭,0,11,11,-1,0.63
"20230202","1783","1650","1650",新加坡商瑞銀,142,52,90,1,4.41
"20230202","1783","9268","9200",凱基-台北,89,169,80,-1,3.92
"20230202","1783","003900360031004e","9600",富邦-西壢,46,0,46,1,2.25
"20230202","1783","6164","6160",中國信託-文心,0,52,52,-1,2.55
"20230202","1783","003500380035004a","5850",統一-三重,51,10,41,1,2.01
"20230202","1783","9676","9600",富邦-仁愛,13,64,51,-1,2.50
"20230202","1783","1440","1440",美林,46,6,40,1,1.96
"20230202","1783","9208","9200",凱基-桃園,3,37,34,-1,1.67
"20230202","1783","0039004100390053","9A00",永豐金-南京,31,3,28,1,1.37
"20230202","1783","9235","9200",凱基-永華,0,20,20,-1,0.98
"20230202","1783","8849","8840",玉山-景美,25,0,25,1,1.22
"20230202","1783","0039003800300051","9800",元大-南崁,0,19,19,-1,0.93
"20230202","1783","0039003100380046","9100",群益金鼎-新店,25,0,25,1,1.22
"20230202","1783","1560","1560",港商野村,29,47,18,-1,0.88
"20230202","1783","0039003800300064","9800",元大-沙鹿,25,1,24,1,1.18
"20230202","1783","8150","8150",台新證券,6,24,18,-1,0.88
"20230202","1783","0031003000320041","1020",合庫-新竹,20,0,20,1,0.98
"20230202","1783","8562","8560",新光-高雄,2,19,17,-1,0.83
"20230202","1783","0035003900320045","5920",元富-城中,21,2,19,1,0.93
"20230202","1783","9237","9200",凱基-敦北,0,15,15,-1,0.73
"20230202","1783","0039004100390057","9A00",永豐金-市政,19,0,19,1,0.93
"20230202","1783","9296","9200",凱基-頭份,0,15,15,-1,0.73
"20230202","1783","003700300030006a","7000",兆豐-大安,16,0,16,1,0.78
"20230202","1783","8157","8150",台新-左楠,0,14,14,-1,0.69
"20230202","1783","8158","8150",台新-松江,16,0,16,1,0.78
"20230202","1783","9252","9200",凱基-嘉義,0,14,14,-1,0.69
"20230202","1783","8560","8560",新光,42,27,15,1,0.73
"20230202","1783","0039004100390078","9A00",永豐金-桃園,1,13,12,-1,0.59
"20230203","1783","0039004100300030","9A00",永豐金證券,142,66,76,1,3.49
"20230203","1783","0039003600320056","9600",富邦-復興,0,65,65,-1,2.98
"20230203","1783","0035003900320048","5920",元富-信義,33,0,33,1,1.52
"20230203","1783","9208","9200",凱基-桃園,1,64,63,-1,2.89
"20230203","1783","6451","6450",永全-南崁,30,0,30,1,1.38
"20230203","1783","0039003200320048","9200",凱基-復興,0,50,50,-1,2.30
"20230203","1783","1262","1260",宏遠-桃園,20,0,20,1,0.92
"20230203","1783","9235","9200",凱基-永華,0,47,47,-1,2.16
"20230203","1783","9135","9100",群益金鼎-東大,20,0,20,1,0.92
"20230203","1783","0039004100390052","9A00",永豐金-信義,0,45,45,-1,2.07
"20230203","1783","003500390032007a","5920",元富-文心,16,0,16,1,0.73
"20230203","1783","7000","7000",兆豐證券,0,44,44,-1,2.02
"20230203","1783","9268","9200",凱基-台北,18,2,16,1,0.73
"20230203","1783","0035003800350063","5850",統一-仁愛,0,38,38,-1,1.74
"20230203","1783","0039003100380073","9100",群益金鼎-丹鳳,15,1,14,1,0.64
"20230203","1783","0035003900320045","5920",元富-城中,0,37,37,-1,1.70
"20230203","1783","9873","9800",元大-西門,13,0,13,1,0.60
"20230203","1783","0039003800330055","9800",元大-頭份,1,37,36,-1,1.65
"20230203","1783","9634","9600",富邦-羅東,12,1,11,1,0.51
"20230203","1783","0039003800310053","9800",元大-崇德,0,34,34,-1,1.56
"20230203","1783","0038003400350053","8450",康和-南崁,10,0,10,1,0.46
"20230203","1783","9105","9100",群益金鼎-高盛,0,31,31,-1,1.42
"20230203","1783","8520","8520",中農,10,0,10,1,0.46
"20230203","1783","8565","8560",新光-桃園,1,32,31,-1,1.42
"20230203","1783","003900380031007a","9800",元大-大統,10,0,10,1,0.46
"20230203","1783","1480","1480",美商高盛,0,28,28,-1,1.29
"20230203","1783","0039004100390078","9A00",永豐金-桃園,9,0,9,1,0.41
"20230203","1783","1020","1020",合庫證券,10,37,27,-1,1.24
"20230206","1783","9600","9600",富邦證券,1200,700,500,1,1.87
"20230206","1783","0039004100300030","9A00",永豐金證券,41,197,156,-1,0.58
"20230206","1783","8440","8440",摩根大通,1192,915,277,1,1.04
"20230206","1783","1440","1440",美林,74,203,129,-1,0.48
"20230206","1783","1480","1480",美商高盛,444,256,188,1,0.70
"20230206","1783","0039003200300043","9200",凱基-雙和,13,141,128,-1,0.48
"20230206","1783","0039004100390055","9A00",永豐金-中正,244,75,169,1,0.63
"20230206","1783","8565","8560",新光-桃園,55,176,121,-1,0.45
"20230206","1783","1650","1650",新加坡商瑞銀,634,477,157,1,0.59
"20230206","1783","9898","9800",元大-新莊,34,139,105,-1,0.39
"20230206","1783","8710","8710",陽信,158,17,141,1,0.53
"20230206","1783","5264","5260",美好-高雄,0,100,100,-1,0.37
"20230206","1783","9105","9100",群益金鼎-高盛,71,12,59,1,0.22
"20230206","1783","0039003600320056","9600",富邦-復興,14,100,86,-1,0.32
"20230206","1783","9623","9600",富邦-台北,104,45,59,1,0.22
"20230206","1783","9217","9200",凱基-松山,8,72,64,-1,0.24
"20230206","1783","003900360031004a","9600",富邦-興業,62,10,52,1,0.19
"20230206","1783","6164","6160",中國信託-文心,13,75,62,-1,0.23
"20230206","1783","1260","1260",宏遠證券,84,34,50,1,0.19
"20230206","1783","003900360031004e","9600",富邦-西壢,19,75,56,-1,0.21
"20230206","1783","9813","9800",元大-八德,87,42,45,1,0.17
"20230206","1783","0039003600320043","9600",富邦-東門,8,59,51,-1,0.19
"20230206","1783","8151","8150",台新-建北,56,13,43,1,0.16
"20230206","1783","0039003800310053","9800",元大-崇德,17,67,50,-1,0.19
"20230206","1783","003900380033006a","9800",元大-仁愛,54,12,42,1,0.16
"20230206","1783","0039003800330066","9800",元大-竹東,12,55,43,-1,0.16
"20230206","1783","1560","1560",港商野村,153,112,41,1,0.15
"20230206","1783","9658","9600",富邦-建國,75,114,39,-1,0.15
"20230207","1783","0035003800350055","5850",統一-南京,225,1,224,1,1.33
"20230207","1783","8710","8710",陽信,3,161,158,-1,0.94
"20230207","1783","1470","1470",台灣摩根士丹利,478,272,206,1,1.23
"20230207","1783","9256","9200",凱基-南崁,24,121,97,-1,0.58
"20230207","1783","1650","1650",新加坡商瑞銀,947,768,179,1,1.07
"20230207","1783","1440","1440",美林,63,148,85,-1,0.51
"20230207","1783","0039003800310055","9800",元大-華山,201,26,175,1,1.04
"20230207","1783","9303","9300",華南永昌-高雄,12,68,56,-1,0.33
"20230207","1783","5110","5110",富隆證券,220,60,160,1,0.95
"20230207","1783","5261","5260",美好-蘆洲,5,46,41,-1,0.24
"20230207","1783","5925","5920",元富-台中,160,10,150,1,0.89
"20230207","1783","5850","5850",統一,134,175,41,-1,0.24
"20230207","1783","003900360035004b","9600",富邦-台中,104,9,95,1,0.57
"20230207","1783","8151","8150",台新-建北,16,56,40,-1,0.24
"20230207","1783","003700370039005a","7790",國票-安和,66,2,64,1,0.38
"20230207","1783","0039003800390042","9800",元大-台中中港,1,36,35,-1,0.21
"20230207","1783","8440","8440",摩根大通,1037,973,64,1,0.38
"20230207","1783","9258","9200",凱基-羅東,34,69,35,-1,0.21
"20230207","1783","9268","9200",凱基-台北,681,622,59,1,0.35
"20230207","1783","0039003200300044","9200",凱基-市府,5,39,34,-1,0.20
"20230207","1783","9898","9800",元大-新莊,124,69,55,1,0.33
"20230207","1783","0039003800390045","9800",元大-草屯,9,43,34,-1,0.20
"20230207","1783","6164","6160",中國信託-文心,59,5,54,1,0.32
"20230207","1783","0035003900320072","5920",元富-城東,35,68,33,-1,0.20
"20230207","1783","0031003200360069","1260",宏遠-光隆,71,28,43,1,0.26
"20230207","1783","8459","8450",康和-嘉義,4,37,33,-1,0.20
"20230207","1783","9252","9200",凱基-嘉義,40,3,37,1,0.22
"20230207","1783","003900410039004c","9A00",永豐金-台中,24,57,33,-1,0.20
"20230208","1783","5854","5850",統一-城中,71,1,70,1,1.09
"20230208","1783","0039004100390055","9A00",永豐金-中正,5,173,168,-1,2.63
"20230208","1783","0039004100390067","9A00",永豐金-內湖,65,10,55,1,0.86
"20230208","1783","1480","1480",美商高盛,140,249,109,-1,1.70
"20230208","1783","0031003000340041","1040",臺銀-臺中,62,13,49,1,0.77
"20230208","1783","9268","9200",凱基-台北,273,379,106,-1,1.66
"20230208","1783","5850","5850",統一,70,28,42,1,0.66
"20230208","1783","9255","9200",凱基-和平,10,65,55,-1,0.86
"20230208","1783","0039003800300064","9800",元大-沙鹿,75,34,41,1,0.64
"20230208","1783","8440","8440",摩根大通,135,187,52,-1,0.81
"20230208","1783","8888","8880",國泰-敦南,162,126,36,1,0.56
"20230208","1783","9800","9800",元大證券,19,65,46,-1,0.72
"20230208","1783","8710","8710",陽信,31,0,31,1,0.48
"20230208","1783","1560","1560",港商野村,53,95,42,-1,0.66
"20230208","1783","0039004100390031","9A00",永豐金-松山,36,5,31,1,0.48
"20230208","1783","9873","9800",元大-西門,1,41,40,-1,0.63
"20230208","1783","1232","1230",彰銀-七賢,29,0,29,1,0.45
"20230208","1783","0039003200310053","9200",凱基-幸福,1,36,35,-1,0.55
"20230208","1783","1440","1440",美林,41,12,29,1,0.45
"20230208","1783","9206","9200",凱基-高雄,2,37,35,-1,0.55
"20230208","1783","9326","9300",華南永昌-南京,40,11,29,1,0.45
"20230208","1783","0036003000310064","6010",(牛牛牛)亞-鑫豐,0,30,30,-1,0.47
"20230208","1783","003900380039004e","9800",元大-內湖,31,2,29,1,0.45
"20230208","1783","003900360031004a","9600",富邦-興業,2,30,28,-1,0.44
"20230208","1783","1470","1470",台灣摩根士丹利,251,223,28,1,0.44
"20230208","1783","0039003100380069","9100",群益金鼎-竹南,1,28,27,-1,0.42
"20230208","1783","8455","8450",康和-台中,24,1,23,1,0.36
"20230208","1783","003700370039005a","7790",國票-安和,8,31,23,-1,0.36
"20230209","1783","8888","8880",國泰-敦南,142,71,71,1,1.52
"20230209","1783","5110","5110",富隆證券,0,160,160,-1,3.42
"20230209","1783","0031003000340041","1040",臺銀-臺中,68,4,64,1,1.37
"20230209","1783","5925","5920",元富-台中,1,150,149,-1,3.18
"20230209","1783","0035003900320072","5920",元富-城東,61,6,55,1,1.17
"20230209","1783","9268","9200",凱基-台北,244,365,121,-1,2.58
"20230209","1783","5850","5850",統一,57,9,48,1,1.02
"20230209","1783","1480","1480",美商高盛,52,160,108,-1,2.31
"20230209","1783","0039003600310043","9600",富邦-南京,55,11,44,1,0.94
"20230209","1783","0039004100300030","9A00",永豐金證券,3,87,84,-1,1.79
"20230209","1783","003700370039006d","7790",國票-中港,43,3,40,1,0.85
"20230209","1783","1650","1650",新加坡商瑞銀,180,262,82,-1,1.75
"20230209","1783","9200","9200",凱基,39,1,38,1,0.81
"20230209","1783","1560","1560",港商野村,64,145,81,-1,1.73
"20230209","1783","0039003800390061","9800",元大-苑裡,43,5,38,1,0.81
"20230209","1783","6164","6160",中國信託-文心,2,50,48,-1,1.02
"20230209","1783","8560","8560",新光,60,23,37,1,0.79
"20230209","1783","003500380035004a","5850",統一-三重,19,56,37,-1,0.79
"20230209","1783","0039003200300047","9200",凱基-彰化,37,1,36,1,0.77
"20230209","1783","6162","6160",中國信託-忠孝,0,31,31,-1,0.66
"20230209","1783","8564","8560",新光-台南,36,5,31,1,0.66
"20230209","1783","9307","9300",華南永昌-大安,1,31,30,-1,0.64
"20230209","1783","0039003100380063","9100",群益金鼎-鳳山,35,5,30,1,0.64
"20230209","1783","0039004100390078","9A00",永豐金-桃園,3,28,25,-1,0.53
"20230209","1783","8710","8710",陽信,30,2,28,1,0.60
"20230209","1783","1232","1230",彰銀-七賢,9,33,24,-1,0.51
"20230209","1783","5856","5850",統一-台中,27,2,25,1,0.53
"20230209","1783","0031003200360044","1260",宏遠-台南,0,24,24,-1,0.51
"20230210","1783","9285","9200",凱基-中壢,55,1,54,1,1.43
"20230210","1783","1470","1470",台灣摩根士丹利,19,199,180,-1,4.75
"20230210","1783","9604","9600",富邦-陽明,57,5,52,1,1.37
"20230210","1783","8440","8440",摩根大通,103,264,161,-1,4.25
"20230210","1783","8888","8880",國泰-敦南,84,43,41,1,1.08
"20230210","1783","0035003800350055","5850",統一-南京,3,102,99,-1,2.61
"20230210","1783","0039003200300047","9200",凱基-彰化,36,0,36,1,0.95
"20230210","1783","0039003800390061","9800",元大-苑裡,7,59,52,-1,1.37
"20230210","1783","9303","9300",華南永昌-高雄,33,0,33,1,0.87
"20230210","1783","9268","9200",凱基-台北,178,228,50,-1,1.32
"20230210","1783","7792","7790",國票-北投,29,0,29,1,0.77
"20230210","1783","9813","9800",元大-八德,24,74,50,-1,1.32
"20230210","1783","8560","8560",新光,66,37,29,1,0.77
"20230210","1783","0039003800300064","9800",元大-沙鹿,3,48,45,-1,1.19
"20230210","1783","9206","9200",凱基-高雄,21,0,21,1,0.55
"20230210","1783","0039003600310043","9600",富邦-南京,32,75,43,-1,1.14
"20230210","1783","9233","9200",凱基-長庚,21,0,21,1,0.55
"20230210","1783","1117","1110",台灣企銀-竹北,9,50,41,-1,1.08
"20230210","1783","1650","1650",新加坡商瑞銀,65,45,20,1,0.53
"20230210","1783","5850","5850",統一,24,64,40,-1,1.06
"20230210","1783","9217","9200",凱基-松山,20,0,20,1,0.53
"20230210","1783","9200","9200",凱基,23,63,40,-1,1.06
"20230210","1783","9309","9300",華南永昌-古亭,17,0,17,1,0.45
"20230210","1783","003700370039006d","7790",國票-中港,23,62,39,-1,1.03
"20230210","1783","0039003800320041","9800",元大-羅東,23,6,17,1,0.45
"20230210","1783","9875","9800",元大-土城永寧,36,67,31,-1,0.82
"20230210","1783","0039003800390064","9800",元大-北屯,16,0,16,1,0.42
"20230210","1783","0039003800390042","9800",元大-台中中港,0,31,31,-1,0.82
"20230213","1783","8561","8560",新光-台中,55,3,52,1,2.66
"20230213","1783","1470","1470",台灣摩根士丹利,27,106,79,-1,4.05
"20230213","1783","0038003800340045","8840",玉山-城中,51,0,51,1,2.61
"20230213","1783","9285","9200",凱基-中壢,5,63,58,-1,2.97
"20230213","1783","5850","5850",統一,56,6,50,1,2.56
"20230213","1783","8440","8440",摩根大通,18,75,57,-1,2.92
"20230213","1783","0039003800300064","9800",元大-沙鹿,47,6,41,1,2.10
"20230213","1783","1650","1650",新加坡商瑞銀,87,139,52,-1,2.66
"20230213","1783","0039003100380046","9100",群益金鼎-新店,31,0,31,1,1.59
"20230213","1783","0039003200300047","9200",凱基-彰化,11,43,32,-1,1.64
"20230213","1783","6464","6460",大昌-新店,23,2,21,1,1.08
"20230213","1783","6164","6160",中國信託-文心,14,41,27,-1,1.38
"20230213","1783","003700370039005a","7790",國票-安和,20,0,20,1,1.02
"20230213","1783","8880","8880",國泰證券,0,27,27,-1,1.38
"20230213","1783","9303","9300",華南永昌-高雄,16,0,16,1,0.82
"20230213","1783","0039004100390066","9A00",永豐金-中盛,5,30,25,-1,1.28
"20230213","1783","0039004100390041","9A00",永豐金-羅東,20,6,14,1,0.72
"20230213","1783","003900360035004b","9600",富邦-台中,1,26,25,-1,1.28
"20230213","1783","003500380035004a","5850",統一-三重,12,0,12,1,0.61
"20230213","1783","5856","5850",統一-台中,2,25,23,-1,1.18
"20230213","1783","7000","7000",兆豐證券,11,0,11,1,0.56
"20230213","1783","9268","9200",凱基-台北,94,116,22,-1,1.13
"20230213","1783","9889","9800",元大-員林,12,1,11,1,0.56
"20230213","1783","0039004100390031","9A00",永豐金-松山,0,16,16,-1,0.82
"20230213","1783","0039003800390053","9800",元大-鹿港,11,0,11,1,0.56
"20230213","1783","0035003800350051","5850",統一-三多,4,16,12,-1,0.61
"20230213","1783","0039004100390057","9A00",永豐金-市政,17,6,11,1,0.56
"20230213","1783","0039003100380069","9100",群益金鼎-竹南,0,11,11,-1,0.56
"20230214","1783","6160","6160",中國信託,88,2,86,1,2.65
"20230214","1783","0035003800350055","5850",統一-南京,1,120,119,-1,3.67
"20230214","1783","9268","9200",凱基-台北,233,153,80,1,2.47
"20230214","1783","5920","5920",元富,0,94,94,-1,2.90
"20230214","1783","9800","9800",元大證券,122,50,72,1,2.22
"20230214","1783","0039004100390067","9A00",永豐金-內湖,17,80,63,-1,1.94
"20230214","1783","1480","1480",美商高盛,135,83,52,1,1.60
"20230214","1783","1440","1440",美林,4,47,43,-1,1.33
"20230214","1783","8440","8440",摩根大通,106,55,51,1,1.57
"20230214","1783","0035003900320072","5920",元富-城東,5,44,39,-1,1.20
"20230214","1783","1560","1560",港商野村,122,77,45,1,1.39
"20230214","1783","8564","8560",新光-台南,4,38,34,-1,1.05
"20230214","1783","9654","9600",富邦-永和,39,1,38,1,1.17
"20230214","1783","5854","5850",統一-城中,0,30,30,-1,0.92
"20230214","1783","0039004100300030","9A00",永豐金證券,42,5,37,1,1.14
"20230214","1783","5850","5850",統一,10,37,27,-1,0.83
"20230214","1783","0035003300380043","5380",第一金-光復,36,0,36,1,1.11
"20230214","1783","8882","8880",國泰-台中,2,29,27,-1,0.83
"20230214","1783","003700370039005a","7790",國票-安和,37,4,33,1,1.02
"20230214","1783","9233","9200",凱基-長庚,0,20,20,-1,0.62
"20230214","1783","8561","8560",新光-台中,34,3,31,1,0.96
"20230214","1783","9366","9300",華南永昌-豐原,0,20,20,-1,0.62
"20230214","1783","0035003800350044","5850",統一-新台中,27,1,26,1,0.80
"20230214","1783","9869","9800",元大-新盛,0,20,20,-1,0.62
"20230214","1783","0037003700390063","7790",國票-敦北法人,25,0,25,1,0.77
"20230214","1783","6915","6910",德信-和平,0,18,18,-1,0.55
"20230214","1783","0039003800390042","9800",元大-台中中港,23,1,22,1,0.68
"20230214","1783","0039003800330057","9800",元大-大里德芳,7,25,18,-1,0.55
"20230215","1783","003900410039004c","9A00",永豐金-台中,49,6,43,1,1.59
"20230215","1783","1480","1480",美商高盛,10,67,57,-1,2.11
"20230215","1783","0031003000340041","1040",臺銀-臺中,40,0,40,1,1.48
"20230215","1783","8440","8440",摩根大通,9,65,56,-1,2.07
"20230215","1783","0039004100390072","9A00",永豐金-北高雄,40,0,40,1,1.48
"20230215","1783","0039003200300047","9200",凱基-彰化,1,50,49,-1,1.81
"20230215","1783","0039004100390078","9A00",永豐金-桃園,38,3,35,1,1.29
"20230215","1783","9134","9100",群益金鼎-開元,13,59,46,-1,1.70
"20230215","1783","9636","9600",富邦-中壢,33,3,30,1,1.11
"20230215","1783","0039003100380063","9100",群益金鼎-鳳山,0,40,40,-1,1.48
"20230215","1783","9268","9200",凱基-台北,194,171,23,1,0.85
"20230215","1783","1560","1560",港商野村,23,62,39,-1,1.44
"20230215","1783","003800340035004a","8450",康和-高雄,22,1,21,1,0.78
"20230215","1783","1440","1440",美林,16,53,37,-1,1.37
"20230215","1783","8561","8560",新光-台中,23,5,18,1,0.67
"20230215","1783","0035003300380043","5380",第一金-光復,3,38,35,-1,1.29
"20230215","1783","0039003600360046","9600",富邦-左營,20,2,18,1,0.67
"20230215","1783","9813","9800",元大-八德,0,32,32,-1,1.18
"20230215","1783","9801","9800",元大-城東,29,14,15,1,0.55
"20230215","1783","003700370039005a","7790",國票-安和,0,23,23,-1,0.85
"20230215","1783","5858","5850",統一-嘉義,15,0,15,1,0.55
"20230215","1783","1650","1650",新加坡商瑞銀,106,123,17,-1,0.63
"20230215","1783","7007","7000",兆豐-竹北,14,1,13,1,0.48
"20230215","1783","0037003700390058","7790",國票-中和,0,16,16,-1,0.59
"20230215","1783","7034","7030",致和-金華,13,1,12,1,0.44
"20230215","1783","9857","9800",元大-東蘆,1,16,15,-1,0.55
"20230215","1783","0039004100390073","9A00",永豐金-彰化,12,0,12,1,0.44
"20230215","1783","5854","5850",統一-城中,1,14,13,-1,0.48
"20230216","1783","0039004100390032","9A00",永豐金-萬盛,45,0,45,1,3.98
"20230216","1783","1470","1470",台灣摩根士丹利,5,79,74,-1,6.54
"20230216","1783","9268","9200",凱基-台北,114,73,41,1,3.62
"20230216","1783","003900380039004e","9800",元大-內湖,1,27,26,-1,2.30
"20230216","1783","1650","1650",新加坡商瑞銀,32,2,30,1,2.65
"20230216","1783","0039004100390031","9A00",永豐金-松山,0,25,25,-1,2.21
"20230216","1783","0038003100350059","8150",台新-新營,31,10,21,1,1.86
"20230216","1783","0039003800310068","9800",元大-屏東民生,0,21,21,-1,1.86
"20230216","1783","003800340035004a","8450",康和-高雄,20,0,20,1,1.77
"20230216","1783","0039004100390072","9A00",永豐金-北高雄,0,16,16,-1,1.41
"20230216","1783","9209","9200",凱基-岡山,20,0,20,1,1.77
"20230216","1783","8150","8150",台新證券,2,17,15,-1,1.33
"20230216","1783","0039003600320056","9600",富邦-復興,16,0,16,1,1.41
"20230216","1783","9658","9600",富邦-建國,0,12,12,-1,1.06
"20230216","1783","1480","1480",美商高盛,18,3,15,1,1.33
"20230216","1783","6451","6450",永全-南崁,0,11,11,-1,0.97
"20230216","1783","0035003900320076","5920",元富-桃園,12,0,12,1,1.06
"20230216","1783","9676","9600",富邦-仁愛,5,16,11,-1,0.97
"20230216","1783","0037003000300057","7000",兆豐-城中,12,0,12,1,1.06
"20230216","1783","1033","1030",土銀-高雄,0,10,10,-1,0.88
"20230216","1783","1440","1440",美林,17,6,11,1,0.97
"20230216","1783","0035003900320067","5920",元富-中原,0,10,10,-1,0.88
"20230216","1783","9800","9800",元大證券,31,20,11,1,0.97
"20230216","1783","8450","8450",康和,0,10,10,-1,0.88
"20230216","1783","0039003100380046","9100",群益金鼎-新店,10,0,10,1,0.88
"20230216","1783","0039003100380045","9100",群益金鼎-南京,0,10,10,-1,0.88
"20230216","1783","5384","5380",第一金-台南,8,0,8,1,0.71
"20230216","1783","5854","5850",統一-城中,1,11,10,-1,0.88
"20230217","1783","0039004100390032","9A00",永豐金-萬盛,55,0,55,1,2.85
"20230217","1783","003900360035004b","9600",富邦-台中,13,57,44,-1,2.28
"20230217","1783","9268","9200",凱基-台北,167,116,51,1,2.64
"20230217","1783","8888","8880",國泰-敦南,45,78,33,-1,1.71
"20230217","1783","1480","1480",美商高盛,94,44,50,1,2.59
"20230217","1783","0038003100350059","8150",台新-新營,1,28,27,-1,1.40
"20230217","1783","8440","8440",摩根大通,76,27,49,1,2.54
"20230217","1783","0039003600310050","9600",富邦-和美,0,19,19,-1,0.98
"20230217","1783","0039004100390053","9A00",永豐金-南京,43,3,40,1,2.07
"20230217","1783","8560","8560",新光,52,70,18,-1,0.93
"20230217","1783","003700370039005a","7790",國票-安和,31,1,30,1,1.55
"20230217","1783","0039004100390038","9A00",永豐金-大園,0,16,16,-1,0.83
"20230217","1783","003800340035004a","8450",康和-高雄,28,0,28,1,1.45
"20230217","1783","1440","1440",美林,15,30,15,-1,0.78
"20230217","1783","1560","1560",港商野村,39,12,27,1,1.40
"20230217","1783","7000","7000",兆豐證券,3,16,13,-1,0.67
"20230217","1783","0031003000320046","1020",合庫-西台中,20,0,20,1,1.04
"20230217","1783","8843","8840",玉山-高雄,2,15,13,-1,0.67
"20230217","1783","0039003800300061","9800",元大-承德,16,0,16,1,0.83
"20230217","1783","0035003900320049","5920",元富-嘉義,1,13,12,-1,0.62
"20230217","1783","9654","9600",富邦-永和,15,0,15,1,0.78
"20230217","1783","0037003000300072","7000",兆豐-寶成,12,24,12,-1,0.62
"20230217","1783","9205","9200",凱基-三重,15,1,14,1,0.72
"20230217","1783","0039004100390052","9A00",永豐金-信義,3,15,12,-1,0.62
"20230217","1783","1650","1650",新加坡商瑞銀,46,33,13,1,0.67
"20230217","1783","0035003900320075","5920",元富-世貿,0,11,11,-1,0.57
"20230217","1783","9300","9300",華南永昌,15,2,13,1,0.67
"20230217","1783","8458","8450",康和-台南,2,13,11,-1,0.57
"20230220","1783","5920","5920",元富,156,2,154,1,1.98
"20230220","1783","5264","5260",美好-高雄,0,200,200,-1,2.57
"20230220","1783","6160","6160",中國信託,159,22,137,1,1.76
"20230220","1783","1480","1480",美商高盛,75,221,146,-1,1.87
"20230220","1783","9216","9200",凱基-信義,130,10,120,1,1.54
"20230220","1783","9623","9600",富邦-台北,21,139,118,-1,1.51
"20230220","1783","9300","9300",華南永昌,171,57,114,1,1.46
"20230220","1783","0031003000340041","1040",臺銀-臺中,5,114,109,-1,1.40
"20230220","1783","0039004100390032","9A00",永豐金-萬盛,122,20,102,1,1.31
"20230220","1783","003800340035004a","8450",康和-高雄,0,96,96,-1,1.23
"20230220","1783","003900380039004e","9800",元大-內湖,103,1,102,1,1.31
"20230220","1783","8710","8710",陽信,20,103,83,-1,1.07
"20230220","1783","0039004100300030","9A00",永豐金證券,127,28,99,1,1.27
"20230220","1783","1650","1650",新加坡商瑞銀,171,235,64,-1,0.82
"20230220","1783","0035003900320072","5920",元富-城東,114,23,91,1,1.17
"20230220","1783","9813","9800",元大-八德,2,57,55,-1,0.71
"20230220","1783","8440","8440",摩根大通,182,100,82,1,1.05
"20230220","1783","003700370039005a","7790",國票-安和,2,51,49,-1,0.63
"20230220","1783","8880","8880",國泰證券,101,20,81,1,1.04
"20230220","1783","0039004100390078","9A00",永豐金-桃園,6,51,45,-1,0.58
"20230220","1783","1031","1030",土銀-台中,71,1,70,1,0.90
"20230220","1783","9208","9200",凱基-桃園,10,49,39,-1,0.50
"20230220","1783","5850","5850",統一,60,16,44,1,0.56
"20230220","1783","0039004100390053","9A00",永豐金-南京,8,43,35,-1,0.45
"20230220","1783","0037003700390063","7790",國票-敦北法人,53,13,40,1,0.51
"20230220","1783","9184","9100",群益金鼎-台中,11,45,34,-1,0.44
"20230220","1783","5851","5850",統一-高雄,63,29,34,1,0.44
"20230220","1783","0035003900320049","5920",元富-嘉義,6,39,33,-1,0.42
"20230221","1783","8710","8710",陽信,135,1,134,1,4.16
"20230221","1783","9307","9300",華南永昌-大安,5,92,87,-1,2.70
"20230221","1783","9268","9200",凱基-台北,182,53,129,1,4.01
"20230221","1783","9623","9600",富邦-台北,3,54,51,-1,1.58
"20230221","1783","5920","5920",元富,77,0,77,1,2.39
"20230221","1783","0039003200300046","9200",凱基-站前,3,52,49,-1,1.52
"20230221","1783","8440","8440",摩根大通,89,31,58,1,1.80
"20230221","1783","003900410039004c","9A00",永豐金-台中,2,47,45,-1,1.40
"20230221","1783","0039004100380046","9A00",永豐金-敦南,56,1,55,1,1.71
"20230221","1783","5851","5850",統一-高雄,0,33,33,-1,1.02
"20230221","1783","0035003900320072","5920",元富-城東,61,8,53,1,1.65
"20230221","1783","5382","5380",第一金-台中,1,33,32,-1,0.99
"20230221","1783","1031","1030",土銀-台中,50,0,50,1,1.55
"20230221","1783","0037003700390075","7790",國票-長城,0,32,32,-1,0.99
"20230221","1783","1560","1560",港商野村,87,42,45,1,1.40
"20230221","1783","5380","5380",第一金,0,28,28,-1,0.87
"20230221","1783","8150","8150",台新證券,62,24,38,1,1.18
"20230221","1783","0039003800300064","9800",元大-沙鹿,2,30,28,-1,0.87
"20230221","1783","1480","1480",美商高盛,97,60,37,1,1.15
"20230221","1783","0035003800350044","5850",統一-新台中,0,27,27,-1,0.84
"20230221","1783","9676","9600",富邦-仁愛,35,3,32,1,0.99
"20230221","1783","1470","1470",台灣摩根士丹利,17,41,24,-1,0.75
"20230221","1783","1650","1650",新加坡商瑞銀,96,66,30,1,0.93
"20230221","1783","9326","9300",華南永昌-南京,11,34,23,-1,0.71
"20230221","1783","9200","9200",凱基,30,0,30,1,0.93
"20230221","1783","0039004100390052","9A00",永豐金-信義,11,33,22,-1,0.68
"20230221","1783","9667","9600",富邦-台南,29,4,25,1,0.78
"20230221","1783","003700370039005a","7790",國票-安和,1,21,20,-1,0.62
"20230222","1783","9100","9100",群益金鼎,256,5,251,1,2.57
"20230222","1783","1650","1650",新加坡商瑞銀,97,166,69,-1,0.71
"20230222","1783","9268","9200",凱基-台北,689,488,201,1,2.06
"20230222","1783","9208","9200",凱基-桃園,13,79,66,-1,0.68
"20230222","1783","5854","5850",統一-城中,204,63,141,1,1.44
"20230222","1783","0039004100380046","9A00",永豐金-敦南,58,117,59,-1,0.60
"20230222","1783","1560","1560",港商野村,237,114,123,1,1.26
"20230222","1783","8888","8880",國泰-敦南,110,166,56,-1,0.57
"20230222","1783","9676","9600",富邦-仁愛,173,58,115,1,1.18
"20230222","1783","9898","9800",元大-新莊,7,60,53,-1,0.54
"20230222","1783","0039004100300030","9A00",永豐金證券,117,34,83,1,0.85
"20230222","1783","6160","6160",中國信託,26,78,52,-1,0.53
"20230222","1783","9661","9600",富邦-新店,92,22,70,1,0.72
"20230222","1783","8880","8880",國泰證券,20,69,49,-1,0.50
"20230222","1783","9604","9600",富邦-陽明,53,6,47,1,0.48
"20230222","1783","0037003000300069","7000",兆豐-松德,2,47,45,-1,0.46
"20230222","1783","9272","9200",凱基-竹科,108,63,45,1,0.46
"20230222","1783","0039003800300064","9800",元大-沙鹿,13,54,41,-1,0.42
"20230222","1783","0039003800330055","9800",元大-頭份,51,7,44,1,0.45
"20230222","1783","0039003600320056","9600",富邦-復興,1,40,39,-1,0.40
"20230222","1783","003900380030004b","9800",元大-竹科,53,11,42,1,0.43
"20230222","1783","0039003100380063","9100",群益金鼎-鳳山,28,63,35,-1,0.36
"20230222","1783","0035003900320072","5920",元富-城東,53,12,41,1,0.42
"20230222","1783","1470","1470",台灣摩根士丹利,36,70,34,-1,0.35
"20230222","1783","003900410039004c","9A00",永豐金-台中,54,15,39,1,0.40
"20230222","1783","1480","1480",美商高盛,97,126,29,-1,0.30
"20230222","1783","003900380031004e","9800",元大-金門,43,5,38,1,0.39
"20230222","1783","0039003800310067","9800",元大-大里,15,41,26,-1,0.27
"20230223","1783","9898","9800",元大-新莊,55,1,54,1,1.69
"20230223","1783","1480","1480",美商高盛,14,156,142,-1,4.46
"20230223","1783","003900380039004e","9800",元大-內湖,53,8,45,1,1.41
"20230223","1783","8440","8440",摩根大通,14,102,88,-1,2.76
"20230223","1783","0039003800390053","9800",元大-鹿港,43,1,42,1,1.32
"20230223","1783","1440","1440",美林,26,105,79,-1,2.48
"20230223","1783","0039004100300030","9A00",永豐金證券,37,4,33,1,1.04
"20230223","1783","9676","9600",富邦-仁愛,7,79,72,-1,2.26
"20230223","1783","0031003000340041","1040",臺銀-臺中,35,5,30,1,0.94
"20230223","1783","9661","9600",富邦-新店,12,76,64,-1,2.01
"20230223","1783","8150","8150",台新證券,32,5,27,1,0.85
"20230223","1783","1650","1650",新加坡商瑞銀,61,109,48,-1,1.51
"20230223","1783","0038003800380041","8880",國泰-館前,37,10,27,1,0.85
"20230223","1783","0039003800330055","9800",元大-頭份,0,46,46,-1,1.44
"20230223","1783","003900380033004e","9800",元大-大安,25,0,25,1,0.78
"20230223","1783","1470","1470",台灣摩根士丹利,49,91,42,-1,1.32
"20230223","1783","0039003800320041","9800",元大-羅東,25,1,24,1,0.75
"20230223","1783","9268","9200",凱基-台北,113,155,42,-1,1.32
"20230223","1783","5854","5850",統一-城中,24,0,24,1,0.75
"20230223","1783","9131","9100",群益金鼎-民權,10,47,37,-1,1.16
"20230223","1783","0031003100310045","1110",台灣企銀-桃園,23,1,22,1,0.69
"20230223","1783","003500380035005a","5850",統一-松江,0,36,36,-1,1.13
"20230223","1783","0039003600310048","9600",富邦-新板,21,0,21,1,0.66
"20230223","1783","0039004100390039","9A00",永豐金-中壢,2,37,35,-1,1.10
"20230223","1783","8888","8880",國泰-敦南,51,31,20,1,0.63
"20230223","1783","003900410039004c","9A00",永豐金-台中,9,42,33,-1,1.04
"20230223","1783","0039003800330066","9800",元大-竹東,20,0,20,1,0.63
"20230223","1783","0039004100380039","9A00",永豐金-敦北,1,33,32,-1,1.00
"20230224","1783","1470","1470",台灣摩根士丹利,153,6,147,1,5.68
"20230224","1783","5921","5920",元富-高雄,0,100,100,-1,3.86
"20230224","1783","1480","1480",美商高盛,80,22,58,1,2.24
"20230224","1783","0038003800340045","8840",玉山-城中,0,80,80,-1,3.09
"20230224","1783","9300","9300",華南永昌,55,1,54,1,2.09
"20230224","1783","1440","1440",美林,5,75,70,-1,2.70
"20230224","1783","0031003000340041","1040",臺銀-臺中,50,5,45,1,1.74
"20230224","1783","9205","9200",凱基-三重,7,63,56,-1,2.16
"20230224","1783","9676","9600",富邦-仁愛,65,25,40,1,1.54
"20230224","1783","9859","9800",元大-新竹經國,1,50,49,-1,1.89
"20230224","1783","9654","9600",富邦-永和,34,0,34,1,1.31
"20230224","1783","0039004100300030","9A00",永豐金證券,56,101,45,-1,1.74
"20230224","1783","8560","8560",新光,49,17,32,1,1.24
"20230224","1783","0039003100380046","9100",群益金鼎-新店,0,40,40,-1,1.54
"20230224","1783","0039004100390041","9A00",永豐金-羅東,38,6,32,1,1.24
"20230224","1783","9209","9200",凱基-岡山,0,40,40,-1,1.54
"20230224","1783","7792","7790",國票-北投,30,0,30,1,1.16
"20230224","1783","9206","9200",凱基-高雄,0,34,34,-1,1.31
"20230224","1783","003900380039004e","9800",元大-內湖,25,0,25,1,0.97
"20230224","1783","9307","9300",華南永昌-大安,2,34,32,-1,1.24
"20230224","1783","9268","9200",凱基-台北,146,123,23,1,0.89
"20230224","1783","0039003800390042","9800",元大-台中中港,0,32,32,-1,1.24
"20230224","1783","9324","9300",華南永昌-岡山,25,2,23,1,0.89
"20230224","1783","9636","9600",富邦-中壢,7,36,29,-1,1.12
"20230224","1783","0031003100310045","1110",台灣企銀-桃園,21,1,20,1,0.77
"20230224","1783","0035003900320076","5920",元富-桃園,0,24,24,-1,0.93
"20230224","1783","9278","9200",凱基-永康,19,0,19,1,0.73
"20230224","1783","8710","8710",陽信,0,21,21,-1,0.81
"20230103","1783","1021","1020",合庫-台中,102,0,102,1,4.51
"20230103","1783","0035003800350055","5850",統一-南京,2,160,158,-1,6.98
"20230103","1783","1650","1650",新加坡商瑞銀,131,34,97,1,4.29
"20230103","1783","8843","8840",玉山-高雄,5,109,104,-1,4.60
"20230103","1783","9307","9300",華南永昌-大安,87,0,87,1,3.84
"20230103","1783","0039003800390047","9800",元大-大同,0,100,100,-1,4.42
"20230103","1783","1470","1470",台灣摩根士丹利,140,99,41,1,1.81
"20230103","1783","0039004100390067","9A00",永豐金-內湖,18,47,29,-1,1.28
"20230103","1783","1480","1480",美商高盛,55,19,36,1,1.59
"20230103","1783","0039003800330069","9800",元大-大雅,3,25,22,-1,0.97
"20230103","1783","9614","9600",富邦-基隆,44,10,34,1,1.50
"20230103","1783","7005","7000",兆豐-台中港,2,23,21,-1,0.93
"20230103","1783","0039003600310047","9600",富邦-成功,31,0,31,1,1.37
"20230103","1783","0031003000320041","1020",合庫-新竹,0,15,15,-1,0.66
"20230103","1783","0031003000320046","1020",合庫-西台中,30,0,30,1,1.33
"20230103","1783","9138","9100",群益金鼎-中港,2,17,15,-1,0.66
"20230103","1783","0038003400350041","8450",康和-內湖,28,0,28,1,1.24
"20230103","1783","003900320030004d","9200",凱基-宜蘭,0,15,15,-1,0.66
"20230103","1783","9800","9800",元大證券,47,23,24,1,1.06
"20230103","1783","0039004100390053","9A00",永豐金-南京,3,15,12,-1,0.53
"20230103","1783","003900380039004a","9800",元大-彰化民生,21,0,21,1,0.93
"20230103","1783","8455","8450",康和-台中,2,12,10,-1,0.44
"20230103","1783","5380","5380",第一金,20,0,20,1,0.88
"20230103","1783","9362","9300",華南永昌-苗栗,0,10,10,-1,0.44
"20230103","1783","9103","9100",群益金鼎-松山,20,0,20,1,0.88
"20230103","1783","0039003600310053","9600",富邦-景美,0,9,9,-1,0.40
"20230103","1783","8150","8150",台新證券,32,12,20,1,0.88
"20230103","1783","0039003600320043","9600",富邦-東門,1,10,9,-1,0.40
"20230104","1783","0037003000300069","7000",兆豐-松德,46,0,46,1,2.71
"20230104","1783","1650","1650",新加坡商瑞銀,18,71,53,-1,3.12
"20230104","1783","1480","1480",美商高盛,49,4,45,1,2.65
"20230104","1783","0039004100390069","9A00",永豐金-新店,3,54,51,-1,3.00
"20230104","1783","9692","9600",富邦-嘉義,41,0,41,1,2.41
"20230104","1783","0037003000300053","7000",兆豐-大同,3,51,48,-1,2.83
"20230104","1783","0039003800310047","9800",元大-彰化,33,0,33,1,1.94
"20230104","1783","8843","8840",玉山-高雄,4,31,27,-1,1.59
"20230104","1783","1440","1440",美林,29,8,21,1,1.24
"20230104","1783","9227","9200",凱基-城中,0,23,23,-1,1.35
"20230104","1783","5386","5380",第一金-彰化,20,0,20,1,1.18
"20230104","1783","0039003200310053","9200",凱基-幸福,0,22,22,-1,1.30
"20230104","1783","9614","9600",富邦-基隆,30,10,20,1,1.18
"20230104","1783","1023","1020",合庫-高雄,0,20,20,-1,1.18
"20230104","1783","9268","9200",凱基-台北,49,30,19,1,1.12
"20230104","1783","0031003000330042","1030",土銀-彰化,0,20,20,-1,1.18
"20230104","1783","8150","8150",台新證券,35,16,19,1,1.12
"20230104","1783","5858","5850",統一-嘉義,0,20,20,-1,1.18
"20230104","1783","9307","9300",華南永昌-大安,16,0,16,1,0.94
"20230104","1783","003900320030004e","9200",凱基-湖口,0,18,18,-1,1.06
"20230104","1783","003900380039004a","9800",元大-彰化民生,16,1,15,1,0.88
"20230104","1783","9322","9300",華南永昌-公誠,2,18,16,-1,0.94
"20230104","1783","0039004100390031","9A00",永豐金-松山,14,0,14,1,0.82
"20230104","1783","9623","9600",富邦-台北,10,26,16,-1,0.94
"20230104","1783","6168","6160",中國信託-嘉義,13,0,13,1,0.77
"20230104","1783","8882","8880",國泰-台中,5,21,16,-1,0.94
"20230104","1783","6380","6380",光和,13,0,13,1,0.77
"20230104","1783","9186","9100",群益金鼎-新竹,0,12,12,-1,0.71
"20230105","1783","1470","1470",台灣摩根士丹利,170,15,155,1,6.37
"20230105","1783","9692","9600",富邦-嘉義,0,41,41,-1,1.69
"20230105","1783","1480","1480",美商高盛,116,7,109,1,4.48
"20230105","1783","0035003800350055","5850",統一-南京,10,50,40,-1,1.64
"20230105","1783","9268","9200",凱基-台北,106,35,71,1,2.92
"20230105","1783","9307","9300",華南永昌-大安,16,49,33,-1,1.36
"20230105","1783","1560","1560",港商野村,65,17,48,1,1.97
"20230105","1783","0039003800310047","9800",元大-彰化,0,32,32,-1,1.32
"20230105","1783","0037003000300069","7000",兆豐-松德,33,3,30,1,1.23
"20230105","1783","0038003400350041","8450",康和-內湖,1,30,29,-1,1.19
"20230105","1783","8150","8150",台新證券,56,28,28,1,1.15
"20230105","1783","8843","8840",玉山-高雄,0,25,25,-1,1.03
"20230105","1783","8560","8560",新光,38,13,25,1,1.03
"20230105","1783","5386","5380",第一金-彰化,0,20,20,-1,0.82
"20230105","1783","1440","1440",美林,62,42,20,1,0.82
"20230105","1783","8561","8560",新光-台中,13,32,19,-1,0.78
"20230105","1783","6162","6160",中國信託-忠孝,20,1,19,1,0.78
"20230105","1783","003900360035004b","9600",富邦-台中,0,17,17,-1,0.70
"20230105","1783","0039003600310044","9600",富邦-忠孝,20,2,18,1,0.74
"20230105","1783","9800","9800",元大證券,13,29,16,-1,0.66
"20230105","1783","8440","8440",摩根大通,27,10,17,1,0.70
"20230105","1783","1117","1110",台灣企銀-竹北,0,15,15,-1,0.62
"20230105","1783","9894","9800",元大-桃興,16,0,16,1,0.66
"20230105","1783","0035003900320072","5920",元富-城東,5,20,15,-1,0.62
"20230105","1783","003900380031006d","9800",元大-前金,25,10,15,1,0.62
"20230105","1783","1020","1020",合庫證券,0,14,14,-1,0.58
"20230105","1783","9623","9600",富邦-台北,39,26,13,1,0.53
"20230105","1783","5858","5850",統一-嘉義,0,14,14,-1,0.58
"20230106","1783","0039004100390050","9A00",永豐金-竹北,181,6,175,1,5.23
"20230106","1783","1470","1470",台灣摩根士丹利,69,155,86,-1,2.57
"20230106","1783","9692","9600",富邦-嘉義,82,17,65,1,1.94
"20230106","1783","9268","9200",凱基-台北,65,149,84,-1,2.51
"20230106","1783","0039003800390053","9800",元大-鹿港,50,1,49,1,1.46
"20230106","1783","8560","8560",新光,38,121,83,-1,2.48
"20230106","1783","0038003800380041","8880",國泰-館前,37,8,29,1,0.87
"20230106","1783","8440","8440",摩根大通,7,80,73,-1,2.18
"20230106","1783","9183","9100",群益金鼎-高雄,23,1,22,1,0.66
"20230106","1783","1560","1560",港商野村,24,81,57,-1,1.70
"20230106","1783","9216","9200",凱基-信義,21,1,20,1,0.60
"20230106","1783","0035003300380044","5380",第一金-忠孝,0,51,51,-1,1.52
"20230106","1783","8880","8880",國泰證券,16,0,16,1,0.48
"20230106","1783","1440","1440",美林,21,68,47,-1,1.40
"20230106","1783","6460","6460",大昌,16,1,15,1,0.45
"20230106","1783","1650","1650",新加坡商瑞銀,25,65,40,-1,1.19
"20230106","1783","6164","6160",中國信託-文心,19,5,14,1,0.42
"20230106","1783","5853","5850",統一-中壢,0,23,23,-1,0.69
"20230106","1783","003900320031004d","9200",凱基-八德,18,4,14,1,0.42
"20230106","1783","0039003600310044","9600",富邦-忠孝,7,28,21,-1,0.63
"20230106","1783","8881","8880",國泰-高雄,18,5,13,1,0.39
"20230106","1783","003900380039004a","9800",元大-彰化民生,5,26,21,-1,0.63
"20230106","1783","0039003600310052","9600",富邦-南員林,12,0,12,1,0.36
"20230106","1783","6162","6160",中國信託-忠孝,1,21,20,-1,0.60
"20230106","1783","9875","9800",元大-土城永寧,11,0,11,1,0.33
"20230106","1783","9894","9800",元大-桃興,0,16,16,-1,0.48
"20230106","1783","9324","9300",華南永昌-岡山,11,0,11,1,0.33
"20230106","1783","0039003600320051","9600",富邦-北高雄,12,28,16,-1,0.48
"20230109","1783","1440","1440",美林,126,38,88,1,4.14
"20230109","1783","0039003600310047","9600",富邦-成功,1,31,30,-1,1.41
"20230109","1783","1480","1480",美商高盛,62,4,58,1,2.73
"20230109","1783","0035003300380041","5380",第一金-新興,1,28,27,-1,1.27
"20230109","1783","1650","1650",新加坡商瑞銀,88,32,56,1,2.64
"20230109","1783","9183","9100",群益金鼎-高雄,2,24,22,-1,1.04
"20230109","1783","1470","1470",台灣摩根士丹利,73,21,52,1,2.45
"20230109","1783","0031003000320047","1020",合庫-三重,0,20,20,-1,0.94
"20230109","1783","0037003000300069","7000",兆豐-松德,72,31,41,1,1.93
"20230109","1783","6915","6910",德信-和平,0,20,20,-1,0.94
"20230109","1783","9333","9300",華南永昌-長虹,23,1,22,1,1.04
"20230109","1783","0035003900320072","5920",元富-城東,0,18,18,-1,0.85
"20230109","1783","9654","9600",富邦-永和,22,0,22,1,1.04
"20230109","1783","0037003700390063","7790",國票-敦北法人,1,19,18,-1,0.85
"20230109","1783","8880","8880",國泰證券,17,0,17,1,0.80
"20230109","1783","1117","1110",台灣企銀-竹北,0,15,15,-1,0.71
"20230109","1783","8151","8150",台新-建北,16,0,16,1,0.75
"20230109","1783","8150","8150",台新證券,8,20,12,-1,0.56
"20230109","1783","9296","9200",凱基-頭份,14,0,14,1,0.66
"20230109","1783","9604","9600",富邦-陽明,3,15,12,-1,0.56
"20230109","1783","0039003100380057","9100",群益金鼎-忠孝,13,0,13,1,0.61
"20230109","1783","003500320036004b","5260",美好-富順,5,16,11,-1,0.52
"20230109","1783","0039004100390057","9A00",永豐金-市政,13,0,13,1,0.61
"20230109","1783","9324","9300",華南永昌-岡山,0,11,11,-1,0.52
"20230109","1783","6160","6160",中國信託,17,5,12,1,0.56
"20230109","1783","9362","9300",華南永昌-苗栗,10,21,11,-1,0.52
"20230109","1783","9327","9300",華南永昌-斗六,12,1,11,1,0.52
"20230109","1783","0037003000300061","7000",兆豐-忠孝,0,10,10,-1,0.47
"20230110","1783","0035003800350063","5850",統一-仁愛,35,0,35,1,2.99
"20230110","1783","9103","9100",群益金鼎-松山,0,40,40,-1,3.41
"20230110","1783","0035003900320045","5920",元富-城中,35,1,34,1,2.90
"20230110","1783","1480","1480",美商高盛,14,53,39,-1,3.33
"20230110","1783","5921","5920",元富-高雄,30,2,28,1,2.39
"20230110","1783","1650","1650",新加坡商瑞銀,4,39,35,-1,2.99
"20230110","1783","8150","8150",台新證券,26,4,22,1,1.88
"20230110","1783","8880","8880",國泰證券,0,33,33,-1,2.82
"20230110","1783","0039004100390044","9A00",永豐金-忠孝,21,0,21,1,1.79
"20230110","1783","1440","1440",美林,40,64,24,-1,2.05
"20230110","1783","8713","8710",陽信-高雄,20,0,20,1,1.71
"20230110","1783","8560","8560",新光,3,23,20,-1,1.71
"20230110","1783","6168","6160",中國信託-嘉義,15,0,15,1,1.28
"20230110","1783","1470","1470",台灣摩根士丹利,23,38,15,-1,1.28
"20230110","1783","9296","9200",凱基-頭份,15,0,15,1,1.28
"20230110","1783","6460","6460",大昌,1,15,14,-1,1.19
"20230110","1783","003900380030004b","9800",元大-竹科,13,0,13,1,1.11
"20230110","1783","8842","8840",玉山-新莊,0,14,14,-1,1.19
"20230110","1783","0035003900320072","5920",元富-城東,11,0,11,1,0.94
"20230110","1783","6160","6160",中國信託,6,19,13,-1,1.11
"20230110","1783","003700370039005a","7790",國票-安和,10,0,10,1,0.85
"20230110","1783","9856","9800",元大-花蓮,0,12,12,-1,1.02
"20230110","1783","0039003600320058","9600",富邦-文化,10,0,10,1,0.85
"20230110","1783","5269","5260",美好-台中,0,11,11,-1,0.94
"20230110","1783","0039003800330069","9800",元大-大雅,8,0,8,1,0.68
"20230110","1783","0035003900320071","5920",元富-屏東,0,10,10,-1,0.85
"20230110","1783","0039004100390058","9A00",永豐金-竹科,8,0,8,1,0.68
"20230110","1783","0039003100380065","9100",群益金鼎-大安,0,10,10,-1,0.85
"20230111","1783","1470","1470",台灣摩根士丹利,58,5,53,1,5.57
"20230111","1783","8560","8560",新光,4,28,24,-1,2.52
"20230111","1783","1480","1480",美商高盛,30,0,30,1,3.15
"20230111","1783","0035003900320045","5920",元富-城中,1,21,20,-1,2.10
"20230111","1783","6162","6160",中國信託-忠孝,30,0,30,1,3.15
"20230111","1783","1440","1440",美林,10,29,19,-1,2.00
"20230111","1783","9676","9600",富邦-仁愛,26,0,26,1,2.73
"20230111","1783","8150","8150",台新證券,0,14,14,-1,1.47
"20230111","1783","9692","9600",富邦-嘉義,21,2,19,1,2.00
"20230111","1783","1650","1650",新加坡商瑞銀,4,18,14,-1,1.47
"20230111","1783","1560","1560",港商野村,15,0,15,1,1.58
"20230111","1783","0039003100380067","9100",群益金鼎-大甲,2,16,14,-1,1.47
"20230111","1783","0039003800390042","9800",元大-台中中港,16,1,15,1,1.58
"20230111","1783","0039003100380057","9100",群益金鼎-忠孝,0,14,14,-1,1.47
"20230111","1783","0039003800340048","9800",元大-景美,11,1,10,1,1.05
"20230111","1783","8561","8560",新光-台中,2,15,13,-1,1.37
"20230111","1783","0039003600310044","9600",富邦-忠孝,10,0,10,1,1.05
"20230111","1783","0039003600310057","9600",富邦-東花蓮,0,12,12,-1,1.26
"20230111","1783","9308","9300",華南永昌-麻豆,7,0,7,1,0.74
"20230111","1783","5850","5850",統一,1,11,10,-1,1.05
"20230111","1783","0039004100360031","9A00",永豐金-鳳山,10,3,7,1,0.74
"20230111","1783","6385","6380",光和-花壇,0,10,10,-1,1.05
"20230111","1783","003900380039006b","9800",元大-古亭,6,0,6,1,0.63
"20230111","1783","003700370039005a","7790",國票-安和,0,10,10,-1,1.05
"20230111","1783","9302","9300",華南永昌-台中,11,6,5,1,0.53
"20230111","1783","8843","8840",玉山-高雄,1,11,10,-1,1.05
"20230111","1783","0039003100330059","9100",群益金鼎-館前,5,0,5,1,0.53
"20230111","1783","0039004100390064","9A00",永豐金-古亭,1,10,9,-1,0.95
"20230112","1783","1470","1470",台灣摩根士丹利,64,12,52,1,6.32
"20230112","1783","1021","1020",合庫-台中,0,23,23,-1,2.79
"20230112","1783","1480","1480",美商高盛,32,8,24,1,2.92
"20230112","1783","0039004100390067","9A00",永豐金-內湖,0,21,21,-1,2.55
"20230112","1783","8440","8440",摩根大通,58,34,24,1,2.92
"20230112","1783","6116","6110",台中銀-高雄,0,20,20,-1,2.43
"20230112","1783","1650","1650",新加坡商瑞銀,37,18,19,1,2.31
"20230112","1783","9692","9600",富邦-嘉義,0,20,20,-1,2.43
"20230112","1783","8560","8560",新光,18,2,16,1,1.94
"20230112","1783","0035003300380044","5380",第一金-忠孝,0,17,17,-1,2.07
"20230112","1783","003900360031004d","9600",富邦-木柵,15,0,15,1,1.82
"20230112","1783","9647","9600",富邦-新竹,7,23,16,-1,1.94
"20230112","1783","0038003100350042","8150",台新-台中,12,0,12,1,1.46
"20230112","1783","9676","9600",富邦-仁愛,0,12,12,-1,1.46
"20230112","1783","6164","6160",中國信託-文心,12,1,11,1,1.34
"20230112","1783","003600310036004b","6160",中國信託-高雄,1,11,10,-1,1.22
"20230112","1783","8881","8880",國泰-高雄,8,0,8,1,0.97
"20230112","1783","0039003600310044","9600",富邦-忠孝,0,10,10,-1,1.22
"20230112","1783","9296","9200",凱基-頭份,7,0,7,1,0.85
"20230112","1783","0039003600320058","9600",富邦-文化,0,10,10,-1,1.22
"20230112","1783","9217","9200",凱基-松山,5,0,5,1,0.61
"20230112","1783","0038003400350041","8450",康和-內湖,6,14,8,-1,0.97
"20230112","1783","9327","9300",華南永昌-斗六,5,0,5,1,0.61
"20230112","1783","9604","9600",富邦-陽明,3,11,8,-1,0.97
"20230112","1783","0039003800310071","9800",元大-萬華,5,0,5,1,0.61
"20230112","1783","0037003000300069","7000",兆豐-松德,2,9,7,-1,0.85
"20230112","1783","1560","1560",港商野村,21,17,4,1,0.49
"20230112","1783","5320","5320",高橋,0,6,6,-1,0.73
"20230113","1783","1470","1470",台灣摩根士丹利,202,3,199,1,3.13
"20230113","1783","9339","9300",華南永昌-竹北,0,90,90,-1,1.42
"20230113","1783","1650","1650",新加坡商瑞銀,248,49,199,1,3.13
"20230113","1783","003800380038004b","8880",國泰-板橋,14,100,86,-1,1.35
"20230113","1783","9268","9200",凱基-台北,424,263,161,1,2.53
"20230113","1783","9235","9200",凱基-永華,0,81,81,-1,1.27
"20230113","1783","9658","9600",富邦-建國,216,62,154,1,2.42
"20230113","1783","1021","1020",合庫-台中,0,51,51,-1,0.80
"20230113","1783","1440","1440",美林,224,95,129,1,2.03
"20230113","1783","8150","8150",台新證券,31,67,36,-1,0.57
"20230113","1783","9676","9600",富邦-仁愛,114,27,87,1,1.37
"20230113","1783","0031003000320046","1020",合庫-西台中,5,31,26,-1,0.41
"20230113","1783","0035003300380043","5380",第一金-光復,85,8,77,1,1.21
"20230113","1783","0039003200320048","9200",凱基-復興,1,27,26,-1,0.41
"20230113","1783","0039003800300061","9800",元大-承德,68,9,59,1,0.93
"20230113","1783","8713","8710",陽信-高雄,0,25,25,-1,0.39
"20230113","1783","1480","1480",美商高盛,89,36,53,1,0.83
"20230113","1783","0039003600310048","9600",富邦-新板,11,36,25,-1,0.39
"20230113","1783","9816","9800",元大-新竹,63,28,35,1,0.55
"20230113","1783","0038003800380041","8880",國泰-館前,9,33,24,-1,0.38
"20230113","1783","6164","6160",中國信託-文心,57,24,33,1,0.52
"20230113","1783","0035003900320045","5920",元富-城中,3,25,22,-1,0.35
"20230113","1783","0039004100390057","9A00",永豐金-市政,41,9,32,1,0.50
"20230113","1783","0037003000300069","7000",兆豐-松德,9,31,22,-1,0.35
"20230113","1783","9667","9600",富邦-台南,60,30,30,1,0.47
"20230113","1783","0035003800350063","5850",統一-仁愛,1,22,21,-1,0.33
"20230113","1783","0039003800330066","9800",元大-竹東,31,2,29,1,0.46
"20230113","1783","0035003900320042","5920",元富-永和,0,21,21,-1,0.33
"20230116","1783","9268","9200",凱基-台北,319,195,124,1,2.97
"20230116","1783","8150","8150",台新證券,18,71,53,-1,1.27
"20230116","1783","9676","9600",富邦-仁愛,163,45,118,1,2.83
"20230116","1783","1480","1480",美商高盛,12,61,49,-1,1.17
"20230116","1783","0039003800300061","9800",元大-承德,32,0,32,1,0.77
"20230116","1783","9816","9800",元大-新竹,16,52,36,-1,0.86
"20230116","1783","0039003800390043","9800",元大-板橋,50,26,24,1,0.57
"20230116","1783","9327","9300",華南永昌-斗六,0,30,30,-1,0.72
"20230116","1783","0039003600320051","9600",富邦-北高雄,29,6,23,1,0.55
"20230116","1783","9667","9600",富邦-台南,3,32,29,-1,0.69
"20230116","1783","8440","8440",摩根大通,454,432,22,1,0.53
"20230116","1783","0039003600320044","9600",富邦-新莊,4,31,27,-1,0.65
"20230116","1783","0039004100390057","9A00",永豐金-市政,41,19,22,1,0.53
"20230116","1783","9893","9800",元大-大天母,0,25,25,-1,0.60
"20230116","1783","1440","1440",美林,109,88,21,1,0.50
"20230116","1783","0037003000300069","7000",兆豐-松德,4,26,22,-1,0.53
"20230116","1783","0039004100390038","9A00",永豐金-大園,20,0,20,1,0.48
"20230116","1783","0039003600390043","9600",富邦-北港,1,21,20,-1,0.48
"20230116","1783","0035003900320045","5920",元富-城中,21,3,18,1,0.43
"20230116","1783","0031003200360069","1260",宏遠-光隆,2,21,19,-1,0.46
"20230116","1783","9815","9800",元大-大灣,19,2,17,1,0.41
"20230116","1783","5855","5850",統一-台南,3,21,18,-1,0.43
"20230116","1783","9647","9600",富邦-新竹,19,4,15,1,0.36
"20230116","1783","0031003000320043","1020",合庫-自強,1,18,17,-1,0.41
"20230116","1783","9252","9200",凱基-嘉義,16,1,15,1,0.36
"20230116","1783","8888","8880",國泰-敦南,41,58,17,-1,0.41
"20230116","1783","9256","9200",凱基-南崁,15,1,14,1,0.34
"20230116","1783","7034","7030",致和-金華,16,31,15,-1,0.36
"20230117","1783","0039003200300046","9200",凱基-站前,111,16,95,1,3.40
"20230117","1783","9268","9200",凱基-台北,100,261,161,-1,5.76
"20230117","1783","9235","9200",凱基-永華,78,0,78,1,2.79
"20230117","1783","1650","1650",新加坡商瑞銀,91,220,129,-1,4.62
"20230117","1783","9654","9600",富邦-永和,34,1,33,1,1.18
"20230117","1783","1440","1440",美林,6,68,62,-1,2.22
"20230117","1783","8565","8560",新光-桃園,37,11,26,1,0.93
"20230117","1783","1480","1480",美商高盛,3,42,39,-1,1.40
"20230117","1783","0039003100380057","9100",群益金鼎-忠孝,24,3,21,1,0.75
"20230117","1783","1560","1560",港商野村,0,22,22,-1,0.79
"20230117","1783","0031003000320046","1020",合庫-西台中,20,0,20,1,0.72
"20230117","1783","1470","1470",台灣摩根士丹利,73,93,20,-1,0.72
"20230117","1783","9686","9600",富邦-宜蘭,20,0,20,1,0.72
"20230117","1783","0037003000300068","7000",兆豐-三民,3,23,20,-1,0.72
"20230117","1783","9322","9300",華南永昌-公誠,21,2,19,1,0.68
"20230117","1783","0035003300380057","5380",第一金-華江,1,15,14,-1,0.50
"20230117","1783","003900380039004e","9800",元大-內湖,18,0,18,1,0.64
"20230117","1783","0039003600320051","9600",富邦-北高雄,3,14,11,-1,0.39
"20230117","1783","5264","5260",美好-高雄,18,0,18,1,0.64
"20230117","1783","0039004100390069","9A00",永豐金-新店,1,11,10,-1,0.36
"20230117","1783","0039004100390057","9A00",永豐金-市政,18,0,18,1,0.64
"20230117","1783","0039004100390050","9A00",永豐金-竹北,8,18,10,-1,0.36
"20230117","1783","003500390032006e","5920",元富-西松,16,2,14,1,0.50
"20230117","1783","8151","8150",台新-建北,6,15,9,-1,0.32
"20230117","1783","0037003000300069","7000",兆豐-松德,12,0,12,1,0.43
"20230117","1783","8883","8880",國泰-松江,0,9,9,-1,0.32
"20230117","1783","0039004100390067","9A00",永豐金-內湖,12,0,12,1,0.43
"20230117","1783","8710","8710",陽信,0,8,8,-1,0.29
"20230130","1783","1650","1650",新加坡商瑞銀,84,43,41,1,3.43
"20230130","1783","9324","9300",華南永昌-岡山,0,52,52,-1,4.35
"20230130","1783","8150","8150",台新證券,40,4,36,1,3.01
"20230130","1783","9647","9600",富邦-新竹,0,24,24,-1,2.01
"20230130","1783","9339","9300",華南永昌-竹北,25,0,25,1,2.09
"20230130","1783","0039003800300064","9800",元大-沙鹿,0,24,24,-1,2.01
"20230130","1783","6165","6160",中國信託-新竹,20,0,20,1,1.67
"20230130","1783","9307","9300",華南永昌-大安,0,20,20,-1,1.67
"20230130","1783","0039003800330066","9800",元大-竹東,20,0,20,1,1.67
"20230130","1783","0039003800390042","9800",元大-台中中港,1,21,20,-1,1.67
"20230130","1783","0035003900320072","5920",元富-城東,18,0,18,1,1.51
"20230130","1783","9654","9600",富邦-永和,0,19,19,-1,1.59
"20230130","1783","8561","8560",新光-台中,19,1,18,1,1.51
"20230130","1783","9875","9800",元大-土城永寧,0,18,18,-1,1.51
"20230130","1783","8888","8880",國泰-敦南,21,5,16,1,1.34
"20230130","1783","0039003800390043","9800",元大-板橋,0,17,17,-1,1.42
"20230130","1783","1470","1470",台灣摩根士丹利,31,17,14,1,1.17
"20230130","1783","9268","9200",凱基-台北,92,108,16,-1,1.34
"20230130","1783","003500380035004a","5850",統一-三重,14,0,14,1,1.17
"20230130","1783","9308","9300",華南永昌-麻豆,0,14,14,-1,1.17
"20230130","1783","0035003900320055","5920",元富-宜蘭,14,0,14,1,1.17
"20230130","1783","003700300030005a","7000",兆豐-高雄,0,13,13,-1,1.09
"20230130","1783","8882","8880",國泰-台中,19,5,14,1,1.17
"20230130","1783","9814","9800",元大-大益,0,12,12,-1,1.00
"20230130","1783","7034","7030",致和-金華,15,4,11,1,0.92
"20230130","1783","8560","8560",新光,8,19,11,-1,0.92
"20230130","1783","9255","9200",凱基-和平,14,4,10,1,0.84
"20230130","1783","0039003600320051","9600",富邦-北高雄,0,11,11,-1,0.92
"20230131","1783","9202","9200",凱基-中港,100,1,99,1,2.51
"20230131","1783","5603","5600",永興-台中,0,125,125,-1,3.17
"20230131","1783","8565","8560",新光-桃園,118,20,98,1,2.49
"20230131","1783","0039003800300061","9800",元大-承德,0,80,80,-1,2.03
"20230131","1783","9205","9200",凱基-三重,100,3,97,1,2.46
"20230131","1783","8840","8840",玉山證券,10,87,77,-1,1.96
"20230131","1783","5920","5920",元富,97,1,96,1,2.44
"20230131","1783","0039004100390050","9A00",永豐金-竹北,3,78,75,-1,1.90
"20230131","1783","9268","9200",凱基-台北,402,310,92,1,2.34
"20230131","1783","9134","9100",群益金鼎-開元,1,65,64,-1,1.63
"20230131","1783","0039004100390052","9A00",永豐金-信義,91,10,81,1,2.06
"20230131","1783","1650","1650",新加坡商瑞銀,59,113,54,-1,1.37
"20230131","1783","1440","1440",美林,65,16,49,1,1.24
"20230131","1783","9235","9200",凱基-永華,0,50,50,-1,1.27
"20230131","1783","0039003800300064","9800",元大-沙鹿,40,0,40,1,1.02
"20230131","1783","9339","9300",華南永昌-竹北,0,35,35,-1,0.89
"20230131","1783","0036003000310064","6010",(牛牛牛)亞-鑫豐,38,0,38,1,0.96
"20230131","1783","8150","8150",台新證券,7,38,31,-1,0.79
"20230131","1783","7000","7000",兆豐證券,47,11,36,1,0.91
"20230131","1783","9208","9200",凱基-桃園,3,32,29,-1,0.74
"20230131","1783","0039003200300046","9200",凱基-站前,40,5,35,1,0.89
"20230131","1783","0038003800340045","8840",玉山-城中,5,32,27,-1,0.69
"20230131","1783","0037003000300069","7000",兆豐-松德,38,6,32,1,0.81
"20230131","1783","0039003100330044","9100",群益金鼎-潭子,9,31,22,-1,0.56
"20230131","1783","0039003800310051","9800",元大-太平,30,0,30,1,0.76
"20230131","1783","9654","9600",富邦-永和,2,22,20,-1,0.51
"20230131","1783","0039003600310044","9600",富邦-忠孝,32,3,29,1,0.74
"20230131","1783","0039003200310047","9200",凱基-五股,12,29,17,-1,0.43
"20221201","1783","0037003000300069","7000",兆豐-松德,35,0,35,1,10.20
"20221201","1783","9255","9200",凱基-和平,0,11,11,-1,3.21
"20221201","1783","1470","1470",台灣摩根士丹利,24,0,24,1,7.00
"20221201","1783","8158","8150",台新-松江,0,10,10,-1,2.92
"20221201","1783","1650","1650",新加坡商瑞銀,26,8,18,1,5.25
"20221201","1783","8887","8880",國泰-忠孝,0,10,10,-1,2.92
"20221201","1783","9334","9300",華南永昌-世貿,18,0,18,1,5.25
"20221201","1783","1560","1560",港商野村,11,18,7,-1,2.04
"20221201","1783","9307","9300",華南永昌-大安,11,0,11,1,3.21
"20221201","1783","9324","9300",華南永昌-岡山,0,7,7,-1,2.04
"20221201","1783","1440","1440",美林,17,11,6,1,1.75
"20221201","1783","0035003800350046","5850",統一-彰化,0,5,5,-1,1.46
"20221201","1783","9801","9800",元大-城東,6,0,6,1,1.75
"20221201","1783","9266","9200",凱基-新豐,0,5,5,-1,1.46
"20221201","1783","8884","8880",國泰-台南,5,0,5,1,1.46
"20221201","1783","9363","9300",華南永昌-彰化,0,5,5,-1,1.46
"20221201","1783","5927","5920",元富-林園,4,0,4,1,1.17
"20221201","1783","0031003000340044","1040",臺銀-金山,0,4,4,-1,1.17
"20221201","1783","9268","9200",凱基-台北,47,43,4,1,1.17
"20221201","1783","5856","5850",統一-台中,1,5,4,-1,1.17
"20221201","1783","003600310036004b","6160",中國信託-高雄,4,1,3,1,0.87
"20221201","1783","9349","9300",華南永昌-板橋,0,4,4,-1,1.17
"20221201","1783","0039003100380042","9100",群益金鼎-板橋,3,0,3,1,0.87
"20221201","1783","0039003600310048","9600",富邦-新板,0,4,4,-1,1.17
"20221201","1783","0039003600320048","9600",富邦-鳳山,3,0,3,1,0.87
"20221201","1783","003900380031004c","9800",元大-莒光,0,4,4,-1,1.17
"20221201","1783","0039003600330041","9600",富邦-八德,3,0,3,1,0.87
"20221201","1783","0035003800350053","5850",統一-宜蘭,0,3,3,-1,0.87
"20221202","1783","1480","1480",美商高盛,34,7,27,1,8.36
"20221202","1783","8847","8840",玉山-台南,0,15,15,-1,4.64
"20221202","1783","1470","1470",台灣摩根士丹利,18,0,18,1,5.57
"20221202","1783","0039003800390043","9800",元大-板橋,0,12,12,-1,3.72
"20221202","1783","1440","1440",美林,22,5,17,1,5.26
"20221202","1783","1030","1030",土銀,0,10,10,-1,3.10
"20221202","1783","0037003000300069","7000",兆豐-松德,14,2,12,1,3.72
"20221202","1783","7006","7000",兆豐-台南,0,10,10,-1,3.10
"20221202","1783","0037003700390065","7790",國票-南科,10,0,10,1,3.10
"20221202","1783","0035003900320065","5920",元富-古亭,0,7,7,-1,2.17
"20221202","1783","003900310038007a","9100",群益金鼎-宜蘭,10,0,10,1,3.10
"20221202","1783","9255","9200",凱基-和平,0,7,7,-1,2.17
"20221202","1783","9268","9200",凱基-台北,32,24,8,1,2.48
"20221202","1783","003700300030004c","7000",兆豐-天母,0,6,6,-1,1.86
"20221202","1783","1040","1040",臺銀,5,0,5,1,1.55
"20221202","1783","9891","9800",元大-永和,1,7,6,-1,1.86
"20221202","1783","8380","8380",安泰,5,0,5,1,1.55
"20221202","1783","1650","1650",新加坡商瑞銀,16,21,5,-1,1.55
"20221202","1783","9307","9300",華南永昌-大安,4,0,4,1,1.24
"20221202","1783","0036003300380041","6380",光和-嘉義,0,5,5,-1,1.55
"20221202","1783","0039003800390047","9800",元大-大同,4,0,4,1,1.24
"20221202","1783","9608","9600",富邦-台東,0,5,5,-1,1.55
"20221202","1783","0039003600310058","9600",富邦-大墩,3,0,3,1,0.93
"20221202","1783","0039003800390067","9800",元大-嘉義,0,5,5,-1,1.55
"20221202","1783","003900410039004c","9A00",永豐金-台中,3,0,3,1,0.93
"20221202","1783","003500380035004a","5850",統一-三重,0,4,4,-1,1.24
"20221202","1783","2187","2180",亞東-台中,2,0,2,1,0.62
"20221202","1783","9616","9600",富邦-岡山,0,4,4,-1,1.24
"20221205","1783","9268","9200",凱基-台北,67,43,24,1,3.23
"20221205","1783","0031003000320041","1020",合庫-新竹,0,45,45,-1,6.05
"20221205","1783","0031003000330046","1030",土銀-南港,15,0,15,1,2.02
"20221205","1783","1480","1480",美商高盛,7,37,30,-1,4.03
"20221205","1783","8440","8440",摩根大通,37,22,15,1,2.02
"20221205","1783","003500380035004a","5850",統一-三重,3,31,28,-1,3.76
"20221205","1783","003500320036004b","5260",美好-富順,18,5,13,1,1.75
"20221205","1783","9255","9200",凱基-和平,3,27,24,-1,3.23
"20221205","1783","0037003000300069","7000",兆豐-松德,21,10,11,1,1.48
"20221205","1783","9623","9600",富邦-台北,3,21,18,-1,2.42
"20221205","1783","8840","8840",玉山證券,11,0,11,1,1.48
"20221205","1783","8158","8150",台新-松江,0,15,15,-1,2.02
"20221205","1783","8561","8560",新光-台中,14,4,10,1,1.34
"20221205","1783","7006","7000",兆豐-台南,0,10,10,-1,1.34
"20221205","1783","0039003100330049","9100",群益金鼎-萬華,10,0,10,1,1.34
"20221205","1783","0037003700390050","7790",國票-九鼎,1,10,9,-1,1.21
"20221205","1783","6168","6160",中國信託-嘉義,7,0,7,1,0.94
"20221205","1783","1440","1440",美林,20,25,5,-1,0.67
"20221205","1783","0039003200300041","9200",凱基-板橋,8,1,7,1,0.94
"20221205","1783","0035003900320065","5920",元富-古亭,2,7,5,-1,0.67
"20221205","1783","9307","9300",華南永昌-大安,6,0,6,1,0.81
"20221205","1783","003700300030004c","7000",兆豐-天母,0,5,5,-1,0.67
"20221205","1783","1650","1650",新加坡商瑞銀,40,34,6,1,0.81
"20221205","1783","9306","9300",華南永昌-台南,0,5,5,-1,0.67
"20221205","1783","6380","6380",光和,6,0,6,1,0.81
"20221205","1783","9319","9300",華南永昌-鶯歌,0,5,5,-1,0.67
"20221205","1783","0039003200310059","9200",凱基-東勢,6,0,6,1,0.81
"20221205","1783","9891","9800",元大-永和,5,10,5,-1,0.67
"20221206","1783","1470","1470",台灣摩根士丹利,111,0,111,1,4.64
"20221206","1783","5603","5600",永興-台中,0,64,64,-1,2.68
"20221206","1783","0037003000300069","7000",兆豐-松德,104,3,101,1,4.22
"20221206","1783","9655","9600",富邦-板橋,0,45,45,-1,1.88
"20221206","1783","8440","8440",摩根大通,119,59,60,1,2.51
"20221206","1783","0035003900320065","5920",元富-古亭,8,43,35,-1,1.46
"20221206","1783","9205","9200",凱基-三重,65,28,37,1,1.55
"20221206","1783","9255","9200",凱基-和平,0,29,29,-1,1.21
"20221206","1783","9307","9300",華南永昌-大安,35,1,34,1,1.42
"20221206","1783","003900380039004a","9800",元大-彰化民生,0,25,25,-1,1.05
"20221206","1783","1650","1650",新加坡商瑞銀,102,75,27,1,1.13
"20221206","1783","9238","9200",凱基-士林,0,23,23,-1,0.96
"20221206","1783","0039003100380067","9100",群益金鼎-大甲,23,2,21,1,0.88
"20221206","1783","8560","8560",新光,11,33,22,-1,0.92
"20221206","1783","9233","9200",凱基-長庚,32,12,20,1,0.84
"20221206","1783","003900310038007a","9100",群益金鼎-宜蘭,0,20,20,-1,0.84
"20221206","1783","003700370039006a","7790",國票-和平,27,8,19,1,0.79
"20221206","1783","003900380031006e","9800",元大-旗山,0,19,19,-1,0.79
"20221206","1783","9666","9600",富邦-南屯,24,5,19,1,0.79
"20221206","1783","9209","9200",凱基-岡山,2,18,16,-1,0.67
"20221206","1783","003500390032007a","5920",元富-文心,17,0,17,1,0.71
"20221206","1783","0039003200320048","9200",凱基-復興,7,21,14,-1,0.59
"20221206","1783","8152","8150",台新-新莊,20,3,17,1,0.71
"20221206","1783","9334","9300",華南永昌-世貿,2,16,14,-1,0.59
"20221206","1783","8150","8150",台新證券,33,19,14,1,0.59
"20221206","1783","003500320036004b","5260",美好-富順,0,13,13,-1,0.54
"20221206","1783","2180","2180",亞東,13,2,11,1,0.46
"20221206","1783","5389","5380",第一金-中山,0,13,13,-1,0.54
"20221207","1783","1470","1470",台灣摩根士丹利,41,0,41,1,3.78
"20221207","1783","9334","9300",華南永昌-世貿,0,41,41,-1,3.78
"20221207","1783","9205","9200",凱基-三重,30,0,30,1,2.76
"20221207","1783","9666","9600",富邦-南屯,0,24,24,-1,2.21
"20221207","1783","003900380039004a","9800",元大-彰化民生,22,0,22,1,2.03
"20221207","1783","1040","1040",臺銀,0,19,19,-1,1.75
"20221207","1783","9231","9200",凱基-員林,17,0,17,1,1.57
"20221207","1783","1440","1440",美林,50,68,18,-1,1.66
"20221207","1783","1480","1480",美商高盛,25,10,15,1,1.38
"20221207","1783","1650","1650",新加坡商瑞銀,32,48,16,-1,1.47
"20221207","1783","1028","1020",合庫-彰化,12,0,12,1,1.11
"20221207","1783","8158","8150",台新-松江,22,37,15,-1,1.38
"20221207","1783","003500390032006e","5920",元富-西松,12,0,12,1,1.11
"20221207","1783","5603","5600",永興-台中,0,14,14,-1,1.29
"20221207","1783","0039003800390049","9800",元大-蘆洲,11,0,11,1,1.01
"20221207","1783","1030","1030",土銀,5,15,10,-1,0.92
"20221207","1783","8888","8880",國泰-敦南,26,16,10,1,0.92
"20221207","1783","0039003800390047","9800",元大-大同,1,11,10,-1,0.92
"20221207","1783","0035003800350046","5850",統一-彰化,10,0,10,1,0.92
"20221207","1783","003900410039006a","9A00",永豐金-嘉義,0,10,10,-1,0.92
"20221207","1783","6910","6910",德信,10,0,10,1,0.92
"20221207","1783","9616","9600",富邦-岡山,0,9,9,-1,0.83
"20221207","1783","0039003100330067","9100",群益金鼎-三重,10,0,10,1,0.92
"20221207","1783","6461","6460",大昌-樹林,0,8,8,-1,0.74
"20221207","1783","9328","9300",華南永昌-潮州,10,0,10,1,0.92
"20221207","1783","8561","8560",新光-台中,4,12,8,-1,0.74
"20221207","1783","9889","9800",元大-員林,10,0,10,1,0.92
"20221207","1783","0039004100380046","9A00",永豐金-敦南,2,10,8,-1,0.74
"20221208","1783","9278","9200",凱基-永康,20,0,20,1,3.37
"20221208","1783","1650","1650",新加坡商瑞銀,31,64,33,-1,5.56
"20221208","1783","5261","5260",美好-蘆洲,19,2,17,1,2.87
"20221208","1783","1480","1480",美商高盛,18,46,28,-1,4.72
"20221208","1783","9863","9800",元大-和平,11,0,11,1,1.85
"20221208","1783","9268","9200",凱基-台北,20,44,24,-1,4.05
"20221208","1783","5600","5600",永興,10,0,10,1,1.69
"20221208","1783","003700370039006a","7790",國票-和平,0,19,19,-1,3.20
"20221208","1783","0037003000300061","7000",兆豐-忠孝,10,2,8,1,1.35
"20221208","1783","9131","9100",群益金鼎-民權,0,10,10,-1,1.69
"20221208","1783","8884","8880",國泰-台南,7,0,7,1,1.18
"20221208","1783","0039003100330067","9100",群益金鼎-三重,0,10,10,-1,1.69
"20221208","1783","0035003800350067","5850",統一-平鎮,6,0,6,1,1.01
"20221208","1783","1440","1440",美林,5,14,9,-1,1.52
"20221208","1783","0035003900320053","5920",元富-基隆,6,0,6,1,1.01
"20221208","1783","0037003000300069","7000",兆豐-松德,0,6,6,-1,1.01
"20221208","1783","9208","9200",凱基-桃園,8,2,6,1,1.01
"20221208","1783","9655","9600",富邦-板橋,0,6,6,-1,1.01
"20221208","1783","9692","9600",富邦-嘉義,7,1,6,1,1.01
"20221208","1783","1030","1030",土銀,0,5,5,-1,0.84
"20221208","1783","0035003900320044","5920",元富-大昌,6,1,5,1,0.84
"20221208","1783","0039004100390047","9A00",永豐金-天母,0,5,5,-1,0.84
"20221208","1783","9347","9300",華南永昌-敦南,5,0,5,1,0.84
"20221208","1783","0035003900320041","5920",元富-緯城,0,4,4,-1,0.67
"20221208","1783","9665","9600",富邦-桃園,5,0,5,1,0.84
"20221208","1783","8157","8150",台新-左楠,0,4,4,-1,0.67
"20221208","1783","0039004100390073","9A00",永豐金-彰化,5,0,5,1,0.84
"20221208","1783","0039003800310067","9800",元大-大里,0,3,3,-1,0.51
"20221209","1783","5261","5260",美好-蘆洲,16,0,16,1,5.78
"20221209","1783","9233","9200",凱基-長庚,0,40,40,-1,14.44
"20221209","1783","1470","1470",台灣摩根士丹利,10,0,10,1,3.61
"20221209","1783","1480","1480",美商高盛,0,17,17,-1,6.14
"20221209","1783","003500320036004b","5260",美好-富順,6,0,6,1,2.17
"20221209","1783","003900360035004b","9600",富邦-台中,0,11,11,-1,3.97
"20221209","1783","0039003100380069","9100",群益金鼎-竹南,5,0,5,1,1.81
"20221209","1783","8150","8150",台新證券,3,10,7,-1,2.53
"20221209","1783","9328","9300",華南永昌-潮州,5,0,5,1,1.81
"20221209","1783","0035003900320044","5920",元富-大昌,0,6,6,-1,2.17
"20221209","1783","0039003600310058","9600",富邦-大墩,5,0,5,1,1.81
"20221209","1783","0035003900320053","5920",元富-基隆,0,6,6,-1,2.17
"20221209","1783","003900380031007a","9800",元大-大統,5,0,5,1,1.81
"20221209","1783","1233","1230",彰銀-台中,0,5,5,-1,1.81
"20221209","1783","9215","9200",凱基-高美館,4,0,4,1,1.44
"20221209","1783","9296","9200",凱基-頭份,3,7,4,-1,1.44
"20221209","1783","9319","9300",華南永昌-鶯歌,4,0,4,1,1.44
"20221209","1783","9327","9300",華南永昌-斗六,0,4,4,-1,1.44
"20221209","1783","9322","9300",華南永昌-公誠,4,0,4,1,1.44
"20221209","1783","9859","9800",元大-新竹經國,1,5,4,-1,1.44
"20221209","1783","0039003800390061","9800",元大-苑裡,4,0,4,1,1.44
"20221209","1783","5927","5920",元富-林園,0,3,3,-1,1.08
"20221209","1783","003900380039004e","9800",元大-內湖,4,0,4,1,1.44
"20221209","1783","003500390032007a","5920",元富-文心,0,3,3,-1,1.08
"20221209","1783","0039003800300065","9800",元大-清水,3,0,3,1,1.08
"20221209","1783","0039003800330055","9800",元大-頭份,1,4,3,-1,1.08
"20221209","1783","1650","1650",新加坡商瑞銀,17,15,2,1,0.72
"20221209","1783","0039003800390044","9800",元大-左營,0,3,3,-1,1.08
"20221212","1783","0039003100380073","9100",群益金鼎-丹鳳,40,0,40,1,4.00
"20221212","1783","8849","8840",玉山-景美,0,38,38,-1,3.80
"20221212","1783","0039004100360039","9A00",永豐金-屏東,28,1,27,1,2.70
"20221212","1783","1650","1650",新加坡商瑞銀,45,76,31,-1,3.10
"20221212","1783","9614","9600",富邦-基隆,23,0,23,1,2.30
"20221212","1783","8440","8440",摩根大通,66,88,22,-1,2.20
"20221212","1783","1470","1470",台灣摩根士丹利,28,7,21,1,2.10
"20221212","1783","1030","1030",土銀,0,20,20,-1,2.00
"20221212","1783","8880","8880",國泰證券,21,0,21,1,2.10
"20221212","1783","9215","9200",凱基-高美館,4,23,19,-1,1.90
"20221212","1783","003900380039006a","9800",元大-樹林,20,0,20,1,2.00
"20221212","1783","8150","8150",台新證券,5,23,18,-1,1.80
"20221212","1783","5263","5260",美好-泰山,18,1,17,1,1.70
"20221212","1783","8840","8840",玉山證券,2,16,14,-1,1.40
"20221212","1783","9812","9800",元大-台中,13,0,13,1,1.30
"20221212","1783","2180","2180",亞東,0,13,13,-1,1.30
"20221212","1783","9302","9300",華南永昌-台中,10,0,10,1,1.00
"20221212","1783","9296","9200",凱基-頭份,0,12,12,-1,1.20
"20221212","1783","9899","9800",元大-淡水,14,4,10,1,1.00
"20221212","1783","0039003800390045","9800",元大-草屯,0,11,11,-1,1.10
"20221212","1783","1440","1440",美林,15,6,9,1,0.90
"20221212","1783","0039004100390072","9A00",永豐金-北高雄,0,11,11,-1,1.10
"20221212","1783","003500380035004d","5850",統一-士林,9,0,9,1,0.90
"20221212","1783","5261","5260",美好-蘆洲,0,10,10,-1,1.00
"20221212","1783","9667","9600",富邦-台南,10,1,9,1,0.90
"20221212","1783","0035003800350046","5850",統一-彰化,0,10,10,-1,1.00
"20221212","1783","1480","1480",美商高盛,17,9,8,1,0.80
"20221212","1783","0035003900320072","5920",元富-城東,15,25,10,-1,1.00
"20221213","1783","0037003700390075","7790",國票-長城,32,5,27,1,1.10
"20221213","1783","9268","9200",凱基-台北,56,176,120,-1,4.88
"20221213","1783","0039003800390042","9800",元大-台中中港,25,0,25,1,1.02
"20221213","1783","8440","8440",摩根大通,66,166,100,-1,4.07
"20221213","1783","1023","1020",合庫-高雄,21,0,21,1,0.85
"20221213","1783","5603","5600",永興-台中,6,60,54,-1,2.20
"20221213","1783","9278","9200",凱基-永康,22,1,21,1,0.85
"20221213","1783","1440","1440",美林,47,99,52,-1,2.12
"20221213","1783","0031003200360069","1260",宏遠-光隆,20,0,20,1,0.81
"20221213","1783","1650","1650",新加坡商瑞銀,117,166,49,-1,1.99
"20221213","1783","5858","5850",統一-嘉義,21,1,20,1,0.81
"20221213","1783","8158","8150",台新-松江,17,66,49,-1,1.99
"20221213","1783","003500390032005a","5920",元富-安南,26,6,20,1,0.81
"20221213","1783","0039003100380073","9100",群益金鼎-丹鳳,12,56,44,-1,1.79
"20221213","1783","9103","9100",群益金鼎-松山,20,0,20,1,0.81
"20221213","1783","1480","1480",美商高盛,10,52,42,-1,1.71
"20221213","1783","0039004100390031","9A00",永豐金-松山,21,1,20,1,0.81
"20221213","1783","1470","1470",台灣摩根士丹利,35,75,40,-1,1.63
"20221213","1783","0039003800300064","9800",元大-沙鹿,17,0,17,1,0.69
"20221213","1783","0039004100360039","9A00",永豐金-屏東,0,28,28,-1,1.14
"20221213","1783","0039003800340043","9800",元大-新店中正,27,10,17,1,0.69
"20221213","1783","9238","9200",凱基-士林,0,25,25,-1,1.02
"20221213","1783","0039003800300061","9800",元大-承德,16,0,16,1,0.65
"20221213","1783","8880","8880",國泰證券,4,25,21,-1,0.85
"20221213","1783","0039003200310045","9200",凱基-三峽,15,0,15,1,0.61
"20221213","1783","1030","1030",土銀,0,20,20,-1,0.81
"20221213","1783","6452","6450",永全-八德,13,0,13,1,0.53
"20221213","1783","5263","5260",美好-泰山,0,17,17,-1,0.69
"20221214","1783","5850","5850",統一,178,1,177,1,9.52
"20221214","1783","9326","9300",華南永昌-南京,18,70,52,-1,2.80
"20221214","1783","1470","1470",台灣摩根士丹利,106,3,103,1,5.54
"20221214","1783","8840","8840",玉山證券,0,33,33,-1,1.78
"20221214","1783","9268","9200",凱基-台北,191,103,88,1,4.73
"20221214","1783","8158","8150",台新-松江,0,31,31,-1,1.67
"20221214","1783","1650","1650",新加坡商瑞銀,100,48,52,1,2.80
"20221214","1783","003900380039004a","9800",元大-彰化民生,0,31,31,-1,1.67
"20221214","1783","003700370039005a","7790",國票-安和,42,2,40,1,2.15
"20221214","1783","003900380039006a","9800",元大-樹林,0,27,27,-1,1.45
"20221214","1783","1440","1440",美林,74,39,35,1,1.88
"20221214","1783","0039004100390066","9A00",永豐金-中盛,17,43,26,-1,1.40
"20221214","1783","0035003900320072","5920",元富-城東,15,0,15,1,0.81
"20221214","1783","9614","9600",富邦-基隆,0,25,25,-1,1.34
"20221214","1783","8565","8560",新光-桃園,12,0,12,1,0.65
"20221214","1783","003500390032005a","5920",元富-安南,0,21,21,-1,1.13
"20221214","1783","0039003600320048","9600",富邦-鳳山,10,0,10,1,0.54
"20221214","1783","003900380031004b","9800",元大-林園,6,26,20,-1,1.08
"20221214","1783","9333","9300",華南永昌-長虹,10,1,9,1,0.48
"20221214","1783","0039004100390031","9A00",永豐金-松山,0,20,20,-1,1.08
"20221214","1783","7034","7030",致和-金華,7,0,7,1,0.38
"20221214","1783","1030","1030",土銀,0,19,19,-1,1.02
"20221214","1783","003900380031006d","9800",元大-前金,7,0,7,1,0.38
"20221214","1783","1034","1030",土銀-嘉義,0,18,18,-1,0.97
"20221214","1783","1560","1560",港商野村,43,37,6,1,0.32
"20221214","1783","9215","9200",凱基-高美館,5,21,16,-1,0.86
"20221214","1783","0039003100380073","9100",群益金鼎-丹鳳,6,0,6,1,0.32
"20221214","1783","0037003700390075","7790",國票-長城,0,15,15,-1,0.81
"20221215","1783","9103","9100",群益金鼎-松山,20,0,20,1,4.26
"20221215","1783","9268","9200",凱基-台北,11,74,63,-1,13.40
"20221215","1783","9856","9800",元大-花蓮,16,0,16,1,3.40
"20221215","1783","003700370039005a","7790",國票-安和,0,42,42,-1,8.94
"20221215","1783","9215","9200",凱基-高美館,17,2,15,1,3.19
"20221215","1783","1650","1650",新加坡商瑞銀,11,30,19,-1,4.04
"20221215","1783","1470","1470",台灣摩根士丹利,12,0,12,1,2.55
"20221215","1783","9208","9200",凱基-桃園,0,17,17,-1,3.62
"20221215","1783","0035003800350046","5850",統一-彰化,10,0,10,1,2.13
"20221215","1783","0039003800390042","9800",元大-台中中港,0,16,16,-1,3.40
"20221215","1783","0039003600310048","9600",富邦-新板,10,0,10,1,2.13
"20221215","1783","1040","1040",臺銀,0,10,10,-1,2.13
"20221215","1783","9647","9600",富邦-新竹,10,1,9,1,1.91
"20221215","1783","0039003800300061","9800",元大-承德,0,10,10,-1,2.13
"20221215","1783","0039003800390044","9800",元大-左營,8,0,8,1,1.70
"20221215","1783","8563","8560",新光-新竹,1,7,6,-1,1.28
"20221215","1783","9604","9600",富邦-陽明,7,0,7,1,1.49
"20221215","1783","003900410039004e","9A00",永豐金-桃盛,0,6,6,-1,1.28
"20221215","1783","1042","1040",臺銀-臺南,6,0,6,1,1.28
"20221215","1783","0039004100390038","9A00",永豐金-大園,0,5,5,-1,1.06
"20221215","1783","9322","9300",華南永昌-公誠,6,0,6,1,1.28
"20221215","1783","0031003200360044","1260",宏遠-台南,0,4,4,-1,0.85
"20221215","1783","9328","9300",華南永昌-潮州,6,0,6,1,1.28
"20221215","1783","0035003300380043","5380",第一金-光復,0,4,4,-1,0.85
"20221215","1783","003900360031005a","9600",富邦-永康,6,0,6,1,1.28
"20221215","1783","0035003900320053","5920",元富-基隆,0,4,4,-1,0.85
"20221215","1783","6115","6110",台中銀-台北,5,0,5,1,1.06
"20221215","1783","9878","9800",元大-金華,0,4,4,-1,0.85
"20221216","1783","1470","1470",台灣摩根士丹利,88,19,69,1,2.54
"20221216","1783","9692","9600",富邦-嘉義,3,84,81,-1,2.98
"20221216","1783","9307","9300",華南永昌-大安,35,0,35,1,1.29
"20221216","1783","0031003000330046","1030",土銀-南港,1,70,69,-1,2.54
"20221216","1783","1480","1480",美商高盛,52,22,30,1,1.10
"20221216","1783","9268","9200",凱基-台北,104,157,53,-1,1.95
"20221216","1783","0035003900320044","5920",元富-大昌,42,12,30,1,1.10
"20221216","1783","9205","9200",凱基-三重,10,50,40,-1,1.47
"20221216","1783","9359","9300",華南永昌-中正,25,2,23,1,0.85
"20221216","1783","1042","1040",臺銀-臺南,2,25,23,-1,0.85
"20221216","1783","8151","8150",台新-建北,36,14,22,1,0.81
"20221216","1783","003900380039004a","9800",元大-彰化民生,2,24,22,-1,0.81
"20221216","1783","8440","8440",摩根大通,191,170,21,1,0.77
"20221216","1783","0039003800340043","9800",元大-新店中正,0,21,21,-1,0.77
"20221216","1783","8456","8450",康和-新竹,21,0,21,1,0.77
"20221216","1783","2184","2180",亞東-新竹,0,20,20,-1,0.74
"20221216","1783","0039003600310047","9600",富邦-成功,22,2,20,1,0.74
"20221216","1783","9856","9800",元大-花蓮,2,19,17,-1,0.63
"20221216","1783","8560","8560",新光,35,15,20,1,0.74
"20221216","1783","5261","5260",美好-蘆洲,1,15,14,-1,0.51
"20221216","1783","0037003000300061","7000",兆豐-忠孝,12,0,12,1,0.44
"20221216","1783","8565","8560",新光-桃園,10,24,14,-1,0.51
"20221216","1783","9300","9300",華南永昌,11,0,11,1,0.40
"20221216","1783","9888","9800",元大-鑫永和,5,19,14,-1,0.51
"20221216","1783","0039004100390061","9A00",永豐金-苓雅,12,1,11,1,0.40
"20221216","1783","9209","9200",凱基-岡山,2,15,13,-1,0.48
"20221216","1783","9215","9200",凱基-高美館,11,1,10,1,0.37
"20221216","1783","7006","7000",兆豐-台南,1,11,10,-1,0.37
"20221219","1783","9334","9300",華南永昌-世貿,60,0,60,1,2.52
"20221219","1783","8440","8440",摩根大通,152,219,67,-1,2.81
"20221219","1783","0037003000300069","7000",兆豐-松德,42,11,31,1,1.30
"20221219","1783","6161","6160",中國信託-三重,2,42,40,-1,1.68
"20221219","1783","0039003600310053","9600",富邦-景美,35,6,29,1,1.22
"20221219","1783","1480","1480",美商高盛,85,121,36,-1,1.51
"20221219","1783","9801","9800",元大-城東,21,0,21,1,0.88
"20221219","1783","1440","1440",美林,11,45,34,-1,1.43
"20221219","1783","0039004100390068","9A00",永豐金-台南,20,0,20,1,0.84
"20221219","1783","0035003900320044","5920",元富-大昌,3,31,28,-1,1.18
"20221219","1783","8150","8150",台新證券,38,19,19,1,0.80
"20221219","1783","1650","1650",新加坡商瑞銀,30,55,25,-1,1.05
"20221219","1783","0039003600310043","9600",富邦-南京,20,5,15,1,0.63
"20221219","1783","0037003000300056","7000",兆豐-新竹,0,25,25,-1,1.05
"20221219","1783","0031003200360069","1260",宏遠-光隆,13,0,13,1,0.55
"20221219","1783","9359","9300",華南永昌-中正,0,25,25,-1,1.05
"20221219","1783","8563","8560",新光-新竹,28,16,12,1,0.50
"20221219","1783","0039003800390049","9800",元大-蘆洲,3,25,22,-1,0.92
"20221219","1783","9266","9200",凱基-新豐,11,0,11,1,0.46
"20221219","1783","1023","1020",合庫-高雄,0,20,20,-1,0.84
"20221219","1783","1260","1260",宏遠證券,10,0,10,1,0.42
"20221219","1783","2184","2180",亞東-新竹,1,21,20,-1,0.84
"20221219","1783","0039003200300041","9200",凱基-板橋,21,11,10,1,0.42
"20221219","1783","8151","8150",台新-建北,1,21,20,-1,0.84
"20221219","1783","003900320030004e","9200",凱基-湖口,10,0,10,1,0.42
"20221219","1783","8560","8560",新光,5,25,20,-1,0.84
"20221219","1783","9227","9200",凱基-城中,14,4,10,1,0.42
"20221219","1783","003900380039004a","9800",元大-彰化民生,0,16,16,-1,0.67
"20221220","1783","1470","1470",台灣摩根士丹利,49,1,48,1,5.85
"20221220","1783","9334","9300",華南永昌-世貿,0,60,60,-1,7.32
"20221220","1783","003900380039004a","9800",元大-彰化民生,25,0,25,1,3.05
"20221220","1783","0039003100380045","9100",群益金鼎-南京,0,38,38,-1,4.63
"20221220","1783","0037003000300061","7000",兆豐-忠孝,11,1,10,1,1.22
"20221220","1783","8440","8440",摩根大通,11,38,27,-1,3.29
"20221220","1783","0037003700390063","7790",國票-敦北法人,10,0,10,1,1.22
"20221220","1783","0039003800300044","9800",元大-北府,0,18,18,-1,2.20
"20221220","1783","0038003400350042","8450",康和-永和,10,0,10,1,1.22
"20221220","1783","0039003800310065","9800",元大-佳里,4,18,14,-1,1.71
"20221220","1783","0039003600320050","9600",富邦-頭份,10,0,10,1,1.22
"20221220","1783","9624","9600",富邦-竹北,0,11,11,-1,1.34
"20221220","1783","0039003800340043","9800",元大-新店中正,10,0,10,1,1.22
"20221220","1783","1260","1260",宏遠證券,0,10,10,-1,1.22
"20221220","1783","0039003600320048","9600",富邦-鳳山,9,0,9,1,1.10
"20221220","1783","1650","1650",新加坡商瑞銀,12,22,10,-1,1.22
"20221220","1783","8560","8560",新光,17,9,8,1,0.98
"20221220","1783","0039003200300041","9200",凱基-板橋,0,10,10,-1,1.22
"20221220","1783","9655","9600",富邦-板橋,8,0,8,1,0.98
"20221220","1783","9227","9200",凱基-城中,0,10,10,-1,1.22
"20221220","1783","1440","1440",美林,22,15,7,1,0.85
"20221220","1783","9300","9300",華南永昌,3,13,10,-1,1.22
"20221220","1783","9322","9300",華南永昌-公誠,9,2,7,1,0.85
"20221220","1783","8151","8150",台新-建北,1,10,9,-1,1.10
"20221220","1783","0039003800390061","9800",元大-苑裡,6,0,6,1,0.73
"20221220","1783","0038003800340045","8840",玉山-城中,1,9,8,-1,0.98
"20221220","1783","0039004100390041","9A00",永豐金-羅東,7,1,6,1,0.73
"20221220","1783","003500390032006f","5920",元富-新興,2,8,6,-1,0.73
"20221221","1783","9268","9200",凱基-台北,198,58,140,1,6.29
"20221221","1783","6910","6910",德信,0,92,92,-1,4.13
"20221221","1783","1650","1650",新加坡商瑞銀,153,16,137,1,6.16
"20221221","1783","003900310033004e","9100",群益金鼎-土城,3,73,70,-1,3.15
"20221221","1783","0035003300380044","5380",第一金-忠孝,128,1,127,1,5.71
"20221221","1783","8885","8880",國泰-桃園,1,49,48,-1,2.16
"20221221","1783","0037003000300069","7000",兆豐-松德,113,3,110,1,4.94
"20221221","1783","8150","8150",台新證券,3,32,29,-1,1.30
"20221221","1783","1480","1480",美商高盛,115,7,108,1,4.85
"20221221","1783","0035003900320072","5920",元富-城東,0,28,28,-1,1.26
"20221221","1783","1470","1470",台灣摩根士丹利,93,0,93,1,4.18
"20221221","1783","0039003600310053","9600",富邦-景美,11,39,28,-1,1.26
"20221221","1783","9692","9600",富邦-嘉義,62,3,59,1,2.65
"20221221","1783","003900380031004e","9800",元大-金門,0,28,28,-1,1.26
"20221221","1783","1560","1560",港商野村,70,25,45,1,2.02
"20221221","1783","003900380039004a","9800",元大-彰化民生,5,33,28,-1,1.26
"20221221","1783","9857","9800",元大-東蘆,35,1,34,1,1.53
"20221221","1783","9328","9300",華南永昌-潮州,1,28,27,-1,1.21
"20221221","1783","9801","9800",元大-城東,30,0,30,1,1.35
"20221221","1783","8560","8560",新光,14,40,26,-1,1.17
"20221221","1783","1440","1440",美林,40,11,29,1,1.30
"20221221","1783","9256","9200",凱基-南崁,5,30,25,-1,1.12
"20221221","1783","9307","9300",華南永昌-大安,24,1,23,1,1.03
"20221221","1783","8849","8840",玉山-景美,0,20,20,-1,0.90
"20221221","1783","0036003100310041","6110",台中銀-豐原,20,0,20,1,0.90
"20221221","1783","0039003800340043","9800",元大-新店中正,0,20,20,-1,0.90
"20221221","1783","7005","7000",兆豐-台中港,20,0,20,1,0.90
"20221221","1783","9283","9200",凱基-北門,0,19,19,-1,0.85
"20221222","1783","9268","9200",凱基-台北,146,42,104,1,4.97
"20221222","1783","8150","8150",台新證券,23,64,41,-1,1.96
"20221222","1783","9623","9600",富邦-台北,69,3,66,1,3.15
"20221222","1783","1560","1560",港商野村,33,62,29,-1,1.39
"20221222","1783","1470","1470",台灣摩根士丹利,64,1,63,1,3.01
"20221222","1783","9858","9800",元大-龍潭,4,30,26,-1,1.24
"20221222","1783","0035003800350063","5850",統一-仁愛,100,50,50,1,2.39
"20221222","1783","9255","9200",凱基-和平,1,22,21,-1,1.00
"20221222","1783","0037003000300069","7000",兆豐-松德,63,15,48,1,2.29
"20221222","1783","0036003100310041","6110",台中銀-豐原,0,20,20,-1,0.96
"20221222","1783","1650","1650",新加坡商瑞銀,68,22,46,1,2.20
"20221222","1783","0039003200310047","9200",凱基-五股,0,20,20,-1,0.96
"20221222","1783","0037003000300053","7000",兆豐-大同,40,0,40,1,1.91
"20221222","1783","6161","6160",中國信託-三重,0,19,19,-1,0.91
"20221222","1783","0039003800300077","9800",元大-西屯,33,0,33,1,1.58
"20221222","1783","8158","8150",台新-松江,0,18,18,-1,0.86
"20221222","1783","003800380038004b","8880",國泰-板橋,31,2,29,1,1.39
"20221222","1783","5262","5260",美好-楊梅,1,17,16,-1,0.76
"20221222","1783","8455","8450",康和-台中,30,1,29,1,1.39
"20221222","1783","5850","5850",統一,0,15,15,-1,0.72
"20221222","1783","8560","8560",新光,52,27,25,1,1.20
"20221222","1783","9676","9600",富邦-仁愛,1,16,15,-1,0.72
"20221222","1783","003700370039007a","7790",國票-博愛,27,5,22,1,1.05
"20221222","1783","0039003600310051","9600",富邦-重新,0,15,15,-1,0.72
"20221222","1783","0039003800310047","9800",元大-彰化,22,1,21,1,1.00
"20221222","1783","9658","9600",富邦-建國,15,30,15,-1,0.72
"20221222","1783","0038003800380041","8880",國泰-館前,19,1,18,1,0.86
"20221222","1783","8843","8840",玉山-高雄,0,14,14,-1,0.67
"20221223","1783","003900380030004b","9800",元大-竹科,674,52,622,1,6.21
"20221223","1783","5261","5260",美好-蘆洲,6,300,294,-1,2.94
"20221223","1783","0035003800350055","5850",統一-南京,402,0,402,1,4.02
"20221223","1783","5603","5600",永興-台中,0,223,223,-1,2.23
"20221223","1783","0035003800350063","5850",統一-仁愛,150,0,150,1,1.50
"20221223","1783","8440","8440",摩根大通,293,502,209,-1,2.09
"20221223","1783","1480","1480",美商高盛,193,83,110,1,1.10
"20221223","1783","9623","9600",富邦-台北,165,367,202,-1,2.02
"20221223","1783","0035003900320076","5920",元富-桃園,111,2,109,1,1.09
"20221223","1783","1470","1470",台灣摩根士丹利,22,108,86,-1,0.86
"20221223","1783","0037003000300050","7000",兆豐-南京,549,449,100,1,1.00
"20221223","1783","9307","9300",華南永昌-大安,3,87,84,-1,0.84
"20221223","1783","0037003700390063","7790",國票-敦北法人,103,4,99,1,0.99
"20221223","1783","9268","9200",凱基-台北,112,184,72,-1,0.72
"20221223","1783","1440","1440",美林,181,124,57,1,0.57
"20221223","1783","003700300030004c","7000",兆豐-天母,0,41,41,-1,0.41
"20221223","1783","8840","8840",玉山證券,62,7,55,1,0.55
"20221223","1783","0035003300380044","5380",第一金-忠孝,2,40,38,-1,0.38
"20221223","1783","9347","9300",華南永昌-敦南,370,318,52,1,0.52
"20221223","1783","9308","9300",華南永昌-麻豆,0,34,34,-1,0.34
"20221223","1783","0039003800390047","9800",元大-大同,53,3,50,1,0.50
"20221223","1783","9857","9800",元大-東蘆,7,37,30,-1,0.30
"20221223","1783","9325","9300",華南永昌-忠孝,56,16,40,1,0.40
"20221223","1783","9208","9200",凱基-桃園,19,46,27,-1,0.27
"20221223","1783","0037003000300069","7000",兆豐-松德,40,2,38,1,0.38
"20221223","1783","9255","9200",凱基-和平,2,28,26,-1,0.26
"20221223","1783","0039003200300046","9200",凱基-站前,52,14,38,1,0.38
"20221223","1783","8455","8450",康和-台中,6,31,25,-1,0.25
"20221226","1783","5852","5850",統一-敦南,287,1,286,1,1.65
"20221226","1783","003900380030004b","9800",元大-竹科,36,660,624,-1,3.60
"20221226","1783","0035003800350063","5850",統一-仁愛,184,31,153,1,0.88
"20221226","1783","8440","8440",摩根大通,127,702,575,-1,3.31
"20221226","1783","6164","6160",中國信託-文心,104,13,91,1,0.52
"20221226","1783","0035003800350050","5850",統一-板橋,625,925,300,-1,1.73
"20221226","1783","9134","9100",群益金鼎-開元,104,13,91,1,0.52
"20221226","1783","1470","1470",台灣摩根士丹利,25,246,221,-1,1.27
"20221226","1783","9898","9800",元大-新莊,82,11,71,1,0.41
"20221226","1783","1480","1480",美商高盛,0,221,221,-1,1.27
"20221226","1783","9893","9800",元大-大天母,64,2,62,1,0.36
"20221226","1783","9268","9200",凱基-台北,519,731,212,-1,1.22
"20221226","1783","1117","1110",台灣企銀-竹北,64,10,54,1,0.31
"20221226","1783","8560","8560",新光,231,355,124,-1,0.71
"20221226","1783","9658","9600",富邦-建國,87,36,51,1,0.29
"20221226","1783","0035003900320076","5920",元富-桃園,0,112,112,-1,0.65
"20221226","1783","8882","8880",國泰-台中,113,62,51,1,0.29
"20221226","1783","0037003700390063","7790",國票-敦北法人,61,161,100,-1,0.58
"20221226","1783","9255","9200",凱基-和平,76,30,46,1,0.27
"20221226","1783","1650","1650",新加坡商瑞銀,258,356,98,-1,0.56
"20221226","1783","0039004100390069","9A00",永豐金-新店,137,92,45,1,0.26
"20221226","1783","0037003000300050","7000",兆豐-南京,3,101,98,-1,0.56
"20221226","1783","8888","8880",國泰-敦南,255,210,45,1,0.26
"20221226","1783","1440","1440",美林,0,84,84,-1,0.48
"20221226","1783","8150","8150",台新證券,230,187,43,1,0.25
"20221226","1783","003700370039007a","7790",國票-博愛,24,79,55,-1,0.32
"20221226","1783","8840","8840",玉山證券,61,19,42,1,0.24
"20221226","1783","0039003200320048","9200",凱基-復興,9,61,52,-1,0.30
"20221227","1783","0039004100390031","9A00",永豐金-松山,105,3,102,1,1.53
"20221227","1783","9268","9200",凱基-台北,192,360,168,-1,2.52
"20221227","1783","0037003000300050","7000",兆豐-南京,127,26,101,1,1.52
"20221227","1783","5852","5850",統一-敦南,0,118,118,-1,1.77
"20221227","1783","8440","8440",摩根大通,284,205,79,1,1.19
"20221227","1783","0039003800340043","9800",元大-新店中正,57,145,88,-1,1.32
"20221227","1783","9255","9200",凱基-和平,76,3,73,1,1.10
"20221227","1783","1470","1470",台灣摩根士丹利,14,100,86,-1,1.29
"20221227","1783","0035003900320045","5920",元富-城中,77,21,56,1,0.84
"20221227","1783","9347","9300",華南永昌-敦南,20,72,52,-1,0.78
"20221227","1783","9134","9100",群益金鼎-開元,85,34,51,1,0.77
"20221227","1783","9256","9200",凱基-南崁,5,53,48,-1,0.72
"20221227","1783","0039004100390044","9A00",永豐金-忠孝,95,45,50,1,0.75
"20221227","1783","0038003100350042","8150",台新-台中,7,45,38,-1,0.57
"20221227","1783","9183","9100",群益金鼎-高雄,46,10,36,1,0.54
"20221227","1783","0038003100350041","8150",台新-高雄,9,45,36,-1,0.54
"20221227","1783","8561","8560",新光-台中,54,20,34,1,0.51
"20221227","1783","8888","8880",國泰-敦南,37,71,34,-1,0.51
"20221227","1783","9324","9300",華南永昌-岡山,35,3,32,1,0.48
"20221227","1783","0035003300380044","5380",第一金-忠孝,3,36,33,-1,0.50
"20221227","1783","9875","9800",元大-土城永寧,33,1,32,1,0.48
"20221227","1783","1440","1440",美林,4,36,32,-1,0.48
"20221227","1783","9205","9200",凱基-三重,35,4,31,1,0.47
"20221227","1783","003500380035004d","5850",統一-士林,18,49,31,-1,0.47
"20221227","1783","0039003600310043","9600",富邦-南京,39,9,30,1,0.45
"20221227","1783","0039003100380064","9100",群益金鼎-內湖,1,31,30,-1,0.45
"20221227","1783","0039003800390047","9800",元大-大同,32,2,30,1,0.45
"20221227","1783","003700370039005a","7790",國票-安和,18,46,28,-1,0.42
"20221228","1783","9227","9200",凱基-城中,65,9,56,1,0.96
"20221228","1783","8843","8840",玉山-高雄,55,219,164,-1,2.81
"20221228","1783","5921","5920",元富-高雄,40,2,38,1,0.65
"20221228","1783","0037003000300050","7000",兆豐-南京,1,100,99,-1,1.69
"20221228","1783","0039004100390055","9A00",永豐金-中正,31,1,30,1,0.51
"20221228","1783","0035003800350055","5850",統一-南京,6,100,94,-1,1.61
"20221228","1783","0035003900320044","5920",元富-大昌,29,4,25,1,0.43
"20221228","1783","0037003000300053","7000",兆豐-大同,0,58,58,-1,0.99
"20221228","1783","9324","9300",華南永昌-岡山,29,5,24,1,0.41
"20221228","1783","9255","9200",凱基-和平,21,78,57,-1,0.98
"20221228","1783","1023","1020",合庫-高雄,25,2,23,1,0.39
"20221228","1783","0035003900320045","5920",元富-城中,12,68,56,-1,0.96
"20221228","1783","7003","7000",兆豐-台中,21,0,21,1,0.36
"20221228","1783","0035003800350063","5850",統一-仁愛,0,55,55,-1,0.94
"20221228","1783","0038003800340042","8840",玉山-台中,25,4,21,1,0.36
"20221228","1783","0037003000300077","7000",兆豐-新莊,2,43,41,-1,0.70
"20221228","1783","0039004100390038","9A00",永豐金-大園,23,2,21,1,0.36
"20221228","1783","003900310033004e","9100",群益金鼎-土城,5,44,39,-1,0.67
"20221228","1783","1020","1020",合庫證券,21,1,20,1,0.34
"20221228","1783","8152","8150",台新-新莊,6,34,28,-1,0.48
"20221228","1783","9634","9600",富邦-羅東,20,0,20,1,0.34
"20221228","1783","5852","5850",統一-敦南,0,27,27,-1,0.46
"20221228","1783","0035003900320072","5920",元富-城東,20,0,20,1,0.34
"20221228","1783","9875","9800",元大-土城永寧,5,31,26,-1,0.44
"20221228","1783","8848","8840",玉山-嘉義,22,3,19,1,0.33
"20221228","1783","0035003300380059","5380",第一金-中壢,30,54,24,-1,0.41
"20221228","1783","0031003000340043","1040",臺銀-高雄,21,3,18,1,0.31
"20221228","1783","003500380035005a","5850",統一-松江,5,25,20,-1,0.34
"20221229","1783","1480","1480",美商高盛,49,6,43,1,2.16
"20221229","1783","8843","8840",玉山-高雄,7,121,114,-1,5.71
"20221229","1783","1440","1440",美林,44,15,29,1,1.45
"20221229","1783","8440","8440",摩根大通,41,110,69,-1,3.46
"20221229","1783","8150","8150",台新證券,46,20,26,1,1.30
"20221229","1783","9692","9600",富邦-嘉義,2,37,35,-1,1.75
"20221229","1783","9103","9100",群益金鼎-松山,21,0,21,1,1.05
"20221229","1783","0039004100390068","9A00",永豐金-台南,3,27,24,-1,1.20
"20221229","1783","1560","1560",港商野村,54,34,20,1,1.00
"20221229","1783","9268","9200",凱基-台北,68,91,23,-1,1.15
"20221229","1783","0037003000300077","7000",兆豐-新莊,20,3,17,1,0.85
"20221229","1783","9183","9100",群益金鼎-高雄,1,20,19,-1,0.95
"20221229","1783","0039003100380067","9100",群益金鼎-大甲,23,7,16,1,0.80
"20221229","1783","0035003900320061","5920",元富-松德,2,21,19,-1,0.95
"20221229","1783","0039003600310043","9600",富邦-南京,15,2,13,1,0.65
"20221229","1783","0031003000340043","1040",臺銀-高雄,1,18,17,-1,0.85
"20221229","1783","003600310036004b","6160",中國信託-高雄,13,0,13,1,0.65
"20221229","1783","9209","9200",凱基-岡山,2,15,13,-1,0.65
"20221229","1783","8560","8560",新光,20,8,12,1,0.60
"20221229","1783","9875","9800",元大-土城永寧,2,14,12,-1,0.60
"20221229","1783","0031003000320041","1020",合庫-新竹,11,0,11,1,0.55
"20221229","1783","5262","5260",美好-楊梅,0,11,11,-1,0.55
"20221229","1783","1040","1040",臺銀,12,1,11,1,0.55
"20221229","1783","0036003300380041","6380",光和-嘉義,0,10,10,-1,0.50
"20221229","1783","9893","9800",元大-大天母,11,0,11,1,0.55
"20221229","1783","0039003600320052","9600",富邦-園區,0,10,10,-1,0.50
"20221229","1783","003500390032006d","5920",元富-成功,13,3,10,1,0.50
"20221229","1783","9801","9800",元大-城東,3,12,9,-1,0.45
"20221230","1783","0035003300380044","5380",第一金-忠孝,51,0,51,1,3.58
"20221230","1783","8843","8840",玉山-高雄,9,80,71,-1,4.99
"20221230","1783","0037003000300069","7000",兆豐-松德,42,0,42,1,2.95
"20221230","1783","8440","8440",摩根大通,0,58,58,-1,4.08
"20221230","1783","0039003800390043","9800",元大-板橋,30,1,29,1,2.04
"20221230","1783","9692","9600",富邦-嘉義,1,55,54,-1,3.79
"20221230","1783","0035003300380041","5380",第一金-新興,25,0,25,1,1.76
"20221230","1783","1650","1650",新加坡商瑞銀,59,102,43,-1,3.02
"20221230","1783","0035003800350063","5850",統一-仁愛,20,0,20,1,1.41
"20221230","1783","1480","1480",美商高盛,10,36,26,-1,1.83
"20221230","1783","0035003900320045","5920",元富-城中,20,0,20,1,1.41
"20221230","1783","8150","8150",台新證券,11,33,22,-1,1.55
"20221230","1783","0039003100330059","9100",群益金鼎-館前,21,1,20,1,1.41
"20221230","1783","1560","1560",港商野村,6,26,20,-1,1.41
"20221230","1783","0038003800340042","8840",玉山-台中,21,2,19,1,1.34
"20221230","1783","9227","9200",凱基-城中,8,27,19,-1,1.34
"20221230","1783","9268","9200",凱基-台北,63,45,18,1,1.26
"20221230","1783","1440","1440",美林,5,22,17,-1,1.19
"20221230","1783","9623","9600",富邦-台北,35,17,18,1,1.26
"20221230","1783","9815","9800",元大-大灣,2,13,11,-1,0.77
"20221230","1783","9307","9300",華南永昌-大安,15,1,14,1,0.98
"20221230","1783","8152","8150",台新-新莊,1,11,10,-1,0.70
"20221230","1783","0037003000300077","7000",兆豐-新莊,10,0,10,1,0.70
"20221230","1783","0039003600320048","9600",富邦-鳳山,0,10,10,-1,0.70
"20221230","1783","8882","8880",國泰-台中,13,3,10,1,0.70
"20221230","1783","7034","7030",致和-金華,0,9,9,-1,0.63
"20221230","1783","0037003700390063","7790",國票-敦北法人,9,0,9,1,0.63
"20221230","1783","1470","1470",台灣摩根士丹利,24,32,8,-1,0.56
"20221101","1783","9303","9300",華南永昌-高雄,43,0,43,1,12.18
"20221101","1783","0037003000300049","7000",兆豐-北高雄,0,20,20,-1,5.67
"20221101","1783","1470","1470",台灣摩根士丹利,36,2,34,1,9.63
"20221101","1783","5855","5850",統一-台南,0,14,14,-1,3.97
"20221101","1783","5850","5850",統一,16,0,16,1,4.53
"20221101","1783","0037003000300061","7000",兆豐-忠孝,0,11,11,-1,3.12
"20221101","1783","1440","1440",美林,22,7,15,1,4.25
"20221101","1783","1040","1040",臺銀,0,10,10,-1,2.83
"20221101","1783","8440","8440",摩根大通,20,7,13,1,3.68
"20221101","1783","6163","6160",中國信託-永康,0,10,10,-1,2.83
"20221101","1783","0031003000330043","1030",土銀-白河,10,0,10,1,2.83
"20221101","1783","7750","7750",北城證券,0,10,10,-1,2.83
"20221101","1783","0035003300380045","5380",第一金-自由,10,0,10,1,2.83
"20221101","1783","003900380039004c","9800",元大-成功,0,7,7,-1,1.98
"20221101","1783","6210","6210",新百王,10,0,10,1,2.83
"20221101","1783","7008","7000",兆豐-三重,0,6,6,-1,1.70
"20221101","1783","0035003900320072","5920",元富-城東,9,4,5,1,1.42
"20221101","1783","8882","8880",國泰-台中,0,6,6,-1,1.70
"20221101","1783","8886","8880",國泰-新莊,5,0,5,1,1.42
"20221101","1783","9101","9100",群益金鼎-敦南,0,6,6,-1,1.70
"20221101","1783","9207","9200",凱基-永和,5,0,5,1,1.42
"20221101","1783","0039003100380044","9100",群益金鼎-東門,1,7,6,-1,1.70
"20221101","1783","9677","9600",富邦-三重,5,0,5,1,1.42
"20221101","1783","0038003100350041","8150",台新-高雄,0,5,5,-1,1.42
"20221101","1783","0035003300380059","5380",第一金-中壢,3,0,3,1,0.85
"20221101","1783","9324","9300",華南永昌-岡山,0,5,5,-1,1.42
"20221101","1783","003500390032006f","5920",元富-新興,5,2,3,1,0.85
"20221101","1783","0039004100300030","9A00",永豐金證券,0,5,5,-1,1.42
"20221102","1783","9268","9200",凱基-台北,15,2,13,1,6.63
"20221102","1783","0031003000330043","1030",土銀-白河,0,10,10,-1,5.10
"20221102","1783","0039004100390071","9A00",永豐金-潮州,11,0,11,1,5.61
"20221102","1783","0035003300380045","5380",第一金-自由,0,10,10,-1,5.10
"20221102","1783","1470","1470",台灣摩根士丹利,13,4,9,1,4.59
"20221102","1783","0035003900320072","5920",元富-城東,0,10,10,-1,5.10
"20221102","1783","0039004100360031","9A00",永豐金-鳳山,7,0,7,1,3.57
"20221102","1783","5850","5850",統一,4,13,9,-1,4.59
"20221102","1783","2184","2180",亞東-新竹,5,0,5,1,2.55
"20221102","1783","0039003200300056","9200",凱基-新店,0,7,7,-1,3.57
"20221102","1783","0037003000300056","7000",兆豐-新竹,5,0,5,1,2.55
"20221102","1783","1560","1560",港商野村,0,5,5,-1,2.55
"20221102","1783","9312","9300",華南永昌-民權,6,1,5,1,2.55
"20221102","1783","1650","1650",新加坡商瑞銀,4,9,5,-1,2.55
"20221102","1783","9328","9300",華南永昌-潮州,5,0,5,1,2.55
"20221102","1783","8886","8880",國泰-新莊,0,5,5,-1,2.55
"20221102","1783","003500320036004b","5260",美好-富順,4,0,4,1,2.04
"20221102","1783","5389","5380",第一金-中山,0,4,4,-1,2.04
"20221102","1783","9829","9800",元大-永康,4,0,4,1,2.04
"20221102","1783","8711","8710",陽信-石牌,0,4,4,-1,2.04
"20221102","1783","1110","1110",台灣企銀,3,0,3,1,1.53
"20221102","1783","0035003300380059","5380",第一金-中壢,0,3,3,-1,1.53
"20221102","1783","003500390032006f","5920",元富-新興,3,0,3,1,1.53
"20221102","1783","0037003700390072","7790",國票-桃園,0,3,3,-1,1.53
"20221102","1783","9303","9300",華南永昌-高雄,3,0,3,1,1.53
"20221102","1783","8846","8840",玉山-板橋,0,2,2,-1,1.02
"20221102","1783","0039004100300030","9A00",永豐金證券,3,0,3,1,1.53
"20221102","1783","1480","1480",美商高盛,0,2,2,-1,1.02
"20221103","1783","9268","9200",凱基-台北,35,11,24,1,10.67
"20221103","1783","8560","8560",新光,0,14,14,-1,6.22
"20221103","1783","1480","1480",美商高盛,20,1,19,1,8.44
"20221103","1783","0038003400350055","8450",康和-台北,0,12,12,-1,5.33
"20221103","1783","1440","1440",美林,16,5,11,1,4.89
"20221103","1783","0035003300380044","5380",第一金-忠孝,0,10,10,-1,4.44
"20221103","1783","003600310036004b","6160",中國信託-高雄,10,0,10,1,4.44
"20221103","1783","9204","9200",凱基-台中,0,10,10,-1,4.44
"20221103","1783","1650","1650",新加坡商瑞銀,13,4,9,1,4.00
"20221103","1783","5856","5850",統一-台中,0,9,9,-1,4.00
"20221103","1783","0039003800390046","9800",元大-高雄,10,1,9,1,4.00
"20221103","1783","003500320036004b","5260",美好-富順,0,5,5,-1,2.22
"20221103","1783","8440","8440",摩根大通,12,4,8,1,3.56
"20221103","1783","5852","5850",統一-敦南,0,5,5,-1,2.22
"20221103","1783","5384","5380",第一金-台南,7,0,7,1,3.11
"20221103","1783","0037003700390045","7790",國票-南崁,0,5,5,-1,2.22
"20221103","1783","9692","9600",富邦-嘉義,7,0,7,1,3.11
"20221103","1783","0039003100380063","9100",群益金鼎-鳳山,0,5,5,-1,2.22
"20221103","1783","1470","1470",台灣摩根士丹利,6,0,6,1,2.67
"20221103","1783","8847","8840",玉山-台南,0,4,4,-1,1.78
"20221103","1783","003800380034004a","8840",玉山-大里,5,0,5,1,2.22
"20221103","1783","9604","9600",富邦-陽明,0,4,4,-1,1.78
"20221103","1783","9608","9600",富邦-台東,5,0,5,1,2.22
"20221103","1783","0039003600310045","9600",富邦-府城,0,4,4,-1,1.78
"20221103","1783","1560","1560",港商野村,4,0,4,1,1.78
"20221103","1783","5850","5850",統一,0,3,3,-1,1.33
"20221103","1783","003500380035004a","5850",統一-三重,4,0,4,1,1.78
"20221103","1783","0035003300380049","5380",第一金-頭份,0,3,3,-1,1.33
"20221104","1783","9897","9800",元大-土城,22,0,22,1,12.09
"20221104","1783","5855","5850",統一-台南,0,12,12,-1,6.59
"20221104","1783","9268","9200",凱基-台北,18,5,13,1,7.14
"20221104","1783","0039003800390067","9800",元大-嘉義,0,10,10,-1,5.49
"20221104","1783","0038003400350046","8450",康和-仁愛,10,0,10,1,5.49
"20221104","1783","9266","9200",凱基-新豐,0,9,9,-1,4.95
"20221104","1783","9215","9200",凱基-高美館,10,0,10,1,5.49
"20221104","1783","1650","1650",新加坡商瑞銀,0,6,6,-1,3.30
"20221104","1783","1440","1440",美林,14,7,7,1,3.85
"20221104","1783","9136","9100",群益金鼎-西松,0,6,6,-1,3.30
"20221104","1783","7008","7000",兆豐-三重,6,0,6,1,3.30
"20221104","1783","5856","5850",統一-台中,0,5,5,-1,2.75
"20221104","1783","0039003800300051","9800",元大-南崁,6,0,6,1,3.30
"20221104","1783","8564","8560",新光-台南,0,4,4,-1,2.20
"20221104","1783","1480","1480",美商高盛,4,0,4,1,2.20
"20221104","1783","0039003100380063","9100",群益金鼎-鳳山,0,4,4,-1,2.20
"20221104","1783","0035003900320072","5920",元富-城東,10,6,4,1,2.20
"20221104","1783","9300","9300",華南永昌,0,4,4,-1,2.20
"20221104","1783","0039003800390046","9800",元大-高雄,5,1,4,1,2.20
"20221104","1783","0039004100390042","9A00",永豐金-中和,0,4,4,-1,2.20
"20221104","1783","2180","2180",亞東,3,0,3,1,1.65
"20221104","1783","6114","6110",台中銀-員林,0,3,3,-1,1.65
"20221104","1783","9692","9600",富邦-嘉義,3,0,3,1,1.65
"20221104","1783","7750","7750",北城證券,0,3,3,-1,1.65
"20221104","1783","5384","5380",第一金-台南,2,0,2,1,1.10
"20221104","1783","8560","8560",新光,0,3,3,-1,1.65
"20221104","1783","5050","5050",大展,2,0,2,1,1.10
"20221104","1783","9616","9600",富邦-岡山,0,3,3,-1,1.65
"20221107","1783","9829","9800",元大-永康,11,0,11,1,5.34
"20221107","1783","9303","9300",華南永昌-高雄,1,25,24,-1,11.65
"20221107","1783","5925","5920",元富-台中,10,0,10,1,4.85
"20221107","1783","8440","8440",摩根大通,2,15,13,-1,6.31
"20221107","1783","9272","9200",凱基-竹科,10,0,10,1,4.85
"20221107","1783","1650","1650",新加坡商瑞銀,1,12,11,-1,5.34
"20221107","1783","1230","1230",彰銀,5,0,5,1,2.43
"20221107","1783","0035003800350049","5850",統一-員林,0,10,10,-1,4.85
"20221107","1783","2184","2180",亞東-新竹,5,0,5,1,2.43
"20221107","1783","0039004100390071","9A00",永豐金-潮州,1,11,10,-1,4.85
"20221107","1783","2180","2180",亞東,5,0,5,1,2.43
"20221107","1783","1440","1440",美林,2,10,8,-1,3.88
"20221107","1783","6210","6210",新百王,5,0,5,1,2.43
"20221107","1783","1480","1480",美商高盛,0,7,7,-1,3.40
"20221107","1783","8158","8150",台新-松江,5,0,5,1,2.43
"20221107","1783","0035003900320044","5920",元富-大昌,0,6,6,-1,2.91
"20221107","1783","9312","9300",華南永昌-民權,5,0,5,1,2.43
"20221107","1783","1560","1560",港商野村,0,4,4,-1,1.94
"20221107","1783","0039003600310053","9600",富邦-景美,5,0,5,1,2.43
"20221107","1783","0039003800310072","9800",元大-屏南,0,4,4,-1,1.94
"20221107","1783","0039003600330041","9600",富邦-八德,5,0,5,1,2.43
"20221107","1783","0039003800310043","9800",元大-路竹,2,5,3,-1,1.46
"20221107","1783","0039003800320043","9800",元大-六合,5,0,5,1,2.43
"20221107","1783","9874","9800",元大-雙和,0,3,3,-1,1.46
"20221107","1783","9604","9600",富邦-陽明,4,0,4,1,1.94
"20221107","1783","0039004100390067","9A00",永豐金-內湖,1,4,3,-1,1.46
"20221107","1783","9858","9800",元大-龍潭,4,0,4,1,1.94
"20221107","1783","0038003800340048","8840",玉山-新竹,0,2,2,-1,0.97
"20221108","1783","8440","8440",摩根大通,35,2,33,1,11.83
"20221108","1783","9867","9800",元大-北成功,0,21,21,-1,7.53
"20221108","1783","1560","1560",港商野村,21,2,19,1,6.81
"20221108","1783","6380","6380",光和,0,20,20,-1,7.17
"20221108","1783","9897","9800",元大-土城,13,0,13,1,4.66
"20221108","1783","9303","9300",華南永昌-高雄,0,15,15,-1,5.38
"20221108","1783","1470","1470",台灣摩根士丹利,12,0,12,1,4.30
"20221108","1783","0038003800380041","8880",國泰-館前,0,11,11,-1,3.94
"20221108","1783","0035003800350049","5850",統一-員林,10,0,10,1,3.58
"20221108","1783","9863","9800",元大-和平,0,10,10,-1,3.58
"20221108","1783","1650","1650",新加坡商瑞銀,10,1,9,1,3.23
"20221108","1783","9874","9800",元大-雙和,0,9,9,-1,3.23
"20221108","1783","0036003000310064","6010",(牛牛牛)亞-鑫豐,8,0,8,1,2.87
"20221108","1783","2180","2180",亞東,0,7,7,-1,2.51
"20221108","1783","0039003200300046","9200",凱基-站前,8,0,8,1,2.87
"20221108","1783","9322","9300",華南永昌-公誠,0,7,7,-1,2.51
"20221108","1783","1480","1480",美商高盛,6,1,5,1,1.79
"20221108","1783","6163","6160",中國信託-永康,0,6,6,-1,2.15
"20221108","1783","2187","2180",亞東-台中,5,0,5,1,1.79
"20221108","1783","0039003800300051","9800",元大-南崁,0,6,6,-1,2.15
"20221108","1783","0035003900320072","5920",元富-城東,5,0,5,1,1.79
"20221108","1783","003900380031006e","9800",元大-旗山,0,6,6,-1,2.15
"20221108","1783","9255","9200",凱基-和平,5,0,5,1,1.79
"20221108","1783","6620","6620",口袋證券,0,5,5,-1,1.79
"20221108","1783","0037003700390048","7790",國票-嘉義,4,0,4,1,1.43
"20221108","1783","8380","8380",安泰,0,5,5,-1,1.79
"20221108","1783","0039003800390044","9800",元大-左營,4,0,4,1,1.43
"20221108","1783","0039003100380047","9100",群益金鼎-新莊,0,5,5,-1,1.79
"20221109","1783","8440","8440",摩根大通,26,8,18,1,8.61
"20221109","1783","0037003000300053","7000",兆豐-大同,0,20,20,-1,9.57
"20221109","1783","0039003600310048","9600",富邦-新板,15,0,15,1,7.18
"20221109","1783","0038003800380041","8880",國泰-館前,0,11,11,-1,5.26
"20221109","1783","1470","1470",台灣摩根士丹利,14,0,14,1,6.70
"20221109","1783","9874","9800",元大-雙和,0,10,10,-1,4.78
"20221109","1783","1034","1030",土銀-嘉義,10,0,10,1,4.78
"20221109","1783","003500390032006f","5920",元富-新興,1,7,6,-1,2.87
"20221109","1783","1650","1650",新加坡商瑞銀,6,0,6,1,2.87
"20221109","1783","9677","9600",富邦-三重,0,6,6,-1,2.87
"20221109","1783","0039003600320044","9600",富邦-新莊,5,0,5,1,2.39
"20221109","1783","1560","1560",港商野村,0,5,5,-1,2.39
"20221109","1783","1440","1440",美林,10,6,4,1,1.91
"20221109","1783","1030","1030",土銀,0,5,5,-1,2.39
"20221109","1783","003700300030004a","7000",兆豐-公益,4,0,4,1,1.91
"20221109","1783","9898","9800",元大-新莊,0,4,4,-1,1.91
"20221109","1783","0039003100330049","9100",群益金鼎-萬華,4,0,4,1,1.91
"20221109","1783","8888","8880",國泰-敦南,1,4,3,-1,1.44
"20221109","1783","9255","9200",凱基-和平,6,2,4,1,1.91
"20221109","1783","9258","9200",凱基-羅東,0,3,3,-1,1.44
"20221109","1783","0036003000310064","6010",(牛牛牛)亞-鑫豐,3,0,3,1,1.44
"20221109","1783","0039003800300044","9800",元大-北府,0,3,3,-1,1.44
"20221109","1783","0038003800340044","8840",玉山-左營,3,0,3,1,1.44
"20221109","1783","1590","1590",花旗環球,0,2,2,-1,0.96
"20221109","1783","9300","9300",華南永昌,4,1,3,1,1.44
"20221109","1783","0035003800350050","5850",統一-板橋,0,2,2,-1,0.96
"20221109","1783","9692","9600",富邦-嘉義,3,0,3,1,1.44
"20221109","1783","6161","6160",中國信託-三重,0,2,2,-1,0.96
"20221110","1783","1650","1650",新加坡商瑞銀,55,6,49,1,9.16
"20221110","1783","0037003700390065","7790",國票-南科,0,20,20,-1,3.74
"20221110","1783","9303","9300",華南永昌-高雄,58,23,35,1,6.54
"20221110","1783","7750","7750",北城證券,0,15,15,-1,2.80
"20221110","1783","1440","1440",美林,37,6,31,1,5.79
"20221110","1783","003900310038004b","9100",群益金鼎-東湖,0,14,14,-1,2.62
"20221110","1783","8440","8440",摩根大通,39,9,30,1,5.61
"20221110","1783","0036003000310064","6010",(牛牛牛)亞-鑫豐,0,11,11,-1,2.06
"20221110","1783","9268","9200",凱基-台北,39,12,27,1,5.05
"20221110","1783","0037003000300042","7000",兆豐-板橋,0,10,10,-1,1.87
"20221110","1783","1470","1470",台灣摩根士丹利,24,3,21,1,3.93
"20221110","1783","0039003600310053","9600",富邦-景美,0,10,10,-1,1.87
"20221110","1783","6380","6380",光和,20,0,20,1,3.74
"20221110","1783","003700300030004a","7000",兆豐-公益,0,9,9,-1,1.68
"20221110","1783","0039003800310068","9800",元大-屏東民生,13,0,13,1,2.43
"20221110","1783","0039004100390067","9A00",永豐金-內湖,0,9,9,-1,1.68
"20221110","1783","9327","9300",華南永昌-斗六,10,0,10,1,1.87
"20221110","1783","6465","6460",大昌-桃園,0,8,8,-1,1.50
"20221110","1783","0039003600310048","9600",富邦-新板,16,7,9,1,1.68
"20221110","1783","9636","9600",富邦-中壢,0,8,8,-1,1.50
"20221110","1783","0035003900320067","5920",元富-中原,8,0,8,1,1.50
"20221110","1783","1560","1560",港商野村,5,12,7,-1,1.31
"20221110","1783","9215","9200",凱基-高美館,10,2,8,1,1.50
"20221110","1783","7007","7000",兆豐-竹北,0,7,7,-1,1.31
"20221110","1783","9853","9800",元大-南屯,8,0,8,1,1.50
"20221110","1783","9319","9300",華南永昌-鶯歌,0,6,6,-1,1.12
"20221110","1783","9227","9200",凱基-城中,6,0,6,1,1.12
"20221110","1783","0039003600310056","9600",富邦-板橋中山,0,6,6,-1,1.12
"20221111","1783","8560","8560",新光,29,2,27,1,5.88
"20221111","1783","9829","9800",元大-永康,0,40,40,-1,8.71
"20221111","1783","6380","6380",光和,21,0,21,1,4.58
"20221111","1783","8440","8440",摩根大通,6,26,20,-1,4.36
"20221111","1783","9327","9300",華南永昌-斗六,10,0,10,1,2.18
"20221111","1783","1480","1480",美商高盛,3,18,15,-1,3.27
"20221111","1783","9856","9800",元大-花蓮,10,0,10,1,2.18
"20221111","1783","1650","1650",新加坡商瑞銀,0,15,15,-1,3.27
"20221111","1783","9205","9200",凱基-三重,13,5,8,1,1.74
"20221111","1783","6210","6210",新百王,0,14,14,-1,3.05
"20221111","1783","9255","9200",凱基-和平,10,2,8,1,1.74
"20221111","1783","6465","6460",大昌-桃園,0,14,14,-1,3.05
"20221111","1783","9697","9600",富邦-虎尾,8,0,8,1,1.74
"20221111","1783","9268","9200",凱基-台北,37,49,12,-1,2.61
"20221111","1783","1470","1470",台灣摩根士丹利,7,0,7,1,1.53
"20221111","1783","9300","9300",華南永昌,0,11,11,-1,2.40
"20221111","1783","1040","1040",臺銀,7,0,7,1,1.53
"20221111","1783","003900410039004b","9A00",永豐金-三重,0,10,10,-1,2.18
"20221111","1783","9238","9200",凱基-士林,7,0,7,1,1.53
"20221111","1783","0039004100390067","9A00",永豐金-內湖,0,10,10,-1,2.18
"20221111","1783","0039004100390038","9A00",永豐金-大園,7,0,7,1,1.53
"20221111","1783","0035003900320067","5920",元富-中原,0,9,9,-1,1.96
"20221111","1783","9209","9200",凱基-岡山,6,0,6,1,1.31
"20221111","1783","1440","1440",美林,4,12,8,-1,1.74
"20221111","1783","0039003800390055","9800",元大-大甲,5,0,5,1,1.09
"20221111","1783","0039003600310048","9600",富邦-新板,0,8,8,-1,1.74
"20221111","1783","9101","9100",群益金鼎-敦南,5,0,5,1,1.09
"20221111","1783","0035003300380049","5380",第一金-頭份,0,8,8,-1,1.74
"20221114","1783","9268","9200",凱基-台北,64,12,52,1,10.95
"20221114","1783","5855","5850",統一-台南,2,27,25,-1,5.26
"20221114","1783","8440","8440",摩根大通,26,7,19,1,4.00
"20221114","1783","5384","5380",第一金-台南,0,16,16,-1,3.37
"20221114","1783","9891","9800",元大-永和,17,3,14,1,2.95
"20221114","1783","0039003600310048","9600",富邦-新板,0,15,15,-1,3.16
"20221114","1783","8882","8880",國泰-台中,12,0,12,1,2.53
"20221114","1783","8560","8560",新光,2,17,15,-1,3.16
"20221114","1783","0039003100380045","9100",群益金鼎-南京,12,0,12,1,2.53
"20221114","1783","5385","5380",第一金-桃園,0,10,10,-1,2.11
"20221114","1783","9329","9300",華南永昌-朴子,10,0,10,1,2.11
"20221114","1783","1034","1030",土銀-嘉義,0,7,7,-1,1.47
"20221114","1783","9205","9200",凱基-三重,8,0,8,1,1.68
"20221114","1783","1440","1440",美林,8,14,6,-1,1.26
"20221114","1783","9666","9600",富邦-南屯,6,0,6,1,1.26
"20221114","1783","9255","9200",凱基-和平,3,9,6,-1,1.26
"20221114","1783","1115","1110",台灣企銀-太平,5,0,5,1,1.05
"20221114","1783","1480","1480",美商高盛,12,17,5,-1,1.05
"20221114","1783","8847","8840",玉山-台南,6,1,5,1,1.05
"20221114","1783","9256","9200",凱基-南崁,0,5,5,-1,1.05
"20221114","1783","9300","9300",華南永昌,5,0,5,1,1.05
"20221114","1783","9608","9600",富邦-台東,0,5,5,-1,1.05
"20221114","1783","0039003600310044","9600",富邦-忠孝,5,0,5,1,1.05
"20221114","1783","1111","1110",台灣企銀-台中,0,4,4,-1,0.84
"20221114","1783","003800380038004b","8880",國泰-板橋,5,0,5,1,1.05
"20221114","1783","5389","5380",第一金-中山,0,4,4,-1,0.84
"20221114","1783","9604","9600",富邦-陽明,5,2,3,1,0.63
"20221114","1783","7750","7750",北城證券,0,4,4,-1,0.84
"20221115","1783","1470","1470",台灣摩根士丹利,30,0,30,1,11.36
"20221115","1783","9891","9800",元大-永和,0,14,14,-1,5.30
"20221115","1783","0039003600310052","9600",富邦-南員林,10,0,10,1,3.79
"20221115","1783","0039003800310068","9800",元大-屏東民生,0,13,13,-1,4.92
"20221115","1783","1480","1480",美商高盛,9,0,9,1,3.41
"20221115","1783","0031003000330046","1030",土銀-南港,0,10,10,-1,3.79
"20221115","1783","6910","6910",德信,7,0,7,1,2.65
"20221115","1783","0039003800340043","9800",元大-新店中正,0,10,10,-1,3.79
"20221115","1783","8440","8440",摩根大通,10,4,6,1,2.27
"20221115","1783","1560","1560",港商野村,0,8,8,-1,3.03
"20221115","1783","9205","9200",凱基-三重,5,0,5,1,1.89
"20221115","1783","0035003800350049","5850",統一-員林,0,6,6,-1,2.27
"20221115","1783","1034","1030",土銀-嘉義,3,0,3,1,1.14
"20221115","1783","8847","8840",玉山-台南,0,6,6,-1,2.27
"20221115","1783","5855","5850",統一-台南,3,0,3,1,1.14
"20221115","1783","9666","9600",富邦-南屯,0,6,6,-1,2.27
"20221115","1783","9215","9200",凱基-高美館,3,0,3,1,1.14
"20221115","1783","9879","9800",元大-板橋三民,0,6,6,-1,2.27
"20221115","1783","9814","9800",元大-大益,3,0,3,1,1.14
"20221115","1783","0039003100330055","9100",群益金鼎-崇德,0,5,5,-1,1.89
"20221115","1783","003500320036004b","5260",美好-富順,9,7,2,1,0.76
"20221115","1783","9300","9300",華南永昌,0,5,5,-1,1.89
"20221115","1783","003500390032006f","5920",元富-新興,3,1,2,1,0.76
"20221115","1783","1650","1650",新加坡商瑞銀,7,11,4,-1,1.52
"20221115","1783","6462","6460",大昌-安康,2,0,2,1,0.76
"20221115","1783","1020","1020",合庫證券,0,4,4,-1,1.52
"20221115","1783","9255","9200",凱基-和平,2,0,2,1,0.76
"20221115","1783","5856","5850",統一-台中,0,4,4,-1,1.52
"20221116","1783","0039003100330049","9100",群益金鼎-萬華,12,0,12,1,7.06
"20221116","1783","8882","8880",國泰-台中,0,11,11,-1,6.47
"20221116","1783","1440","1440",美林,14,7,7,1,4.12
"20221116","1783","0037003000300053","7000",兆豐-大同,0,10,10,-1,5.88
"20221116","1783","0039003800390044","9800",元大-左營,5,0,5,1,2.94
"20221116","1783","8150","8150",台新證券,0,9,9,-1,5.29
"20221116","1783","003500390032006f","5920",元富-新興,4,0,4,1,2.35
"20221116","1783","1590","1590",花旗環球,0,8,8,-1,4.71
"20221116","1783","9658","9600",富邦-建國,4,0,4,1,2.35
"20221116","1783","9800","9800",元大證券,1,8,7,-1,4.12
"20221116","1783","0035003900320072","5920",元富-城東,3,0,3,1,1.76
"20221116","1783","5856","5850",統一-台中,0,5,5,-1,2.94
"20221116","1783","9814","9800",元大-大益,3,0,3,1,1.76
"20221116","1783","0037003700390045","7790",國票-南崁,0,5,5,-1,2.94
"20221116","1783","9867","9800",元大-北成功,3,0,3,1,1.76
"20221116","1783","003500390032005a","5920",元富-安南,2,6,4,-1,2.35
"20221116","1783","0039003800310044","9800",元大-南投,2,0,2,1,1.18
"20221116","1783","6465","6460",大昌-桃園,0,4,4,-1,2.35
"20221116","1783","1261","1260",宏遠-民生,2,0,2,1,1.18
"20221116","1783","9200","9200",凱基,0,4,4,-1,2.35
"20221116","1783","1021","1020",合庫-台中,2,0,2,1,1.18
"20221116","1783","0039004100300030","9A00",永豐金證券,1,5,4,-1,2.35
"20221116","1783","003500320036004b","5260",美好-富順,2,0,2,1,1.18
"20221116","1783","6462","6460",大昌-安康,0,3,3,-1,1.76
"20221116","1783","1480","1480",美商高盛,6,4,2,1,1.18
"20221116","1783","0039003600310048","9600",富邦-新板,0,3,3,-1,1.76
"20221116","1783","0035003900320047","5920",元富-新竹,2,0,2,1,1.18
"20221116","1783","1650","1650",新加坡商瑞銀,10,12,2,-1,1.18
"20221117","1783","1470","1470",台灣摩根士丹利,19,0,19,1,4.34
"20221117","1783","8560","8560",新光,4,24,20,-1,4.57
"20221117","1783","8440","8440",摩根大通,21,3,18,1,4.11
"20221117","1783","5384","5380",第一金-台南,0,12,12,-1,2.74
"20221117","1783","1440","1440",美林,33,16,17,1,3.88
"20221117","1783","0039003100330049","9100",群益金鼎-萬華,0,12,12,-1,2.74
"20221117","1783","9268","9200",凱基-台北,45,30,15,1,3.42
"20221117","1783","5854","5850",統一-城中,0,11,11,-1,2.51
"20221117","1783","0039003100380045","9100",群益金鼎-南京,12,0,12,1,2.74
"20221117","1783","9329","9300",華南永昌-朴子,0,11,11,-1,2.51
"20221117","1783","5850","5850",統一,10,0,10,1,2.28
"20221117","1783","9326","9300",華南永昌-南京,0,10,10,-1,2.28
"20221117","1783","5386","5380",第一金-彰化,10,0,10,1,2.28
"20221117","1783","5855","5850",統一-台南,0,8,8,-1,1.83
"20221117","1783","9205","9200",凱基-三重,9,0,9,1,2.05
"20221117","1783","0038003800380041","8880",國泰-館前,0,6,6,-1,1.37
"20221117","1783","0038003100350041","8150",台新-高雄,8,0,8,1,1.83
"20221117","1783","0031003000340041","1040",臺銀-臺中,0,5,5,-1,1.14
"20221117","1783","0039003600310044","9600",富邦-忠孝,7,0,7,1,1.60
"20221117","1783","1034","1030",土銀-嘉義,1,6,5,-1,1.14
"20221117","1783","9315","9300",華南永昌-苑裡,6,0,6,1,1.37
"20221117","1783","1115","1110",台灣企銀-太平,0,5,5,-1,1.14
"20221117","1783","0039003600320055","9600",富邦-縣政,6,0,6,1,1.37
"20221117","1783","003500320036004b","5260",美好-富順,0,5,5,-1,1.14
"20221117","1783","003900380031004b","9800",元大-林園,6,0,6,1,1.37
"20221117","1783","0039004100390072","9A00",永豐金-北高雄,0,5,5,-1,1.14
"20221117","1783","6461","6460",大昌-樹林,5,0,5,1,1.14
"20221117","1783","5856","5850",統一-台中,0,4,4,-1,0.91
"20221118","1783","1650","1650",新加坡商瑞銀,34,2,32,1,9.94
"20221118","1783","9897","9800",元大-土城,0,35,35,-1,10.87
"20221118","1783","1480","1480",美商高盛,22,4,18,1,5.59
"20221118","1783","0039003600310043","9600",富邦-南京,0,20,20,-1,6.21
"20221118","1783","9658","9600",富邦-建國,17,4,13,1,4.04
"20221118","1783","5850","5850",統一,0,10,10,-1,3.11
"20221118","1783","0037003000300043","7000",兆豐-來福,10,1,9,1,2.80
"20221118","1783","8560","8560",新光,0,6,6,-1,1.86
"20221118","1783","9672","9600",富邦-員林,6,0,6,1,1.86
"20221118","1783","1440","1440",美林,19,24,5,-1,1.55
"20221118","1783","6950","6950",福勝,5,0,5,1,1.55
"20221118","1783","003500380035004a","5850",統一-三重,0,5,5,-1,1.55
"20221118","1783","8151","8150",台新-建北,5,0,5,1,1.55
"20221118","1783","003800380034004a","8840",玉山-大里,0,5,5,-1,1.55
"20221118","1783","8440","8440",摩根大通,12,7,5,1,1.55
"20221118","1783","5384","5380",第一金-台南,0,4,4,-1,1.24
"20221118","1783","0039003800390044","9800",元大-左營,5,0,5,1,1.55
"20221118","1783","6160","6160",中國信託,0,4,4,-1,1.24
"20221118","1783","0037003700390065","7790",國票-南科,4,0,4,1,1.24
"20221118","1783","0037003700390063","7790",國票-敦北法人,0,4,4,-1,1.24
"20221118","1783","6451","6450",永全-南崁,3,0,3,1,0.93
"20221118","1783","0036003300380044","6380",光和-高雄,0,3,3,-1,0.93
"20221118","1783","9205","9200",凱基-三重,4,1,3,1,0.93
"20221118","1783","7750","7750",北城證券,1,4,3,-1,0.93
"20221118","1783","5321","5320",高橋-龍潭,2,0,2,1,0.62
"20221118","1783","8882","8880",國泰-台中,0,3,3,-1,0.93
"20221118","1783","003700300030004b","7000",兆豐-新營,2,0,2,1,0.62
"20221118","1783","0039003600320047","9600",富邦-斗六,0,3,3,-1,0.93
"20221121","1783","1470","1470",台灣摩根士丹利,25,0,25,1,6.30
"20221121","1783","5386","5380",第一金-彰化,1,11,10,-1,2.52
"20221121","1783","1480","1480",美商高盛,20,0,20,1,5.04
"20221121","1783","8888","8880",國泰-敦南,12,22,10,-1,2.52
"20221121","1783","8440","8440",摩根大通,14,3,11,1,2.77
"20221121","1783","0035003900320045","5920",元富-城中,0,10,10,-1,2.52
"20221121","1783","003500320036004b","5260",美好-富順,10,0,10,1,2.52
"20221121","1783","9223","9200",凱基-豐中,1,10,9,-1,2.27
"20221121","1783","003500390032006d","5920",元富-成功,10,0,10,1,2.52
"20221121","1783","8560","8560",新光,0,7,7,-1,1.76
"20221121","1783","8455","8450",康和-台中,10,0,10,1,2.52
"20221121","1783","0039003600320047","9600",富邦-斗六,0,6,6,-1,1.51
"20221121","1783","8849","8840",玉山-景美,10,0,10,1,2.52
"20221121","1783","003500380035004a","5850",統一-三重,0,6,6,-1,1.51
"20221121","1783","1560","1560",港商野村,9,1,8,1,2.02
"20221121","1783","003600310036004b","6160",中國信託-高雄,9,15,6,-1,1.51
"20221121","1783","0036003000310064","6010",(牛牛牛)亞-鑫豐,8,0,8,1,2.02
"20221121","1783","7750","7750",北城證券,0,6,6,-1,1.51
"20221121","1783","0039004100390073","9A00",永豐金-彰化,6,0,6,1,1.51
"20221121","1783","9315","9300",華南永昌-苑裡,0,6,6,-1,1.51
"20221121","1783","0035003300380049","5380",第一金-頭份,5,0,5,1,1.26
"20221121","1783","003900380039004c","9800",元大-成功,3,9,6,-1,1.51
"20221121","1783","0039003600310043","9600",富邦-南京,5,0,5,1,1.26
"20221121","1783","0039003100380044","9100",群益金鼎-東門,1,6,5,-1,1.26
"20221121","1783","0039003800380042","9800",元大-桃園,5,0,5,1,1.26
"20221121","1783","0039003200310045","9200",凱基-三峽,0,5,5,-1,1.26
"20221121","1783","1440","1440",美林,10,6,4,1,1.01
"20221121","1783","9300","9300",華南永昌,0,5,5,-1,1.26
"20221122","1783","9205","9200",凱基-三重,20,0,20,1,5.46
"20221122","1783","9268","9200",凱基-台北,5,46,41,-1,11.20
"20221122","1783","9672","9600",富邦-員林,13,0,13,1,3.55
"20221122","1783","1480","1480",美商高盛,6,44,38,-1,10.38
"20221122","1783","0037003000300049","7000",兆豐-北高雄,10,0,10,1,2.73
"20221122","1783","1440","1440",美林,6,39,33,-1,9.02
"20221122","1783","8849","8840",玉山-景美,8,0,8,1,2.19
"20221122","1783","8440","8440",摩根大通,0,23,23,-1,6.28
"20221122","1783","003900310038007a","9100",群益金鼎-宜蘭,8,0,8,1,2.19
"20221122","1783","0036003000310064","6010",(牛牛牛)亞-鑫豐,0,8,8,-1,2.19
"20221122","1783","9215","9200",凱基-高美館,8,0,8,1,2.19
"20221122","1783","8150","8150",台新證券,0,6,6,-1,1.64
"20221122","1783","9233","9200",凱基-長庚,6,0,6,1,1.64
"20221122","1783","0039003600320055","9600",富邦-縣政,0,6,6,-1,1.64
"20221122","1783","9647","9600",富邦-新竹,6,0,6,1,1.64
"20221122","1783","003900360032004c","9600",富邦-雙和,0,5,5,-1,1.37
"20221122","1783","003500390032006d","5920",元富-成功,5,0,5,1,1.37
"20221122","1783","0039003800310056","9800",元大-民雄,0,5,5,-1,1.37
"20221122","1783","5261","5260",美好-蘆洲,5,0,5,1,1.37
"20221122","1783","0035003300380049","5380",第一金-頭份,0,4,4,-1,1.09
"20221122","1783","1030","1030",土銀,5,0,5,1,1.37
"20221122","1783","9856","9800",元大-花蓮,1,5,4,-1,1.09
"20221122","1783","8455","8450",康和-台中,5,0,5,1,1.37
"20221122","1783","8846","8840",玉山-板橋,0,3,3,-1,0.82
"20221122","1783","8888","8880",國泰-敦南,6,1,5,1,1.37
"20221122","1783","9853","9800",元大-南屯,1,4,3,-1,0.82
"20221122","1783","9256","9200",凱基-南崁,10,5,5,1,1.37
"20221122","1783","003900380039004a","9800",元大-彰化民生,0,3,3,-1,0.82
"20221123","1783","1470","1470",台灣摩根士丹利,25,0,25,1,10.29
"20221123","1783","8888","8880",國泰-敦南,0,10,10,-1,4.12
"20221123","1783","9856","9800",元大-花蓮,22,0,22,1,9.05
"20221123","1783","003500320036004b","5260",美好-富順,0,10,10,-1,4.12
"20221123","1783","9268","9200",凱基-台北,26,5,21,1,8.64
"20221123","1783","9215","9200",凱基-高美館,0,9,9,-1,3.70
"20221123","1783","8440","8440",摩根大通,26,8,18,1,7.41
"20221123","1783","0031003000320046","1020",合庫-西台中,0,5,5,-1,2.06
"20221123","1783","1480","1480",美商高盛,14,1,13,1,5.35
"20221123","1783","6950","6950",福勝,0,5,5,-1,2.06
"20221123","1783","1440","1440",美林,8,2,6,1,2.47
"20221123","1783","8455","8450",康和-台中,0,5,5,-1,2.06
"20221123","1783","0035003900320072","5920",元富-城東,5,0,5,1,2.06
"20221123","1783","9184","9100",群益金鼎-台中,0,5,5,-1,2.06
"20221123","1783","003900310038007a","9100",群益金鼎-宜蘭,4,0,4,1,1.65
"20221123","1783","9256","9200",凱基-南崁,0,5,5,-1,2.06
"20221123","1783","003900320030005a","9200",凱基-台東,4,0,4,1,1.65
"20221123","1783","0039003600320043","9600",富邦-東門,0,5,5,-1,2.06
"20221123","1783","9862","9800",元大-南京,4,0,4,1,1.65
"20221123","1783","9608","9600",富邦-台東,0,4,4,-1,1.65
"20221123","1783","003700300030004b","7000",兆豐-新營,3,0,3,1,1.23
"20221123","1783","003900380031006d","9800",元大-前金,0,4,4,-1,1.65
"20221123","1783","1260","1260",宏遠證券,2,0,2,1,0.82
"20221123","1783","7031","7030",致和-台北,0,3,3,-1,1.23
"20221123","1783","0035003900320045","5920",元富-城中,2,0,2,1,0.82
"20221123","1783","0038003800340044","8840",玉山-左營,0,3,3,-1,1.23
"20221123","1783","7797","7790",國票-中正,2,0,2,1,0.82
"20221123","1783","0038003800340046","8840",玉山-桃園,0,3,3,-1,1.23
"20221124","1783","8888","8880",國泰-敦南,10,0,10,1,5.00
"20221124","1783","1480","1480",美商高盛,1,20,19,-1,9.50
"20221124","1783","9856","9800",元大-花蓮,9,0,9,1,4.50
"20221124","1783","8440","8440",摩根大通,5,16,11,-1,5.50
"20221124","1783","8455","8450",康和-台中,5,0,5,1,2.50
"20221124","1783","1650","1650",新加坡商瑞銀,5,13,8,-1,4.00
"20221124","1783","003900380039004e","9800",元大-內湖,5,0,5,1,2.50
"20221124","1783","9647","9600",富邦-新竹,0,6,6,-1,3.00
"20221124","1783","1590","1590",花旗環球,4,0,4,1,2.00
"20221124","1783","003700370039004a","7790",國票-北高雄,0,5,5,-1,2.50
"20221124","1783","9608","9600",富邦-台東,5,1,4,1,2.00
"20221124","1783","9324","9300",華南永昌-岡山,0,5,5,-1,2.50
"20221124","1783","0039003800310046","9800",元大-福營,4,0,4,1,2.00
"20221124","1783","0039003800380042","9800",元大-桃園,0,5,5,-1,2.50
"20221124","1783","9838","9800",元大-豐原,4,0,4,1,2.00
"20221124","1783","0039003800310055","9800",元大-華山,0,4,4,-1,2.00
"20221124","1783","9891","9800",元大-永和,5,1,4,1,2.00
"20221124","1783","5922","5920",元富-新店,0,3,3,-1,1.50
"20221124","1783","1042","1040",臺銀-臺南,3,0,3,1,1.50
"20221124","1783","6465","6460",大昌-桃園,0,3,3,-1,1.50
"20221124","1783","8561","8560",新光-台中,3,0,3,1,1.50
"20221124","1783","0039003800310065","9800",元大-佳里,0,3,3,-1,1.50
"20221124","1783","0038003800380041","8880",國泰-館前,3,0,3,1,1.50
"20221124","1783","1440","1440",美林,2,4,2,-1,1.00
"20221124","1783","0039003100330045","9100",群益金鼎-基隆,3,0,3,1,1.50
"20221124","1783","7030","7030",致和證券,0,2,2,-1,1.00
"20221124","1783","9672","9600",富邦-員林,3,0,3,1,1.50
"20221124","1783","003900310038004c","9100",群益金鼎-建成,0,2,2,-1,1.00
"20221125","1783","9334","9300",華南永昌-世貿,35,0,35,1,15.22
"20221125","1783","6380","6380",光和,0,30,30,-1,13.04
"20221125","1783","1480","1480",美商高盛,14,0,14,1,6.09
"20221125","1783","8440","8440",摩根大通,0,16,16,-1,6.96
"20221125","1783","9268","9200",凱基-台北,30,17,13,1,5.65
"20221125","1783","9857","9800",元大-東蘆,0,7,7,-1,3.04
"20221125","1783","0037003000300049","7000",兆豐-北高雄,10,0,10,1,4.35
"20221125","1783","1040","1040",臺銀,0,5,5,-1,2.17
"20221125","1783","8849","8840",玉山-景美,10,0,10,1,4.35
"20221125","1783","1032","1030",土銀-台南,0,5,5,-1,2.17
"20221125","1783","1029","1020",合庫-鳳山,5,0,5,1,2.17
"20221125","1783","003500390032006d","5920",元富-成功,0,5,5,-1,2.17
"20221125","1783","1590","1590",花旗環球,5,0,5,1,2.17
"20221125","1783","0037003700390045","7790",國票-南崁,0,5,5,-1,2.17
"20221125","1783","0039003100380042","9100",群益金鼎-板橋,5,0,5,1,2.17
"20221125","1783","0039004100380046","9A00",永豐金-敦南,0,5,5,-1,2.17
"20221125","1783","9623","9600",富邦-台北,5,0,5,1,2.17
"20221125","1783","9838","9800",元大-豐原,0,4,4,-1,1.74
"20221125","1783","0035003300380049","5380",第一金-頭份,3,0,3,1,1.30
"20221125","1783","6164","6160",中國信託-文心,0,3,3,-1,1.30
"20221125","1783","003500330038004e","5380",第一金-豐原,3,0,3,1,1.30
"20221125","1783","9205","9200",凱基-三重,0,3,3,-1,1.30
"20221125","1783","5856","5850",統一-台中,4,1,3,1,1.30
"20221125","1783","0031003200360058","1260",宏遠-新化,0,2,2,-1,0.87
"20221125","1783","9672","9600",富邦-員林,2,0,2,1,0.87
"20221125","1783","1650","1650",新加坡商瑞銀,14,16,2,-1,0.87
"20221125","1783","9801","9800",元大-城東,2,0,2,1,0.87
"20221125","1783","0038003800340044","8840",玉山-左營,0,2,2,-1,0.87
"20221128","1783","1480","1480",美商高盛,57,0,57,1,7.93
"20221128","1783","9614","9600",富邦-基隆,0,31,31,-1,4.31
"20221128","1783","9268","9200",凱基-台北,69,18,51,1,7.09
"20221128","1783","9255","9200",凱基-和平,2,30,28,-1,3.89
"20221128","1783","0031003000320041","1020",合庫-新竹,45,0,45,1,6.26
"20221128","1783","8888","8880",國泰-敦南,5,27,22,-1,3.06
"20221128","1783","1470","1470",台灣摩根士丹利,45,0,45,1,6.26
"20221128","1783","8440","8440",摩根大通,19,36,17,-1,2.36
"20221128","1783","9692","9600",富邦-嘉義,43,2,41,1,5.70
"20221128","1783","8158","8150",台新-松江,0,16,16,-1,2.23
"20221128","1783","9307","9300",華南永昌-大安,30,1,29,1,4.03
"20221128","1783","1030","1030",土銀,0,15,15,-1,2.09
"20221128","1783","1440","1440",美林,23,7,16,1,2.23
"20221128","1783","7006","7000",兆豐-台南,0,15,15,-1,2.09
"20221128","1783","1650","1650",新加坡商瑞銀,36,22,14,1,1.95
"20221128","1783","8455","8450",康和-台中,0,15,15,-1,2.09
"20221128","1783","1560","1560",港商野村,11,1,10,1,1.39
"20221128","1783","0035003800350046","5850",統一-彰化,0,10,10,-1,1.39
"20221128","1783","0037003000300049","7000",兆豐-北高雄,10,0,10,1,1.39
"20221128","1783","0035003800350059","5850",統一-土城,0,10,10,-1,1.39
"20221128","1783","003900380031004b","9800",元大-林園,9,0,9,1,1.25
"20221128","1783","003500390032006d","5920",元富-成功,0,10,10,-1,1.39
"20221128","1783","0039003800390043","9800",元大-板橋,11,2,9,1,1.25
"20221128","1783","9223","9200",凱基-豐中,0,10,10,-1,1.39
"20221128","1783","5852","5850",統一-敦南,6,0,6,1,0.83
"20221128","1783","0039003600310043","9600",富邦-南京,0,8,8,-1,1.11
"20221128","1783","0039003800390047","9800",元大-大同,6,0,6,1,0.83
"20221128","1783","003500330038004e","5380",第一金-豐原,0,7,7,-1,0.97
"20221129","1783","9296","9200",凱基-頭份,12,0,12,1,5.50
"20221129","1783","9268","9200",凱基-台北,26,38,12,-1,5.50
"20221129","1783","0039003600310047","9600",富邦-成功,10,0,10,1,4.59
"20221129","1783","1650","1650",新加坡商瑞銀,1,11,10,-1,4.59
"20221129","1783","9692","9600",富邦-嘉義,11,1,10,1,4.59
"20221129","1783","1440","1440",美林,1,11,10,-1,4.59
"20221129","1783","1470","1470",台灣摩根士丹利,8,0,8,1,3.67
"20221129","1783","1480","1480",美商高盛,0,5,5,-1,2.29
"20221129","1783","6163","6160",中國信託-永康,7,0,7,1,3.21
"20221129","1783","6950","6950",福勝,0,5,5,-1,2.29
"20221129","1783","9347","9300",華南永昌-敦南,7,0,7,1,3.21
"20221129","1783","9343","9300",華南永昌-頭份,0,5,5,-1,2.29
"20221129","1783","5603","5600",永興-台中,6,0,6,1,2.75
"20221129","1783","9801","9800",元大-城東,0,5,5,-1,2.29
"20221129","1783","0037003000300069","7000",兆豐-松德,6,1,5,1,2.29
"20221129","1783","0039004100390050","9A00",永豐金-竹北,0,5,5,-1,2.29
"20221129","1783","8887","8880",國泰-忠孝,5,0,5,1,2.29
"20221129","1783","003700300030004d","7000",兆豐-桃園,0,4,4,-1,1.83
"20221129","1783","003800380038004b","8880",國泰-板橋,6,3,3,1,1.38
"20221129","1783","8158","8150",台新-松江,0,4,4,-1,1.83
"20221129","1783","9814","9800",元大-大益,5,2,3,1,1.38
"20221129","1783","0039003600320042","9600",富邦-二林,1,5,4,-1,1.83
"20221129","1783","5856","5850",統一-台中,2,0,2,1,0.92
"20221129","1783","0039003800310046","9800",元大-福營,0,4,4,-1,1.83
"20221129","1783","8157","8150",台新-左楠,2,0,2,1,0.92
"20221129","1783","9853","9800",元大-南屯,0,4,4,-1,1.83
"20221129","1783","9101","9100",群益金鼎-敦南,2,0,2,1,0.92
"20221129","1783","8560","8560",新光,1,4,3,-1,1.38
"20221130","1783","9334","9300",華南永昌-世貿,14,0,14,1,6.83
"20221130","1783","9268","9200",凱基-台北,6,35,29,-1,14.15
"20221130","1783","0037003000300069","7000",兆豐-松德,12,0,12,1,5.85
"20221130","1783","0039004100390061","9A00",永豐金-苓雅,0,15,15,-1,7.32
"20221130","1783","9296","9200",凱基-頭份,11,0,11,1,5.37
"20221130","1783","0039003600310047","9600",富邦-成功,0,10,10,-1,4.88
"20221130","1783","1470","1470",台灣摩根士丹利,9,0,9,1,4.39
"20221130","1783","5603","5600",永興-台中,0,8,8,-1,3.90
"20221130","1783","1590","1590",花旗環球,6,0,6,1,2.93
"20221130","1783","6163","6160",中國信託-永康,0,7,7,-1,3.41
"20221130","1783","0035003800350046","5850",統一-彰化,5,0,5,1,2.44
"20221130","1783","1440","1440",美林,4,10,6,-1,2.93
"20221130","1783","8887","8880",國泰-忠孝,5,0,5,1,2.44
"20221130","1783","003900380033006a","9800",元大-仁愛,0,6,6,-1,2.93
"20221130","1783","9349","9300",華南永昌-板橋,4,0,4,1,1.95
"20221130","1783","1650","1650",新加坡商瑞銀,8,13,5,-1,2.44
"20221130","1783","0035003800350053","5850",統一-宜蘭,3,0,3,1,1.46
"20221130","1783","0039003100380042","9100",群益金鼎-板橋,0,2,2,-1,0.98
"20221130","1783","9692","9600",富邦-嘉義,7,4,3,1,1.46
"20221130","1783","9234","9200",凱基-竹北,0,2,2,-1,0.98
"20221130","1783","0039003800330056","9800",元大-竹南,3,0,3,1,1.46
"20221130","1783","0039003600320042","9600",富邦-二林,0,2,2,-1,0.98
"20221130","1783","1042","1040",臺銀-臺南,2,0,2,1,0.98
"20221130","1783","0039003800310056","9800",元大-民雄,0,2,2,-1,0.98
"20221130","1783","1040","1040",臺銀,2,0,2,1,0.98
"20221130","1783","9892","9800",元大-屏東,0,2,2,-1,0.98
"20221130","1783","9101","9100",群益金鼎-敦南,2,0,2,1,0.98
"20221130","1783","0038003100350042","8150",台新-台中,0,1,1,-1,0.49
"20221003","1783","9205","9200",凱基-三重,11,0,11,1,4.23
"20221003","1783","8440","8440",摩根大通,0,23,23,-1,8.85
"20221003","1783","0039003100380044","9100",群益金鼎-東門,10,0,10,1,3.85
"20221003","1783","9268","9200",凱基-台北,22,44,22,-1,8.46
"20221003","1783","9239","9200",凱基-市政,10,0,10,1,3.85
"20221003","1783","1480","1480",美商高盛,5,21,16,-1,6.15
"20221003","1783","5261","5260",美好-蘆洲,8,0,8,1,3.08
"20221003","1783","8888","8880",國泰-敦南,0,15,15,-1,5.77
"20221003","1783","9223","9200",凱基-豐中,10,2,8,1,3.08
"20221003","1783","1470","1470",台灣摩根士丹利,0,8,8,-1,3.08
"20221003","1783","0039004100390066","9A00",永豐金-中盛,9,2,7,1,2.69
"20221003","1783","1440","1440",美林,6,14,8,-1,3.08
"20221003","1783","1032","1030",土銀-台南,5,0,5,1,1.92
"20221003","1783","9867","9800",元大-北成功,0,7,7,-1,2.69
"20221003","1783","0035003300380049","5380",第一金-頭份,5,0,5,1,1.92
"20221003","1783","1560","1560",港商野村,0,6,6,-1,2.31
"20221003","1783","0037003700390065","7790",國票-南科,5,0,5,1,1.92
"20221003","1783","9302","9300",華南永昌-台中,0,6,6,-1,2.31
"20221003","1783","8158","8150",台新-松江,5,0,5,1,1.92
"20221003","1783","1650","1650",新加坡商瑞銀,6,11,5,-1,1.92
"20221003","1783","9814","9800",元大-大益,5,0,5,1,1.92
"20221003","1783","003500380035004d","5850",統一-士林,0,5,5,-1,1.92
"20221003","1783","9892","9800",元大-屏東,5,0,5,1,1.92
"20221003","1783","003900410039004e","9A00",永豐金-桃盛,0,5,5,-1,1.92
"20221003","1783","003500320036004b","5260",美好-富順,5,1,4,1,1.54
"20221003","1783","0036003300380044","6380",光和-高雄,0,3,3,-1,1.15
"20221003","1783","0039003600310052","9600",富邦-南員林,4,0,4,1,1.54
"20221003","1783","9187","9100",群益金鼎-彰化,0,3,3,-1,1.15
"20221004","1783","8451","8450",康和-延平,19,0,19,1,10.33
"20221004","1783","8158","8150",台新-松江,0,15,15,-1,8.15
"20221004","1783","9268","9200",凱基-台北,27,8,19,1,10.33
"20221004","1783","8560","8560",新光,1,16,15,-1,8.15
"20221004","1783","0035003300380050","5380",第一金-路竹,10,0,10,1,5.43
"20221004","1783","9858","9800",元大-龍潭,0,8,8,-1,4.35
"20221004","1783","8440","8440",摩根大通,10,1,9,1,4.89
"20221004","1783","003700300030006b","7000",兆豐-員林,0,5,5,-1,2.72
"20221004","1783","1650","1650",新加坡商瑞銀,10,3,7,1,3.80
"20221004","1783","8380","8380",安泰,0,5,5,-1,2.72
"20221004","1783","1440","1440",美林,6,0,6,1,3.26
"20221004","1783","8884","8880",國泰-台南,0,5,5,-1,2.72
"20221004","1783","9300","9300",華南永昌,3,0,3,1,1.63
"20221004","1783","003500320036004b","5260",美好-富順,0,4,4,-1,2.17
"20221004","1783","9215","9200",凱基-高美館,2,0,2,1,1.09
"20221004","1783","0039003800310071","9800",元大-萬華,1,5,4,-1,2.17
"20221004","1783","1470","1470",台灣摩根士丹利,7,5,2,1,1.09
"20221004","1783","5263","5260",美好-泰山,0,3,3,-1,1.63
"20221004","1783","0035003300380045","5380",第一金-自由,2,0,2,1,1.09
"20221004","1783","0037003000300063","7000",兆豐-民生,0,3,3,-1,1.63
"20221004","1783","1590","1590",花旗環球,2,0,2,1,1.09
"20221004","1783","0039003800390045","9800",元大-草屯,0,3,3,-1,1.63
"20221004","1783","8886","8880",國泰-新莊,2,0,2,1,1.09
"20221004","1783","5855","5850",統一-台南,0,2,2,-1,1.09
"20221004","1783","9204","9200",凱基-台中,2,0,2,1,1.09
"20221004","1783","0035003900320076","5920",元富-桃園,0,2,2,-1,1.09
"20221004","1783","9297","9200",凱基-文心,2,0,2,1,1.09
"20221004","1783","8563","8560",新光-新竹,0,2,2,-1,1.09
"20221005","1783","8560","8560",新光,32,2,30,1,11.54
"20221005","1783","0039003600320047","9600",富邦-斗六,0,18,18,-1,6.92
"20221005","1783","8886","8880",國泰-新莊,5,0,5,1,1.92
"20221005","1783","1480","1480",美商高盛,2,17,15,-1,5.77
"20221005","1783","9300","9300",華南永昌,5,0,5,1,1.92
"20221005","1783","0039003100380044","9100",群益金鼎-東門,0,12,12,-1,4.62
"20221005","1783","0035003300380045","5380",第一金-自由,4,0,4,1,1.54
"20221005","1783","1470","1470",台灣摩根士丹利,0,11,11,-1,4.23
"20221005","1783","003900380039004a","9800",元大-彰化民生,4,0,4,1,1.54
"20221005","1783","0039003800390049","9800",元大-蘆洲,0,10,10,-1,3.85
"20221005","1783","003700300030004c","7000",兆豐-天母,3,0,3,1,1.15
"20221005","1783","5384","5380",第一金-台南,0,9,9,-1,3.46
"20221005","1783","0038003100350042","8150",台新-台中,3,0,3,1,1.15
"20221005","1783","0039003800390045","9800",元大-草屯,0,7,7,-1,2.69
"20221005","1783","9834","9800",元大-中壢,3,0,3,1,1.15
"20221005","1783","5261","5260",美好-蘆洲,1,7,6,-1,2.31
"20221005","1783","1560","1560",港商野村,2,0,2,1,0.77
"20221005","1783","1650","1650",新加坡商瑞銀,9,15,6,-1,2.31
"20221005","1783","0031003000340041","1040",臺銀-臺中,2,0,2,1,0.77
"20221005","1783","8440","8440",摩根大通,3,9,6,-1,2.31
"20221005","1783","1034","1030",土銀-嘉義,2,0,2,1,0.77
"20221005","1783","1440","1440",美林,0,5,5,-1,1.92
"20221005","1783","5381","5380",第一金-員林,2,0,2,1,0.77
"20221005","1783","8150","8150",台新證券,6,11,5,-1,1.92
"20221005","1783","003500390032005a","5920",元富-安南,2,0,2,1,0.77
"20221005","1783","0039003600320044","9600",富邦-新莊,0,5,5,-1,1.92
"20221005","1783","6110","6110",台中銀,2,0,2,1,0.77
"20221005","1783","0036003100360041","6160",中國信託-中壢,0,3,3,-1,1.15
"20221006","1783","8451","8450",康和-延平,42,0,42,1,13.17
"20221006","1783","9319","9300",華南永昌-鶯歌,0,46,46,-1,14.42
"20221006","1783","6465","6460",大昌-桃園,15,0,15,1,4.70
"20221006","1783","0037003700390044","7790",國票-台南,0,10,10,-1,3.13
"20221006","1783","1440","1440",美林,11,0,11,1,3.45
"20221006","1783","9692","9600",富邦-嘉義,2,10,8,-1,2.51
"20221006","1783","1560","1560",港商野村,8,0,8,1,2.51
"20221006","1783","0035003300380045","5380",第一金-自由,0,6,6,-1,1.88
"20221006","1783","0038003800340045","8840",玉山-城中,6,0,6,1,1.88
"20221006","1783","5323","5320",高橋-內壢,0,5,5,-1,1.57
"20221006","1783","1480","1480",美商高盛,11,6,5,1,1.57
"20221006","1783","9233","9200",凱基-長庚,0,5,5,-1,1.57
"20221006","1783","7007","7000",兆豐-竹北,3,0,3,1,0.94
"20221006","1783","0039003800310053","9800",元大-崇德,0,5,5,-1,1.57
"20221006","1783","7080","7080",石橋證券,3,0,3,1,0.94
"20221006","1783","003900380039004a","9800",元大-彰化民生,0,5,5,-1,1.57
"20221006","1783","0037003700390045","7790",國票-南崁,3,0,3,1,0.94
"20221006","1783","9846","9800",元大-大直,0,4,4,-1,1.25
"20221006","1783","8150","8150",台新證券,5,2,3,1,0.94
"20221006","1783","003700300030004c","7000",兆豐-天母,0,3,3,-1,0.94
"20221006","1783","9205","9200",凱基-三重,3,0,3,1,0.94
"20221006","1783","8520","8520",中農,0,3,3,-1,0.94
"20221006","1783","9256","9200",凱基-南崁,3,0,3,1,0.94
"20221006","1783","9206","9200",凱基-高雄,0,3,3,-1,0.94
"20221006","1783","9852","9800",元大-永春,3,0,3,1,0.94
"20221006","1783","0039004100390073","9A00",永豐金-彰化,0,3,3,-1,0.94
"20221006","1783","0039003800390055","9800",元大-大甲,3,0,3,1,0.94
"20221006","1783","1650","1650",新加坡商瑞銀,10,12,2,-1,0.63
"20221007","1783","8560","8560",新光,12,2,10,1,7.04
"20221007","1783","003900360031004d","9600",富邦-木柵,0,10,10,-1,7.04
"20221007","1783","0039003200310047","9200",凱基-五股,10,0,10,1,7.04
"20221007","1783","003900360035004b","9600",富邦-台中,0,10,10,-1,7.04
"20221007","1783","6465","6460",大昌-桃園,9,0,9,1,6.34
"20221007","1783","1440","1440",美林,0,7,7,-1,4.93
"20221007","1783","9363","9300",華南永昌-彰化,8,0,8,1,5.63
"20221007","1783","003900380039004c","9800",元大-成功,0,7,7,-1,4.93
"20221007","1783","1480","1480",美商高盛,8,2,6,1,4.23
"20221007","1783","8150","8150",台新證券,0,6,6,-1,4.23
"20221007","1783","9302","9300",華南永昌-台中,6,0,6,1,4.23
"20221007","1783","1470","1470",台灣摩根士丹利,0,5,5,-1,3.52
"20221007","1783","003900310038004b","9100",群益金鼎-東湖,5,0,5,1,3.52
"20221007","1783","9233","9200",凱基-長庚,0,5,5,-1,3.52
"20221007","1783","0039004100390067","9A00",永豐金-內湖,5,0,5,1,3.52
"20221007","1783","7080","7080",石橋證券,0,3,3,-1,2.11
"20221007","1783","003900410039004b","9A00",永豐金-三重,5,0,5,1,3.52
"20221007","1783","7750","7750",北城證券,0,2,2,-1,1.41
"20221007","1783","6460","6460",大昌,4,0,4,1,2.82
"20221007","1783","003900380036004b","9800",元大-基隆孝二,0,2,2,-1,1.41
"20221007","1783","0035003800350048","5850",統一-桃園,3,0,3,1,2.11
"20221007","1783","0039003600320047","9600",富邦-斗六,0,2,2,-1,1.41
"20221007","1783","0039003200300048","9200",凱基-基隆,3,0,3,1,2.11
"20221007","1783","5386","5380",第一金-彰化,0,1,1,-1,0.70
"20221007","1783","8564","8560",新光-台南,2,0,2,1,1.41
"20221007","1783","5384","5380",第一金-台南,0,1,1,-1,0.70
"20221007","1783","1650","1650",新加坡商瑞銀,3,1,2,1,1.41
"20221007","1783","2180","2180",亞東,0,1,1,-1,0.70
"20221011","1783","9278","9200",凱基-永康,22,0,22,1,5.66
"20221011","1783","6165","6160",中國信託-新竹,0,44,44,-1,11.31
"20221011","1783","7006","7000",兆豐-台南,23,3,20,1,5.14
"20221011","1783","8843","8840",玉山-高雄,4,40,36,-1,9.25
"20221011","1783","8158","8150",台新-松江,20,0,20,1,5.14
"20221011","1783","8440","8440",摩根大通,1,25,24,-1,6.17
"20221011","1783","6168","6160",中國信託-嘉義,17,2,15,1,3.86
"20221011","1783","9268","9200",凱基-台北,8,22,14,-1,3.60
"20221011","1783","0039003800340043","9800",元大-新店中正,15,0,15,1,3.86
"20221011","1783","1560","1560",港商野村,0,10,10,-1,2.57
"20221011","1783","8560","8560",新光,14,3,11,1,2.83
"20221011","1783","1480","1480",美商高盛,5,15,10,-1,2.57
"20221011","1783","0038003400350055","8450",康和-台北,11,0,11,1,2.83
"20221011","1783","0039003600320059","9600",富邦-土城,0,10,10,-1,2.57
"20221011","1783","5266","5260",美好-中壢,10,0,10,1,2.57
"20221011","1783","1440","1440",美林,2,11,9,-1,2.31
"20221011","1783","9256","9200",凱基-南崁,10,0,10,1,2.57
"20221011","1783","0037003000300063","7000",兆豐-民生,0,8,8,-1,2.06
"20221011","1783","9272","9200",凱基-竹科,12,4,8,1,2.06
"20221011","1783","0039003800310065","9800",元大-佳里,0,8,8,-1,2.06
"20221011","1783","9813","9800",元大-八德,16,9,7,1,1.80
"20221011","1783","0039003100380063","9100",群益金鼎-鳳山,2,9,7,-1,1.80
"20221011","1783","6465","6460",大昌-桃園,6,0,6,1,1.54
"20221011","1783","9676","9600",富邦-仁愛,0,6,6,-1,1.54
"20221011","1783","9892","9800",元大-屏東,6,0,6,1,1.54
"20221011","1783","9852","9800",元大-永春,2,8,6,-1,1.54
"20221011","1783","9187","9100",群益金鼎-彰化,5,0,5,1,1.29
"20221011","1783","9208","9200",凱基-桃園,0,5,5,-1,1.29
"20221012","1783","9268","9200",凱基-台北,33,17,16,1,5.39
"20221012","1783","0039003800300052","9800",元大-南海,0,27,27,-1,9.09
"20221012","1783","8560","8560",新光,11,2,9,1,3.03
"20221012","1783","8711","8710",陽信-石牌,0,26,26,-1,8.75
"20221012","1783","9256","9200",凱基-南崁,7,0,7,1,2.36
"20221012","1783","003500390032004d","5920",元富-彰化,0,25,25,-1,8.42
"20221012","1783","1480","1480",美商高盛,10,4,6,1,2.02
"20221012","1783","003900380036004b","9800",元大-基隆孝二,0,11,11,-1,3.70
"20221012","1783","2180","2180",亞東,7,1,6,1,2.02
"20221012","1783","9233","9200",凱基-長庚,0,10,10,-1,3.37
"20221012","1783","9278","9200",凱基-永康,6,0,6,1,2.02
"20221012","1783","9692","9600",富邦-嘉義,0,10,10,-1,3.37
"20221012","1783","1111","1110",台灣企銀-台中,5,0,5,1,1.68
"20221012","1783","003900380039006d","9800",元大-信義,2,10,8,-1,2.69
"20221012","1783","8158","8150",台新-松江,5,0,5,1,1.68
"20221012","1783","5266","5260",美好-中壢,0,5,5,-1,1.68
"20221012","1783","0039003800340043","9800",元大-新店中正,5,0,5,1,1.68
"20221012","1783","1440","1440",美林,7,12,5,-1,1.68
"20221012","1783","0039004100360031","9A00",永豐金-鳳山,5,0,5,1,1.68
"20221012","1783","0039003100380042","9100",群益金鼎-板橋,0,5,5,-1,1.68
"20221012","1783","5384","5380",第一金-台南,4,0,4,1,1.35
"20221012","1783","0039003800390043","9800",元大-板橋,0,5,5,-1,1.68
"20221012","1783","9239","9200",凱基-市政,4,0,4,1,1.35
"20221012","1783","0031003200360048","1260",宏遠-中和,0,4,4,-1,1.35
"20221012","1783","0039003600320047","9600",富邦-斗六,4,0,4,1,1.35
"20221012","1783","9272","9200",凱基-竹科,0,4,4,-1,1.35
"20221012","1783","0039003800320042","9800",元大-博愛,4,0,4,1,1.35
"20221012","1783","8561","8560",新光-台中,0,3,3,-1,1.01
"20221013","1783","8440","8440",摩根大通,103,21,82,1,9.11
"20221013","1783","9100","9100",群益金鼎,0,105,105,-1,11.67
"20221013","1783","8560","8560",新光,58,22,36,1,4.00
"20221013","1783","9239","9200",凱基-市政,3,72,69,-1,7.67
"20221013","1783","1480","1480",美商高盛,40,8,32,1,3.56
"20221013","1783","9872","9800",元大-復北,0,55,55,-1,6.11
"20221013","1783","1650","1650",新加坡商瑞銀,42,12,30,1,3.33
"20221013","1783","0038003800340048","8840",玉山-新竹,2,50,48,-1,5.33
"20221013","1783","8158","8150",台新-松江,30,0,30,1,3.33
"20221013","1783","0035003900320072","5920",元富-城東,0,34,34,-1,3.78
"20221013","1783","8451","8450",康和-延平,30,0,30,1,3.33
"20221013","1783","1110","1110",台灣企銀,0,25,25,-1,2.78
"20221013","1783","1440","1440",美林,33,8,25,1,2.78
"20221013","1783","1024","1020",合庫-嘉義,0,19,19,-1,2.11
"20221013","1783","9215","9200",凱基-高美館,20,0,20,1,2.22
"20221013","1783","9233","9200",凱基-長庚,0,16,16,-1,1.78
"20221013","1783","8886","8880",國泰-新莊,19,0,19,1,2.11
"20221013","1783","8888","8880",國泰-敦南,1,16,15,-1,1.67
"20221013","1783","1470","1470",台灣摩根士丹利,18,0,18,1,2.00
"20221013","1783","9302","9300",華南永昌-台中,7,20,13,-1,1.44
"20221013","1783","7006","7000",兆豐-台南,15,0,15,1,1.67
"20221013","1783","2180","2180",亞東,0,12,12,-1,1.33
"20221013","1783","0037003700390065","7790",國票-南科,14,0,14,1,1.56
"20221013","1783","9837","9800",元大-北港,0,9,9,-1,1.00
"20221013","1783","0039003600310045","9600",富邦-府城,10,0,10,1,1.11
"20221013","1783","0039003800390046","9800",元大-高雄,0,9,9,-1,1.00
"20221013","1783","9655","9600",富邦-板橋,10,0,10,1,1.11
"20221013","1783","9300","9300",華南永昌,1,9,8,-1,0.89
"20221014","1783","1440","1440",美林,29,9,20,1,5.46
"20221014","1783","0037003000300067","7000",兆豐-南門,0,42,42,-1,11.48
"20221014","1783","0039003200310047","9200",凱基-五股,20,0,20,1,5.46
"20221014","1783","0038003800380041","8880",國泰-館前,0,40,40,-1,10.93
"20221014","1783","1470","1470",台灣摩根士丹利,17,0,17,1,4.64
"20221014","1783","9268","9200",凱基-台北,20,36,16,-1,4.37
"20221014","1783","0035003900320072","5920",元富-城東,10,0,10,1,2.73
"20221014","1783","9215","9200",凱基-高美館,0,15,15,-1,4.10
"20221014","1783","9223","9200",凱基-豐中,10,0,10,1,2.73
"20221014","1783","8440","8440",摩根大通,9,19,10,-1,2.73
"20221014","1783","8560","8560",新光,10,1,9,1,2.46
"20221014","1783","9858","9800",元大-龍潭,2,10,8,-1,2.19
"20221014","1783","0039004100390044","9A00",永豐金-忠孝,7,0,7,1,1.91
"20221014","1783","6168","6160",中國信託-嘉義,0,7,7,-1,1.91
"20221014","1783","0037003700390050","7790",國票-九鼎,5,0,5,1,1.37
"20221014","1783","9859","9800",元大-新竹經國,1,7,6,-1,1.64
"20221014","1783","0039003600310050","9600",富邦-和美,5,0,5,1,1.37
"20221014","1783","9815","9800",元大-大灣,0,4,4,-1,1.09
"20221014","1783","9814","9800",元大-大益,5,0,5,1,1.37
"20221014","1783","003900380039006b","9800",元大-古亭,0,4,4,-1,1.09
"20221014","1783","1560","1560",港商野村,4,0,4,1,1.09
"20221014","1783","9852","9800",元大-永春,0,3,3,-1,0.82
"20221014","1783","003500380035004a","5850",統一-三重,4,0,4,1,1.09
"20221014","1783","0039004100390051","9A00",永豐金-豐原,0,3,3,-1,0.82
"20221014","1783","003500390032006f","5920",元富-新興,6,2,4,1,1.09
"20221014","1783","8888","8880",國泰-敦南,3,5,2,-1,0.55
"20221014","1783","9255","9200",凱基-和平,6,2,4,1,1.09
"20221014","1783","0035003900320069","5920",元富-中港,0,2,2,-1,0.55
"20221017","1783","0039003800320042","9800",元大-博愛,31,0,31,1,9.23
"20221017","1783","8843","8840",玉山-高雄,0,37,37,-1,11.01
"20221017","1783","0039004100390072","9A00",永豐金-北高雄,18,0,18,1,5.36
"20221017","1783","9268","9200",凱基-台北,29,59,30,-1,8.93
"20221017","1783","1480","1480",美商高盛,19,5,14,1,4.17
"20221017","1783","8560","8560",新光,3,21,18,-1,5.36
"20221017","1783","9215","9200",凱基-高美館,11,0,11,1,3.27
"20221017","1783","9319","9300",華南永昌-鶯歌,0,11,11,-1,3.27
"20221017","1783","1520","1520",瑞士信貸,10,0,10,1,2.98
"20221017","1783","0035003900320072","5920",元富-城東,0,10,10,-1,2.98
"20221017","1783","9255","9200",凱基-和平,14,4,10,1,2.98
"20221017","1783","6168","6160",中國信託-嘉義,0,10,10,-1,2.98
"20221017","1783","9655","9600",富邦-板橋,7,0,7,1,2.08
"20221017","1783","0037003700390044","7790",國票-台南,1,11,10,-1,2.98
"20221017","1783","1470","1470",台灣摩根士丹利,5,0,5,1,1.49
"20221017","1783","1440","1440",美林,19,26,7,-1,2.08
"20221017","1783","1032","1030",土銀-台南,5,0,5,1,1.49
"20221017","1783","003500390032006d","5920",元富-成功,0,7,7,-1,2.08
"20221017","1783","1230","1230",彰銀,5,0,5,1,1.49
"20221017","1783","0039004100390044","9A00",永豐金-忠孝,0,6,6,-1,1.79
"20221017","1783","6163","6160",中國信託-永康,5,0,5,1,1.49
"20221017","1783","9813","9800",元大-八德,0,5,5,-1,1.49
"20221017","1783","0037003700390065","7790",國票-南科,5,0,5,1,1.49
"20221017","1783","1650","1650",新加坡商瑞銀,6,9,3,-1,0.89
"20221017","1783","003900360035004b","9600",富邦-台中,5,0,5,1,1.49
"20221017","1783","5261","5260",美好-蘆洲,0,3,3,-1,0.89
"20221017","1783","9278","9200",凱基-永康,4,0,4,1,1.19
"20221017","1783","0039003800310042","9800",元大-竹北,0,3,3,-1,0.89
"20221018","1783","9255","9200",凱基-和平,20,0,20,1,12.27
"20221018","1783","9268","9200",凱基-台北,7,39,32,-1,19.63
"20221018","1783","0039003200310047","9200",凱基-五股,15,0,15,1,9.20
"20221018","1783","9215","9200",凱基-高美館,0,11,11,-1,6.75
"20221018","1783","8560","8560",新光,10,0,10,1,6.13
"20221018","1783","8440","8440",摩根大通,10,16,6,-1,3.68
"20221018","1783","003500390032006f","5920",元富-新興,8,0,8,1,4.91
"20221018","1783","1440","1440",美林,1,5,4,-1,2.45
"20221018","1783","1650","1650",新加坡商瑞銀,9,2,7,1,4.29
"20221018","1783","9319","9300",華南永昌-鶯歌,0,3,3,-1,1.84
"20221018","1783","9200","9200",凱基,4,0,4,1,2.45
"20221018","1783","1480","1480",美商高盛,5,7,2,-1,1.23
"20221018","1783","0037003700390072","7790",國票-桃園,3,0,3,1,1.84
"20221018","1783","0035003900320041","5920",元富-緯城,0,2,2,-1,1.23
"20221018","1783","0039003800310065","9800",元大-佳里,3,0,3,1,1.84
"20221018","1783","0039003600320050","9600",富邦-頭份,0,2,2,-1,1.23
"20221018","1783","9800","9800",元大證券,3,0,3,1,1.84
"20221018","1783","9869","9800",元大-新盛,0,2,2,-1,1.23
"20221018","1783","003500390032005a","5920",元富-安南,2,0,2,1,1.23
"20221018","1783","003900380039004c","9800",元大-成功,0,2,2,-1,1.23
"20221018","1783","6465","6460",大昌-桃園,2,0,2,1,1.23
"20221018","1783","0035003900320061","5920",元富-松德,0,1,1,-1,0.61
"20221018","1783","0038003800340048","8840",玉山-新竹,2,0,2,1,1.23
"20221018","1783","1470","1470",台灣摩根士丹利,1,2,1,-1,0.61
"20221018","1783","9278","9200",凱基-永康,2,0,2,1,1.23
"20221018","1783","1590","1590",花旗環球,0,1,1,-1,0.61
"20221018","1783","9377","9300",華南永昌-虎尾,2,0,2,1,1.23
"20221018","1783","5262","5260",美好-楊梅,0,1,1,-1,0.61
"20221019","1783","9255","9200",凱基-和平,21,0,21,1,12.50
"20221019","1783","7032","7030",致和-佳里,0,10,10,-1,5.95
"20221019","1783","9268","9200",凱基-台北,18,5,13,1,7.74
"20221019","1783","1650","1650",新加坡商瑞銀,3,10,7,-1,4.17
"20221019","1783","8440","8440",摩根大通,17,9,8,1,4.76
"20221019","1783","1440","1440",美林,5,12,7,-1,4.17
"20221019","1783","9209","9200",凱基-岡山,8,0,8,1,4.76
"20221019","1783","0037003700390045","7790",國票-南崁,0,6,6,-1,3.57
"20221019","1783","9812","9800",元大-台中,4,0,4,1,2.38
"20221019","1783","003800380038004b","8880",國泰-板橋,0,5,5,-1,2.98
"20221019","1783","0035003900320069","5920",元富-中港,3,0,3,1,1.79
"20221019","1783","6163","6160",中國信託-永康,0,5,5,-1,2.98
"20221019","1783","6465","6460",大昌-桃園,3,0,3,1,1.79
"20221019","1783","9215","9200",凱基-高美館,0,5,5,-1,2.98
"20221019","1783","9324","9300",華南永昌-岡山,3,0,3,1,1.79
"20221019","1783","1470","1470",台灣摩根士丹利,0,4,4,-1,2.38
"20221019","1783","9616","9600",富邦-岡山,3,0,3,1,1.79
"20221019","1783","1119","1110",台灣企銀-岡山,0,3,3,-1,1.79
"20221019","1783","9800","9800",元大證券,3,0,3,1,1.79
"20221019","1783","0039003600310053","9600",富邦-景美,0,3,3,-1,1.79
"20221019","1783","0039003800310043","9800",元大-路竹,2,0,2,1,1.19
"20221019","1783","003900380039006b","9800",元大-古亭,0,3,3,-1,1.79
"20221019","1783","003900410039004e","9A00",永豐金-桃盛,2,0,2,1,1.19
"20221019","1783","2180","2180",亞東,3,5,2,-1,1.19
"20221019","1783","0035003800350042","5850",統一-永和,1,0,1,1,0.60
"20221019","1783","1261","1260",宏遠-民生,0,2,2,-1,1.19
"20221019","1783","5855","5850",統一-台南,1,0,1,1,0.60
"20221019","1783","0039003600310048","9600",富邦-新板,0,2,2,-1,1.19
"20221020","1783","9255","9200",凱基-和平,8,0,8,1,5.23
"20221020","1783","1650","1650",新加坡商瑞銀,3,18,15,-1,9.80
"20221020","1783","9800","9800",元大證券,6,0,6,1,3.92
"20221020","1783","9268","9200",凱基-台北,12,25,13,-1,8.50
"20221020","1783","6950","6950",福勝,5,0,5,1,3.27
"20221020","1783","003700370039006a","7790",國票-和平,0,10,10,-1,6.54
"20221020","1783","6160","6160",中國信託,4,0,4,1,2.61
"20221020","1783","0037003700390050","7790",國票-九鼎,0,5,5,-1,3.27
"20221020","1783","8440","8440",摩根大通,5,1,4,1,2.61
"20221020","1783","003800380038004b","8880",國泰-板橋,0,5,5,-1,3.27
"20221020","1783","003900380039004e","9800",元大-內湖,4,0,4,1,2.61
"20221020","1783","0039003800390046","9800",元大-高雄,0,5,5,-1,3.27
"20221020","1783","0035003900320069","5920",元富-中港,3,0,3,1,1.96
"20221020","1783","003500390032006f","5920",元富-新興,1,5,4,-1,2.61
"20221020","1783","6114","6110",台中銀-員林,3,0,3,1,1.96
"20221020","1783","5855","5850",統一-台南,8,11,3,-1,1.96
"20221020","1783","6465","6460",大昌-桃園,3,0,3,1,1.96
"20221020","1783","003600310036004b","6160",中國信託-高雄,0,3,3,-1,1.96
"20221020","1783","9303","9300",華南永昌-高雄,3,0,3,1,1.96
"20221020","1783","9616","9600",富邦-岡山,0,3,3,-1,1.96
"20221020","1783","0039004100390061","9A00",永豐金-苓雅,3,0,3,1,1.96
"20221020","1783","1560","1560",港商野村,2,4,2,-1,1.31
"20221020","1783","8156","8150",台新-三民,2,0,2,1,1.31
"20221020","1783","9854","9800",元大-文心興安,0,2,2,-1,1.31
"20221020","1783","9215","9200",凱基-高美館,3,1,2,1,1.31
"20221020","1783","0039003800390045","9800",元大-草屯,0,2,2,-1,1.31
"20221020","1783","9234","9200",凱基-竹北,2,0,2,1,1.31
"20221020","1783","0038003800340044","8840",玉山-左營,0,1,1,-1,0.65
"20221021","1783","9800","9800",元大證券,15,0,15,1,9.87
"20221021","1783","9268","9200",凱基-台北,4,23,19,-1,12.50
"20221021","1783","6163","6160",中國信託-永康,10,0,10,1,6.58
"20221021","1783","1480","1480",美商高盛,4,22,18,-1,11.84
"20221021","1783","9204","9200",凱基-台中,10,0,10,1,6.58
"20221021","1783","8440","8440",摩根大通,1,17,16,-1,10.53
"20221021","1783","8560","8560",新光,10,1,9,1,5.92
"20221021","1783","9834","9800",元大-中壢,0,10,10,-1,6.58
"20221021","1783","1117","1110",台灣企銀-竹北,8,0,8,1,5.26
"20221021","1783","9655","9600",富邦-板橋,0,8,8,-1,5.26
"20221021","1783","9255","9200",凱基-和平,7,0,7,1,4.61
"20221021","1783","1650","1650",新加坡商瑞銀,3,9,6,-1,3.95
"20221021","1783","003900380039004e","9800",元大-內湖,6,0,6,1,3.95
"20221021","1783","0039003600320047","9600",富邦-斗六,0,6,6,-1,3.95
"20221021","1783","9897","9800",元大-土城,5,0,5,1,3.29
"20221021","1783","003700300030005a","7000",兆豐-高雄,1,6,5,-1,3.29
"20221021","1783","8888","8880",國泰-敦南,4,0,4,1,2.63
"20221021","1783","6460","6460",大昌,0,4,4,-1,2.63
"20221021","1783","2180","2180",亞東,3,0,3,1,1.97
"20221021","1783","1470","1470",台灣摩根士丹利,0,2,2,-1,1.32
"20221021","1783","0038003100350048","8150",台新-屏東,3,0,3,1,1.97
"20221021","1783","8562","8560",新光-高雄,0,2,2,-1,1.32
"20221021","1783","0039004100390044","9A00",永豐金-忠孝,3,0,3,1,1.97
"20221021","1783","0039003600310048","9600",富邦-新板,0,2,2,-1,1.32
"20221021","1783","0035003300380049","5380",第一金-頭份,2,0,2,1,1.32
"20221021","1783","9872","9800",元大-復北,0,2,2,-1,1.32
"20221021","1783","0039003600310053","9600",富邦-景美,2,0,2,1,1.32
"20221021","1783","5382","5380",第一金-台中,0,1,1,-1,0.66
"20221024","1783","9636","9600",富邦-中壢,5,0,5,1,8.62
"20221024","1783","1520","1520",瑞士信貸,0,3,3,-1,5.17
"20221024","1783","1590","1590",花旗環球,4,0,4,1,6.90
"20221024","1783","8843","8840",玉山-高雄,0,3,3,-1,5.17
"20221024","1783","003900380039004e","9800",元大-內湖,4,0,4,1,6.90
"20221024","1783","003900380030004b","9800",元大-竹科,0,3,3,-1,5.17
"20221024","1783","003500320036004b","5260",美好-富順,5,2,3,1,5.17
"20221024","1783","0039004100390062","9A00",永豐金-虎尾,0,3,3,-1,5.17
"20221024","1783","1440","1440",美林,3,0,3,1,5.17
"20221024","1783","1480","1480",美商高盛,0,2,2,-1,3.45
"20221024","1783","9800","9800",元大證券,4,1,3,1,5.17
"20221024","1783","1650","1650",新加坡商瑞銀,1,3,2,-1,3.45
"20221024","1783","003500380035004a","5850",統一-三重,2,0,2,1,3.45
"20221024","1783","0035003900320069","5920",元富-中港,0,2,2,-1,3.45
"20221024","1783","9854","9800",元大-文心興安,2,0,2,1,3.45
"20221024","1783","6380","6380",光和,0,2,2,-1,3.45
"20221024","1783","0031003100310042","1110",台灣企銀-建成,1,0,1,1,1.72
"20221024","1783","0039003200300056","9200",凱基-新店,0,2,2,-1,3.45
"20221024","1783","1020","1020",合庫證券,1,0,1,1,1.72
"20221024","1783","9834","9800",元大-中壢,0,2,2,-1,3.45
"20221024","1783","2180","2180",亞東,5,4,1,1,1.72
"20221024","1783","9623","9600",富邦-台北,0,1,1,-1,1.72
"20221024","1783","5262","5260",美好-楊梅,1,0,1,1,1.72
"20221024","1783","0035003800350042","5850",統一-永和,0,1,1,-1,1.72
"20221024","1783","5852","5850",統一-敦南,1,0,1,1,1.72
"20221024","1783","003500390032006f","5920",元富-新興,0,1,1,-1,1.72
"20221024","1783","0035003900320053","5920",元富-基隆,1,0,1,1,1.72
"20221024","1783","003700300030006b","7000",兆豐-員林,0,1,1,-1,1.72
"20221025","1783","0039003800310058","9800",元大-新生,20,5,15,1,11.54
"20221025","1783","1470","1470",台灣摩根士丹利,0,16,16,-1,12.31
"20221025","1783","9800","9800",元大證券,10,0,10,1,7.69
"20221025","1783","1480","1480",美商高盛,0,15,15,-1,11.54
"20221025","1783","003900380039004e","9800",元大-內湖,8,0,8,1,6.15
"20221025","1783","003900360031004d","9600",富邦-木柵,0,10,10,-1,7.69
"20221025","1783","9278","9200",凱基-永康,6,0,6,1,4.62
"20221025","1783","1560","1560",港商野村,0,5,5,-1,3.85
"20221025","1783","5852","5850",統一-敦南,5,0,5,1,3.85
"20221025","1783","1520","1520",瑞士信貸,0,5,5,-1,3.85
"20221025","1783","003500390032006d","5920",元富-成功,5,0,5,1,3.85
"20221025","1783","003900310038004b","9100",群益金鼎-東湖,0,5,5,-1,3.85
"20221025","1783","9215","9200",凱基-高美館,5,0,5,1,3.85
"20221025","1783","1042","1040",臺銀-臺南,0,3,3,-1,2.31
"20221025","1783","0039003800320042","9800",元大-博愛,5,0,5,1,3.85
"20221025","1783","1440","1440",美林,1,3,2,-1,1.54
"20221025","1783","0039004100390037","9A00",永豐金-新竹,5,0,5,1,3.85
"20221025","1783","0031003200360048","1260",宏遠-中和,0,2,2,-1,1.54
"20221025","1783","0039003800310056","9800",元大-民雄,3,0,3,1,2.31
"20221025","1783","0039003200300041","9200",凱基-板橋,0,2,2,-1,1.54
"20221025","1783","003900380039004c","9800",元大-成功,3,0,3,1,2.31
"20221025","1783","1020","1020",合庫證券,0,1,1,-1,0.77
"20221025","1783","9636","9600",富邦-中壢,2,0,2,1,1.54
"20221025","1783","003500320036004b","5260",美好-富順,0,1,1,-1,0.77
"20221025","1783","1117","1110",台灣企銀-竹北,2,0,2,1,1.54
"20221025","1783","8459","8450",康和-嘉義,0,1,1,-1,0.77
"20221025","1783","0039003200300056","9200",凱基-新店,2,0,2,1,1.54
"20221025","1783","9101","9100",群益金鼎-敦南,0,1,1,-1,0.77
"20221026","1783","9800","9800",元大證券,42,2,40,1,6.14
"20221026","1783","9100","9100",群益金鼎,1,82,81,-1,12.44
"20221026","1783","8560","8560",新光,41,4,37,1,5.68
"20221026","1783","9833","9800",元大-敦化,3,30,27,-1,4.15
"20221026","1783","9692","9600",富邦-嘉義,36,0,36,1,5.53
"20221026","1783","1480","1480",美商高盛,3,28,25,-1,3.84
"20221026","1783","0035003300380043","5380",第一金-光復,21,3,18,1,2.76
"20221026","1783","9319","9300",華南永昌-鶯歌,0,23,23,-1,3.53
"20221026","1783","0039003600350055","9600",富邦-彰化,12,1,11,1,1.69
"20221026","1783","8440","8440",摩根大通,21,40,19,-1,2.92
"20221026","1783","5384","5380",第一金-台南,10,0,10,1,1.54
"20221026","1783","0035003900320072","5920",元富-城東,5,23,18,-1,2.76
"20221026","1783","6162","6160",中國信託-忠孝,10,0,10,1,1.54
"20221026","1783","1440","1440",美林,2,14,12,-1,1.84
"20221026","1783","0037003000300048","7000",兆豐-東門,16,6,10,1,1.54
"20221026","1783","5856","5850",統一-台中,1,12,11,-1,1.69
"20221026","1783","9255","9200",凱基-和平,10,1,9,1,1.38
"20221026","1783","9137","9100",群益金鼎-士林,0,10,10,-1,1.54
"20221026","1783","6163","6160",中國信託-永康,8,0,8,1,1.23
"20221026","1783","8888","8880",國泰-敦南,1,7,6,-1,0.92
"20221026","1783","1560","1560",港商野村,6,0,6,1,0.92
"20221026","1783","2180","2180",亞東,0,5,5,-1,0.77
"20221026","1783","5921","5920",元富-高雄,6,0,6,1,0.92
"20221026","1783","5920","5920",元富,0,5,5,-1,0.77
"20221026","1783","0039003800310043","9800",元大-路竹,6,0,6,1,0.92
"20221026","1783","0035003900320069","5920",元富-中港,0,5,5,-1,0.77
"20221026","1783","0037003700390065","7790",國票-南科,5,0,5,1,0.77
"20221026","1783","9897","9800",元大-土城,0,5,5,-1,0.77
"20221027","1783","1440","1440",美林,38,4,34,1,7.51
"20221027","1783","9100","9100",群益金鼎,0,38,38,-1,8.39
"20221027","1783","1650","1650",新加坡商瑞銀,25,0,25,1,5.52
"20221027","1783","9200","9200",凱基,0,32,32,-1,7.06
"20221027","1783","9268","9200",凱基-台北,56,35,21,1,4.64
"20221027","1783","8380","8380",安泰,0,15,15,-1,3.31
"20221027","1783","9867","9800",元大-北成功,20,0,20,1,4.42
"20221027","1783","5855","5850",統一-台南,0,11,11,-1,2.43
"20221027","1783","9829","9800",元大-永康,11,0,11,1,2.43
"20221027","1783","6162","6160",中國信託-忠孝,0,10,10,-1,2.21
"20221027","1783","0035003300380044","5380",第一金-忠孝,10,0,10,1,2.21
"20221027","1783","9319","9300",華南永昌-鶯歌,0,9,9,-1,1.99
"20221027","1783","0039003800390047","9800",元大-大同,10,0,10,1,2.21
"20221027","1783","9692","9600",富邦-嘉義,0,6,6,-1,1.32
"20221027","1783","2180","2180",亞東,8,1,7,1,1.55
"20221027","1783","5266","5260",美好-中壢,0,5,5,-1,1.10
"20221027","1783","8847","8840",玉山-台南,7,0,7,1,1.55
"20221027","1783","9209","9200",凱基-岡山,0,5,5,-1,1.10
"20221027","1783","0035003900320075","5920",元富-世貿,6,0,6,1,1.32
"20221027","1783","9255","9200",凱基-和平,0,5,5,-1,1.10
"20221027","1783","8882","8880",國泰-台中,6,0,6,1,1.32
"20221027","1783","9899","9800",元大-淡水,0,4,4,-1,0.88
"20221027","1783","1590","1590",花旗環球,5,0,5,1,1.10
"20221027","1783","0031003200360069","1260",宏遠-光隆,0,3,3,-1,0.66
"20221027","1783","5389","5380",第一金-中山,5,0,5,1,1.10
"20221027","1783","1116","1110",台灣企銀-屏東,0,3,3,-1,0.66
"20221027","1783","0038003100350041","8150",台新-高雄,5,0,5,1,1.10
"20221027","1783","0035003900320072","5920",元富-城東,5,8,3,-1,0.66
"20221028","1783","6380","6380",光和,25,0,25,1,8.33
"20221028","1783","0037003000300053","7000",兆豐-大同,0,20,20,-1,6.67
"20221028","1783","0037003000300049","7000",兆豐-北高雄,18,0,18,1,6.00
"20221028","1783","1440","1440",美林,10,23,13,-1,4.33
"20221028","1783","0039003800390059","9800",元大-基隆,11,0,11,1,3.67
"20221028","1783","1480","1480",美商高盛,4,15,11,-1,3.67
"20221028","1783","9800","9800",元大證券,10,0,10,1,3.33
"20221028","1783","0037003000300048","7000",兆豐-東門,0,10,10,-1,3.33
"20221028","1783","0038003800380041","8880",國泰-館前,10,0,10,1,3.33
"20221028","1783","9319","9300",華南永昌-鶯歌,0,10,10,-1,3.33
"20221028","1783","9829","9800",元大-永康,9,0,9,1,3.00
"20221028","1783","0039003800390047","9800",元大-大同,0,10,10,-1,3.33
"20221028","1783","5389","5380",第一金-中山,8,1,7,1,2.33
"20221028","1783","2180","2180",亞東,1,8,7,-1,2.33
"20221028","1783","9268","9200",凱基-台北,15,8,7,1,2.33
"20221028","1783","8847","8840",玉山-台南,0,7,7,-1,2.33
"20221028","1783","0035003300380043","5380",第一金-光復,6,0,6,1,2.00
"20221028","1783","1650","1650",新加坡商瑞銀,4,10,6,-1,2.00
"20221028","1783","1116","1110",台灣企銀-屏東,5,0,5,1,1.67
"20221028","1783","1470","1470",台灣摩根士丹利,0,6,6,-1,2.00
"20221028","1783","6912","6910",德信-中正,5,0,5,1,1.67
"20221028","1783","5921","5920",元富-高雄,0,6,6,-1,2.00
"20221028","1783","0039003100380063","9100",群益金鼎-鳳山,5,0,5,1,1.67
"20221028","1783","8157","8150",台新-左楠,0,6,6,-1,2.00
"20221028","1783","9303","9300",華南永昌-高雄,5,0,5,1,1.67
"20221028","1783","8440","8440",摩根大通,4,10,6,-1,2.00
"20221028","1783","0035003900320069","5920",元富-中港,4,0,4,1,1.33
"20221028","1783","9208","9200",凱基-桃園,0,4,4,-1,1.33
"20221031","1783","1470","1470",台灣摩根士丹利,15,0,15,1,11.28
"20221031","1783","003500390032006f","5920",元富-新興,0,7,7,-1,5.26
"20221031","1783","0035003800350049","5850",統一-員林,10,0,10,1,7.52
"20221031","1783","5389","5380",第一金-中山,0,6,6,-1,4.51
"20221031","1783","0037003000300061","7000",兆豐-忠孝,10,0,10,1,7.52
"20221031","1783","8560","8560",新光,0,6,6,-1,4.51
"20221031","1783","1440","1440",美林,13,7,6,1,4.51
"20221031","1783","0035003900320075","5920",元富-世貿,0,5,5,-1,3.76
"20221031","1783","1480","1480",美商高盛,6,1,5,1,3.76
"20221031","1783","0037003700390065","7790",國票-南科,0,5,5,-1,3.76
"20221031","1783","0037003700390045","7790",國票-南崁,5,0,5,1,3.76
"20221031","1783","003900360035004b","9600",富邦-台中,0,5,5,-1,3.76
"20221031","1783","9697","9600",富邦-虎尾,4,0,4,1,3.01
"20221031","1783","003900380039004c","9800",元大-成功,0,5,5,-1,3.76
"20221031","1783","0039003600310043","9600",富邦-南京,3,0,3,1,2.26
"20221031","1783","1560","1560",港商野村,0,4,4,-1,3.01
"20221031","1783","8440","8440",摩根大通,8,6,2,1,1.50
"20221031","1783","0035003900320069","5920",元富-中港,0,4,4,-1,3.01
"20221031","1783","0039003600320050","9600",富邦-頭份,2,0,2,1,1.50
"20221031","1783","9215","9200",凱基-高美館,0,4,4,-1,3.01
"20221031","1783","003900380030004b","9800",元大-竹科,2,0,2,1,1.50
"20221031","1783","9255","9200",凱基-和平,0,4,4,-1,3.01
"20221031","1783","0039004100390038","9A00",永豐金-大園,2,0,2,1,1.50
"20221031","1783","1034","1030",土銀-嘉義,0,3,3,-1,2.26
"20221031","1783","0031003200360048","1260",宏遠-中和,1,0,1,1,0.75
"20221031","1783","0039003800310043","9800",元大-路竹,0,3,3,-1,2.26
"20221031","1783","0035003900320077","5920",元富-佳里,1,0,1,1,0.75
"20221031","1783","0039003600320046","9600",富邦-北桃園,0,2,2,-1,1.50
"20220901","1783","8888","8880",國泰-敦南,102,58,44,1,1.59
"20220901","1783","9672","9600",富邦-員林,2,138,136,-1,4.93
"20220901","1783","9208","9200",凱基-桃園,57,14,43,1,1.56
"20220901","1783","9268","9200",凱基-台北,139,254,115,-1,4.17
"20220901","1783","9655","9600",富邦-板橋,41,1,40,1,1.45
"20220901","1783","5850","5850",統一,2,102,100,-1,3.62
"20220901","1783","7005","7000",兆豐-台中港,31,0,31,1,1.12
"20220901","1783","1650","1650",新加坡商瑞銀,105,178,73,-1,2.64
"20220901","1783","9189","9100",群益金鼎-桃園,49,19,30,1,1.09
"20220901","1783","1470","1470",台灣摩根士丹利,8,53,45,-1,1.63
"20220901","1783","1480","1480",美商高盛,64,36,28,1,1.01
"20220901","1783","9205","9200",凱基-三重,0,32,32,-1,1.16
"20220901","1783","8884","8880",國泰-台南,29,3,26,1,0.94
"20220901","1783","6161","6160",中國信託-三重,17,48,31,-1,1.12
"20220901","1783","003900360031004d","9600",富邦-木柵,26,0,26,1,0.94
"20220901","1783","0037003000300048","7000",兆豐-東門,0,30,30,-1,1.09
"20220901","1783","0039003100330049","9100",群益金鼎-萬華,22,0,22,1,0.80
"20220901","1783","1440","1440",美林,0,28,28,-1,1.01
"20220901","1783","9239","9200",凱基-市政,22,1,21,1,0.76
"20220901","1783","8711","8710",陽信-石牌,0,28,28,-1,1.01
"20220901","1783","003900360035004b","9600",富邦-台中,21,2,19,1,0.69
"20220901","1783","9135","9100",群益金鼎-東大,0,22,22,-1,0.80
"20220901","1783","1040","1040",臺銀,18,0,18,1,0.65
"20220901","1783","9862","9800",元大-南京,0,20,20,-1,0.72
"20220901","1783","9322","9300",華南永昌-公誠,21,3,18,1,0.65
"20220901","1783","9659","9600",富邦-高雄,0,18,18,-1,0.65
"20220901","1783","5856","5850",統一-台中,17,0,17,1,0.62
"20220901","1783","9814","9800",元大-大益,3,20,17,-1,0.62
"20220902","1783","9600","9600",富邦證券,1284,1070,214,1,2.66
"20220902","1783","5854","5850",統一-城中,5,138,133,-1,1.65
"20220902","1783","9268","9200",凱基-台北,527,326,201,1,2.50
"20220902","1783","9238","9200",凱基-士林,0,90,90,-1,1.12
"20220902","1783","9100","9100",群益金鼎,210,11,199,1,2.47
"20220902","1783","5856","5850",統一-台中,1,77,76,-1,0.94
"20220902","1783","0037003000300053","7000",兆豐-大同,225,30,195,1,2.42
"20220902","1783","9239","9200",凱基-市政,29,91,62,-1,0.77
"20220902","1783","8882","8880",國泰-台中,59,5,54,1,0.67
"20220902","1783","0035003800350055","5850",統一-南京,3,60,57,-1,0.71
"20220902","1783","0039004100390044","9A00",永豐金-忠孝,59,6,53,1,0.66
"20220902","1783","1480","1480",美商高盛,37,93,56,-1,0.70
"20220902","1783","0039004100390064","9A00",永豐金-古亭,47,3,44,1,0.55
"20220902","1783","9655","9600",富邦-板橋,34,90,56,-1,0.70
"20220902","1783","1041","1040",臺銀-鳳山,41,0,41,1,0.51
"20220902","1783","8580","8580",聯邦商銀,3,51,48,-1,0.60
"20220902","1783","003900380039006a","9800",元大-樹林,53,13,40,1,0.50
"20220902","1783","0038003100350053","8150",台新-中壢,3,48,45,-1,0.56
"20220902","1783","2181","2180",亞東-板橋,35,1,34,1,0.42
"20220902","1783","0035003900320065","5920",元富-古亭,8,43,35,-1,0.44
"20220902","1783","8880","8880",國泰證券,33,0,33,1,0.41
"20220902","1783","7005","7000",兆豐-台中港,2,32,30,-1,0.37
"20220902","1783","9692","9600",富邦-嘉義,94,62,32,1,0.40
"20220902","1783","8158","8150",台新-松江,1,31,30,-1,0.37
"20220902","1783","9816","9800",元大-新竹,157,127,30,1,0.37
"20220902","1783","8440","8440",摩根大通,211,240,29,-1,0.36
"20220902","1783","0035003300380057","5380",第一金-華江,34,6,28,1,0.35
"20220902","1783","9303","9300",華南永昌-高雄,20,46,26,-1,0.32
"20220905","1783","0035003900320042","5920",元富-永和,72,3,69,1,1.14
"20220905","1783","9268","9200",凱基-台北,329,565,236,-1,3.91
"20220905","1783","8150","8150",台新證券,129,61,68,1,1.13
"20220905","1783","9600","9600",富邦證券,0,214,214,-1,3.55
"20220905","1783","0037003000300056","7000",兆豐-新竹,64,7,57,1,0.94
"20220905","1783","5603","5600",永興-台中,2,204,202,-1,3.35
"20220905","1783","8880","8880",國泰證券,56,0,56,1,0.93
"20220905","1783","1480","1480",美商高盛,0,89,89,-1,1.47
"20220905","1783","0037003000300053","7000",兆豐-大同,50,0,50,1,0.83
"20220905","1783","8440","8440",摩根大通,145,229,84,-1,1.39
"20220905","1783","9100","9100",群益金鼎,56,6,50,1,0.83
"20220905","1783","0031003000320046","1020",合庫-西台中,2,62,60,-1,0.99
"20220905","1783","9254","9200",凱基-科園,44,4,40,1,0.66
"20220905","1783","9658","9600",富邦-建國,53,95,42,-1,0.70
"20220905","1783","003500320036004b","5260",美好-富順,39,3,36,1,0.60
"20220905","1783","1041","1040",臺銀-鳳山,2,42,40,-1,0.66
"20220905","1783","1260","1260",宏遠證券,35,0,35,1,0.58
"20220905","1783","1650","1650",新加坡商瑞銀,66,104,38,-1,0.63
"20220905","1783","0039003800390045","9800",元大-草屯,33,1,32,1,0.53
"20220905","1783","9208","9200",凱基-桃園,8,40,32,-1,0.53
"20220905","1783","2181","2180",亞東-板橋,45,15,30,1,0.50
"20220905","1783","9300","9300",華南永昌,12,44,32,-1,0.53
"20220905","1783","003900380033006a","9800",元大-仁愛,26,0,26,1,0.43
"20220905","1783","003900380039006a","9800",元大-樹林,12,42,30,-1,0.50
"20220905","1783","8563","8560",新光-新竹,31,6,25,1,0.41
"20220905","1783","003800340035004a","8450",康和-高雄,1,29,28,-1,0.46
"20220905","1783","9278","9200",凱基-永康,25,0,25,1,0.41
"20220905","1783","9816","9800",元大-新竹,140,165,25,-1,0.41
"20220906","1783","9268","9200",凱基-台北,278,211,67,1,2.79
"20220906","1783","8150","8150",台新證券,3,92,89,-1,3.71
"20220906","1783","9655","9600",富邦-板橋,54,1,53,1,2.21
"20220906","1783","5850","5850",統一,8,84,76,-1,3.17
"20220906","1783","9206","9200",凱基-高雄,48,0,48,1,2.00
"20220906","1783","2181","2180",亞東-板橋,31,95,64,-1,2.67
"20220906","1783","9856","9800",元大-花蓮,38,3,35,1,1.46
"20220906","1783","8882","8880",國泰-台中,4,55,51,-1,2.13
"20220906","1783","0037003000300056","7000",兆豐-新竹,30,0,30,1,1.25
"20220906","1783","0039004100390044","9A00",永豐金-忠孝,0,50,50,-1,2.09
"20220906","1783","7750","7750",北城證券,26,0,26,1,1.08
"20220906","1783","9254","9200",凱基-科園,1,40,39,-1,1.63
"20220906","1783","9322","9300",華南永昌-公誠,27,1,26,1,1.08
"20220906","1783","0039003600310057","9600",富邦-東花蓮,0,29,29,-1,1.21
"20220906","1783","1034","1030",土銀-嘉義,22,0,22,1,0.92
"20220906","1783","0037003000300070","7000",兆豐-復興,0,28,28,-1,1.17
"20220906","1783","1650","1650",新加坡商瑞銀,94,72,22,1,0.92
"20220906","1783","0035003300380057","5380",第一金-華江,0,25,25,-1,1.04
"20220906","1783","8440","8440",摩根大通,84,63,21,1,0.88
"20220906","1783","9189","9100",群益金鼎-桃園,5,28,23,-1,0.96
"20220906","1783","1030","1030",土銀,20,0,20,1,0.83
"20220906","1783","003900360032004c","9600",富邦-雙和,7,29,22,-1,0.92
"20220906","1783","9278","9200",凱基-永康,19,0,19,1,0.79
"20220906","1783","8888","8880",國泰-敦南,38,59,21,-1,0.88
"20220906","1783","9303","9300",華南永昌-高雄,19,0,19,1,0.79
"20220906","1783","9187","9100",群益金鼎-彰化,0,21,21,-1,0.88
"20220906","1783","0037003000300063","7000",兆豐-民生,18,0,18,1,0.75
"20220906","1783","6451","6450",永全-南崁,0,20,20,-1,0.83
"20220907","1783","9366","9300",華南永昌-豐原,30,0,30,1,1.85
"20220907","1783","8880","8880",國泰證券,30,74,44,-1,2.72
"20220907","1783","9233","9200",凱基-長庚,21,0,21,1,1.30
"20220907","1783","0031003000320046","1020",合庫-西台中,0,25,25,-1,1.55
"20220907","1783","1028","1020",合庫-彰化,19,0,19,1,1.17
"20220907","1783","8440","8440",摩根大通,50,75,25,-1,1.55
"20220907","1783","9331","9300",華南永昌-鳳山,18,0,18,1,1.11
"20220907","1783","1470","1470",台灣摩根士丹利,0,23,23,-1,1.42
"20220907","1783","0039003600310050","9600",富邦-和美,15,0,15,1,0.93
"20220907","1783","1650","1650",新加坡商瑞銀,14,37,23,-1,1.42
"20220907","1783","1440","1440",美林,36,22,14,1,0.87
"20220907","1783","9856","9800",元大-花蓮,9,32,23,-1,1.42
"20220907","1783","0039003600320050","9600",富邦-頭份,15,1,14,1,0.87
"20220907","1783","9658","9600",富邦-建國,2,23,21,-1,1.30
"20220907","1783","5856","5850",統一-台中,13,0,13,1,0.80
"20220907","1783","9623","9600",富邦-台北,1,18,17,-1,1.05
"20220907","1783","003900380039004a","9800",元大-彰化民生,14,1,13,1,0.80
"20220907","1783","9800","9800",元大證券,5,20,15,-1,0.93
"20220907","1783","6114","6110",台中銀-員林,11,0,11,1,0.68
"20220907","1783","9327","9300",華南永昌-斗六,1,15,14,-1,0.87
"20220907","1783","0037003000300049","7000",兆豐-北高雄,13,2,11,1,0.68
"20220907","1783","0035003800350044","5850",統一-新台中,0,13,13,-1,0.80
"20220907","1783","9813","9800",元大-八德,11,0,11,1,0.68
"20220907","1783","1040","1040",臺銀,0,10,10,-1,0.62
"20220907","1783","0035003300380042","5380",第一金-新竹,10,0,10,1,0.62
"20220907","1783","1030","1030",土銀,0,10,10,-1,0.62
"20220907","1783","0035003800350059","5850",統一-土城,10,0,10,1,0.62
"20220907","1783","9853","9800",元大-南屯,1,11,10,-1,0.62
"20220908","1783","9268","9200",凱基-台北,163,113,50,1,4.53
"20220908","1783","9856","9800",元大-花蓮,0,23,23,-1,2.08
"20220908","1783","9200","9200",凱基,43,0,43,1,3.89
"20220908","1783","1028","1020",合庫-彰化,0,19,19,-1,1.72
"20220908","1783","9100","9100",群益金鼎,39,0,39,1,3.53
"20220908","1783","0038003400350046","8450",康和-仁愛,1,20,19,-1,1.72
"20220908","1783","8440","8440",摩根大通,59,28,31,1,2.81
"20220908","1783","0039004100390067","9A00",永豐金-內湖,7,25,18,-1,1.63
"20220908","1783","0035003900320042","5920",元富-永和,21,1,20,1,1.81
"20220908","1783","9339","9300",華南永昌-竹北,0,16,16,-1,1.45
"20220908","1783","1650","1650",新加坡商瑞銀,16,1,15,1,1.36
"20220908","1783","1024","1020",合庫-嘉義,0,13,13,-1,1.18
"20220908","1783","8158","8150",台新-松江,15,0,15,1,1.36
"20220908","1783","0037003000300049","7000",兆豐-北高雄,0,11,11,-1,1.00
"20220908","1783","6380","6380",光和,15,1,14,1,1.27
"20220908","1783","0039003600310050","9600",富邦-和美,0,10,10,-1,0.91
"20220908","1783","003800380038004b","8880",國泰-板橋,12,0,12,1,1.09
"20220908","1783","0039003600310057","9600",富邦-東花蓮,2,12,10,-1,0.91
"20220908","1783","0039003100330059","9100",群益金鼎-館前,11,0,11,1,1.00
"20220908","1783","0039003600320044","9600",富邦-新莊,0,10,10,-1,0.91
"20220908","1783","8843","8840",玉山-高雄,10,0,10,1,0.91
"20220908","1783","0039003200320048","9200",凱基-復興,0,9,9,-1,0.82
"20220908","1783","0039003800390047","9800",元大-大同,10,0,10,1,0.91
"20220908","1783","9300","9300",華南永昌,1,10,9,-1,0.82
"20220908","1783","1440","1440",美林,15,8,7,1,0.63
"20220908","1783","9302","9300",華南永昌-台中,1,10,9,-1,0.82
"20220908","1783","9208","9200",凱基-桃園,20,14,6,1,0.54
"20220908","1783","9327","9300",華南永昌-斗六,0,9,9,-1,0.82
"20220912","1783","1650","1650",新加坡商瑞銀,91,8,83,1,6.09
"20220912","1783","9278","9200",凱基-永康,3,30,27,-1,1.98
"20220912","1783","8440","8440",摩根大通,93,25,68,1,4.99
"20220912","1783","9655","9600",富邦-板橋,2,23,21,-1,1.54
"20220912","1783","1440","1440",美林,35,10,25,1,1.83
"20220912","1783","8158","8150",台新-松江,14,34,20,-1,1.47
"20220912","1783","003900360032004b","9600",富邦-中和,25,0,25,1,1.83
"20220912","1783","9319","9300",華南永昌-鶯歌,0,20,20,-1,1.47
"20220912","1783","9268","9200",凱基-台北,147,124,23,1,1.69
"20220912","1783","0039003100330059","9100",群益金鼎-館前,23,41,18,-1,1.32
"20220912","1783","9100","9100",群益金鼎,22,1,21,1,1.54
"20220912","1783","9817","9800",元大-東泰,0,18,18,-1,1.32
"20220912","1783","1560","1560",港商野村,29,12,17,1,1.25
"20220912","1783","0039004100390057","9A00",永豐金-市政,1,19,18,-1,1.32
"20220912","1783","0039004100390067","9A00",永豐金-內湖,16,0,16,1,1.17
"20220912","1783","9189","9100",群益金鼎-桃園,0,15,15,-1,1.10
"20220912","1783","8152","8150",台新-新莊,15,0,15,1,1.10
"20220912","1783","0037003000300063","7000",兆豐-民生,0,15,15,-1,1.10
"20220912","1783","0038003400350053","8450",康和-南崁,14,0,14,1,1.03
"20220912","1783","0039003600310050","9600",富邦-和美,0,15,15,-1,1.10
"20220912","1783","003500380035004a","5850",統一-三重,16,3,13,1,0.95
"20220912","1783","9333","9300",華南永昌-長虹,1,15,14,-1,1.03
"20220912","1783","1520","1520",瑞士信貸,12,0,12,1,0.88
"20220912","1783","003900410039004c","9A00",永豐金-台中,1,15,14,-1,1.03
"20220912","1783","0035003300380050","5380",第一金-路竹,10,0,10,1,0.73
"20220912","1783","9862","9800",元大-南京,1,14,13,-1,0.95
"20220912","1783","5859","5850",統一-屏東,10,0,10,1,0.73
"20220912","1783","0036003000310064","6010",(牛牛牛)亞-鑫豐,0,10,10,-1,0.73
"20220913","1783","9268","9200",凱基-台北,142,73,69,1,5.75
"20220913","1783","9366","9300",華南永昌-豐原,0,30,30,-1,2.50
"20220913","1783","1480","1480",美商高盛,57,0,57,1,4.75
"20220913","1783","8888","8880",國泰-敦南,2,30,28,-1,2.33
"20220913","1783","0039004100300030","9A00",永豐金證券,54,2,52,1,4.33
"20220913","1783","9658","9600",富邦-建國,0,21,21,-1,1.75
"20220913","1783","1520","1520",瑞士信貸,40,2,38,1,3.17
"20220913","1783","9319","9300",華南永昌-鶯歌,4,23,19,-1,1.58
"20220913","1783","003900360032004b","9600",富邦-中和,25,1,24,1,2.00
"20220913","1783","0035003900320072","5920",元富-城東,1,19,18,-1,1.50
"20220913","1783","1560","1560",港商野村,37,14,23,1,1.92
"20220913","1783","8152","8150",台新-新莊,0,15,15,-1,1.25
"20220913","1783","003500380035004a","5850",統一-三重,22,4,18,1,1.50
"20220913","1783","003900380039006a","9800",元大-樹林,1,15,14,-1,1.17
"20220913","1783","9834","9800",元大-中壢,23,7,16,1,1.33
"20220913","1783","6160","6160",中國信託,3,17,14,-1,1.17
"20220913","1783","003900360031004a","9600",富邦-興業,15,0,15,1,1.25
"20220913","1783","0039003600310058","9600",富邦-大墩,1,14,13,-1,1.08
"20220913","1783","0037003000300070","7000",兆豐-復興,13,0,13,1,1.08
"20220913","1783","0035003300380045","5380",第一金-自由,1,11,10,-1,0.83
"20220913","1783","6451","6450",永全-南崁,10,0,10,1,0.83
"20220913","1783","5856","5850",統一-台中,1,11,10,-1,0.83
"20220913","1783","9206","9200",凱基-高雄,10,0,10,1,0.83
"20220913","1783","0035003800350059","5850",統一-土城,0,10,10,-1,0.83
"20220913","1783","0039003800300064","9800",元大-沙鹿,13,3,10,1,0.83
"20220913","1783","0037003000300048","7000",兆豐-東門,15,25,10,-1,0.83
"20220913","1783","9835","9800",元大-員林中山,10,0,10,1,0.83
"20220913","1783","8440","8440",摩根大通,38,48,10,-1,0.83
"20220914","1783","8560","8560",新光,77,32,45,1,1.49
"20220914","1783","8440","8440",摩根大通,57,154,97,-1,3.20
"20220914","1783","0038003800380041","8880",國泰-館前,53,10,43,1,1.42
"20220914","1783","9268","9200",凱基-台北,99,189,90,-1,2.97
"20220914","1783","5856","5850",統一-台中,32,8,24,1,0.79
"20220914","1783","1480","1480",美商高盛,8,70,62,-1,2.05
"20220914","1783","0039003200300041","9200",凱基-板橋,66,45,21,1,0.69
"20220914","1783","1560","1560",港商野村,0,40,40,-1,1.32
"20220914","1783","0039003800390045","9800",元大-草屯,28,8,20,1,0.66
"20220914","1783","9131","9100",群益金鼎-民權,0,33,33,-1,1.09
"20220914","1783","0035003800350050","5850",統一-板橋,22,2,20,1,0.66
"20220914","1783","9233","9200",凱基-長庚,24,47,23,-1,0.76
"20220914","1783","9208","9200",凱基-桃園,31,11,20,1,0.66
"20220914","1783","0031003000320046","1020",合庫-西台中,0,20,20,-1,0.66
"20220914","1783","9858","9800",元大-龍潭,23,6,17,1,0.56
"20220914","1783","7792","7790",國票-北投,4,23,19,-1,0.63
"20220914","1783","8888","8880",國泰-敦南,51,34,17,1,0.56
"20220914","1783","0039003600310043","9600",富邦-南京,9,26,17,-1,0.56
"20220914","1783","003900360031004c","9600",富邦-士林,16,0,16,1,0.53
"20220914","1783","003900380031006a","9800",元大-士林,0,15,15,-1,0.50
"20220914","1783","9105","9100",群益金鼎-高盛,20,5,15,1,0.50
"20220914","1783","0039003600310044","9600",富邦-忠孝,1,13,12,-1,0.40
"20220914","1783","9623","9600",富邦-台北,24,9,15,1,0.50
"20220914","1783","6114","6110",台中銀-員林,4,14,10,-1,0.33
"20220914","1783","003800380038004b","8880",國泰-板橋,36,21,15,1,0.50
"20220914","1783","6451","6450",永全-南崁,0,10,10,-1,0.33
"20220914","1783","9239","9200",凱基-市政,22,9,13,1,0.43
"20220914","1783","7034","7030",致和-金華,0,10,10,-1,0.33
"20220915","1783","0038003800380041","8880",國泰-館前,48,11,37,1,4.66
"20220915","1783","9266","9200",凱基-新豐,0,30,30,-1,3.78
"20220915","1783","9268","9200",凱基-台北,77,46,31,1,3.90
"20220915","1783","0037003000300070","7000",兆豐-復興,0,25,25,-1,3.15
"20220915","1783","8440","8440",摩根大通,33,8,25,1,3.15
"20220915","1783","0039003100380063","9100",群益金鼎-鳳山,1,26,25,-1,3.15
"20220915","1783","1650","1650",新加坡商瑞銀,26,5,21,1,2.64
"20220915","1783","0038003400350053","8450",康和-南崁,0,14,14,-1,1.76
"20220915","1783","0038003100350042","8150",台新-台中,13,0,13,1,1.64
"20220915","1783","0039003800390047","9800",元大-大同,0,12,12,-1,1.51
"20220915","1783","9206","9200",凱基-高雄,11,0,11,1,1.39
"20220915","1783","9208","9200",凱基-桃園,0,12,12,-1,1.51
"20220915","1783","1030","1030",土銀,10,0,10,1,1.26
"20220915","1783","0031003200360058","1260",宏遠-新化,0,11,11,-1,1.39
"20220915","1783","9322","9300",華南永昌-公誠,12,2,10,1,1.26
"20220915","1783","003800380038004b","8880",國泰-板橋,1,11,10,-1,1.26
"20220915","1783","003500380035004a","5850",統一-三重,8,0,8,1,1.01
"20220915","1783","0035003300380042","5380",第一金-新竹,0,10,10,-1,1.26
"20220915","1783","0039003200310053","9200",凱基-幸福,8,0,8,1,1.01
"20220915","1783","9874","9800",元大-雙和,1,11,10,-1,1.26
"20220915","1783","9326","9300",華南永昌-南京,10,2,8,1,1.01
"20220915","1783","9835","9800",元大-員林中山,1,10,9,-1,1.13
"20220915","1783","9692","9600",富邦-嘉義,7,0,7,1,0.88
"20220915","1783","0037003000300056","7000",兆豐-新竹,0,8,8,-1,1.01
"20220915","1783","9636","9600",富邦-中壢,7,0,7,1,0.88
"20220915","1783","0038003800340041","8840",玉山-士林,0,8,8,-1,1.01
"20220915","1783","0039003600310044","9600",富邦-忠孝,6,0,6,1,0.76
"20220915","1783","0039003200300046","9200",凱基-站前,0,8,8,-1,1.01
"20220916","1783","9319","9300",華南永昌-鶯歌,31,0,31,1,4.61
"20220916","1783","9268","9200",凱基-台北,29,87,58,-1,8.62
"20220916","1783","7792","7790",國票-北投,30,0,30,1,4.46
"20220916","1783","1650","1650",新加坡商瑞銀,0,34,34,-1,5.05
"20220916","1783","0037003000300063","7000",兆豐-民生,23,0,23,1,3.42
"20220916","1783","8440","8440",摩根大通,4,36,32,-1,4.75
"20220916","1783","0038003800340048","8840",玉山-新竹,16,0,16,1,2.38
"20220916","1783","9658","9600",富邦-建國,0,25,25,-1,3.71
"20220916","1783","9655","9600",富邦-板橋,14,0,14,1,2.08
"20220916","1783","0039003800390045","9800",元大-草屯,1,25,24,-1,3.57
"20220916","1783","8560","8560",新光,12,1,11,1,1.63
"20220916","1783","0031003200360058","1260",宏遠-新化,0,20,20,-1,2.97
"20220916","1783","1030","1030",土銀,11,0,11,1,1.63
"20220916","1783","003500320036004b","5260",美好-富順,0,20,20,-1,2.97
"20220916","1783","003500380035004a","5850",統一-三重,11,0,11,1,1.63
"20220916","1783","0039003200310043","9200",凱基-民權,0,18,18,-1,2.67
"20220916","1783","9239","9200",凱基-市政,11,0,11,1,1.63
"20220916","1783","0035003900320059","5920",元富-埔里,0,13,13,-1,1.93
"20220916","1783","5856","5850",統一-台中,10,0,10,1,1.49
"20220916","1783","9208","9200",凱基-桃園,0,11,11,-1,1.63
"20220916","1783","9186","9100",群益金鼎-新竹,10,0,10,1,1.49
"20220916","1783","0039003100380075","9100",群益金鼎-瑞豐,0,10,10,-1,1.49
"20220916","1783","0039004100360031","9A00",永豐金-鳳山,9,0,9,1,1.34
"20220916","1783","9859","9800",元大-新竹經國,0,10,10,-1,1.49
"20220916","1783","5854","5850",統一-城中,6,0,6,1,0.89
"20220916","1783","1440","1440",美林,0,9,9,-1,1.34
"20220916","1783","8848","8840",玉山-嘉義,6,0,6,1,0.89
"20220916","1783","0035003900320041","5920",元富-緯城,0,9,9,-1,1.34
"20220919","1783","0038003800340048","8840",玉山-新竹,15,0,15,1,3.18
"20220919","1783","8440","8440",摩根大通,3,30,27,-1,5.72
"20220919","1783","9239","9200",凱基-市政,14,0,14,1,2.97
"20220919","1783","0031003200360058","1260",宏遠-新化,0,20,20,-1,4.24
"20220919","1783","1650","1650",新加坡商瑞銀,18,6,12,1,2.54
"20220919","1783","0035003800350050","5850",統一-板橋,0,20,20,-1,4.24
"20220919","1783","9206","9200",凱基-高雄,11,0,11,1,2.33
"20220919","1783","0039003200300041","9200",凱基-板橋,0,18,18,-1,3.81
"20220919","1783","0035003800350059","5850",統一-土城,10,0,10,1,2.12
"20220919","1783","1520","1520",瑞士信貸,0,15,15,-1,3.18
"20220919","1783","0037003000300056","7000",兆豐-新竹,10,0,10,1,2.12
"20220919","1783","9186","9100",群益金鼎-新竹,0,10,10,-1,2.12
"20220919","1783","8158","8150",台新-松江,10,0,10,1,2.12
"20220919","1783","9285","9200",凱基-中壢,0,8,8,-1,1.69
"20220919","1783","9800","9800",元大證券,10,0,10,1,2.12
"20220919","1783","9686","9600",富邦-宜蘭,1,8,7,-1,1.48
"20220919","1783","7750","7750",北城證券,8,0,8,1,1.69
"20220919","1783","9854","9800",元大-文心興安,0,7,7,-1,1.48
"20220919","1783","003900360032004c","9600",富邦-雙和,8,0,8,1,1.69
"20220919","1783","0039003100380078","9100",群益金鼎-延平,0,6,6,-1,1.27
"20220919","1783","003800380038004b","8880",國泰-板橋,6,0,6,1,1.27
"20220919","1783","9306","9300",華南永昌-台南,0,6,6,-1,1.27
"20220919","1783","5855","5850",統一-台南,6,0,6,1,1.27
"20220919","1783","003900380030004b","9800",元大-竹科,0,6,6,-1,1.27
"20220919","1783","8843","8840",玉山-高雄,6,0,6,1,1.27
"20220919","1783","0031003200360051","1260",宏遠-高雄,0,5,5,-1,1.06
"20220919","1783","9255","9200",凱基-和平,6,0,6,1,1.27
"20220919","1783","003500390032006d","5920",元富-成功,0,5,5,-1,1.06
"20220920","1783","9239","9200",凱基-市政,7,0,7,1,3.68
"20220920","1783","0038003100350059","8150",台新-新營,0,8,8,-1,4.21
"20220920","1783","8888","8880",國泰-敦南,6,0,6,1,3.16
"20220920","1783","9331","9300",華南永昌-鳳山,0,7,7,-1,3.68
"20220920","1783","0039003800310051","9800",元大-太平,6,0,6,1,3.16
"20220920","1783","1520","1520",瑞士信貸,0,6,6,-1,3.16
"20220920","1783","1440","1440",美林,8,3,5,1,2.63
"20220920","1783","9306","9300",華南永昌-台南,0,6,6,-1,3.16
"20220920","1783","0037003000300071","7000",兆豐-內湖,5,0,5,1,2.63
"20220920","1783","0039003600310051","9600",富邦-重新,0,6,6,-1,3.16
"20220920","1783","8158","8150",台新-松江,5,0,5,1,2.63
"20220920","1783","1480","1480",美商高盛,0,5,5,-1,2.63
"20220920","1783","9187","9100",群益金鼎-彰化,5,0,5,1,2.63
"20220920","1783","1470","1470",台灣摩根士丹利,0,5,5,-1,2.63
"20220920","1783","9256","9200",凱基-南崁,5,0,5,1,2.63
"20220920","1783","5859","5850",統一-屏東,0,5,5,-1,2.63
"20220920","1783","0039003200300046","9200",凱基-站前,5,1,4,1,2.11
"20220920","1783","6460","6460",大昌,0,5,5,-1,2.63
"20220920","1783","9614","9600",富邦-基隆,4,0,4,1,2.11
"20220920","1783","0039003100330059","9100",群益金鼎-館前,0,5,5,-1,2.63
"20220920","1783","5383","5380",第一金-高雄,3,0,3,1,1.58
"20220920","1783","9892","9800",元大-屏東,0,5,5,-1,2.63
"20220920","1783","9326","9300",華南永昌-南京,3,0,3,1,1.58
"20220920","1783","0037003000300063","7000",兆豐-民生,0,4,4,-1,2.11
"20220920","1783","0039003600320047","9600",富邦-斗六,3,0,3,1,1.58
"20220920","1783","0038003100350053","8150",台新-中壢,0,4,4,-1,2.11
"20220920","1783","0039004100390059","9A00",永豐金-板盛,3,0,3,1,1.58
"20220920","1783","0035003300380045","5380",第一金-自由,0,3,3,-1,1.58
"20220921","1783","003900380031006d","9800",元大-前金,12,0,12,1,4.33
"20220921","1783","1520","1520",瑞士信貸,0,25,25,-1,9.03
"20220921","1783","1650","1650",新加坡商瑞銀,25,14,11,1,3.97
"20220921","1783","6160","6160",中國信託,0,14,14,-1,5.05
"20220921","1783","5855","5850",統一-台南,11,0,11,1,3.97
"20220921","1783","0039003800310051","9800",元大-太平,0,10,10,-1,3.61
"20220921","1783","9339","9300",華南永昌-竹北,11,0,11,1,3.97
"20220921","1783","1480","1480",美商高盛,0,9,9,-1,3.25
"20220921","1783","0039003800390049","9800",元大-蘆洲,11,0,11,1,3.97
"20220921","1783","0039004100360031","9A00",永豐金-鳳山,0,8,8,-1,2.89
"20220921","1783","8158","8150",台新-松江,10,0,10,1,3.61
"20220921","1783","8888","8880",國泰-敦南,2,8,6,-1,2.17
"20220921","1783","8440","8440",摩根大通,7,0,7,1,2.53
"20220921","1783","9326","9300",華南永昌-南京,1,7,6,-1,2.17
"20220921","1783","003800380034004a","8840",玉山-大里,6,0,6,1,2.17
"20220921","1783","9331","9300",華南永昌-鳳山,0,6,6,-1,2.17
"20220921","1783","9614","9600",富邦-基隆,6,0,6,1,2.17
"20220921","1783","9134","9100",群益金鼎-開元,0,5,5,-1,1.81
"20220921","1783","0037003000300056","7000",兆豐-新竹,5,0,5,1,1.81
"20220921","1783","0039003600390043","9600",富邦-北港,0,5,5,-1,1.81
"20220921","1783","0038003800340048","8840",玉山-新竹,5,0,5,1,1.81
"20220921","1783","9800","9800",元大證券,0,5,5,-1,1.81
"20220921","1783","0039003100380063","9100",群益金鼎-鳳山,5,0,5,1,1.81
"20220921","1783","8560","8560",新光,0,5,5,-1,1.81
"20220921","1783","0035003900320069","5920",元富-中港,4,0,4,1,1.44
"20220921","1783","0035003900320043","5920",元富-潮州,0,4,4,-1,1.44
"20220921","1783","0031003000330046","1030",土銀-南港,3,0,3,1,1.08
"20220921","1783","6463","6460",大昌-新竹,0,4,4,-1,1.44
"20220922","1783","5856","5850",統一-台中,29,1,28,1,5.62
"20220922","1783","1260","1260",宏遠證券,1,30,29,-1,5.82
"20220922","1783","9238","9200",凱基-士林,20,0,20,1,4.02
"20220922","1783","9239","9200",凱基-市政,1,25,24,-1,4.82
"20220922","1783","8560","8560",新光,17,3,14,1,2.81
"20220922","1783","1650","1650",新加坡商瑞銀,23,38,15,-1,3.01
"20220922","1783","9223","9200",凱基-豐中,12,0,12,1,2.41
"20220922","1783","003500390032006d","5920",元富-成功,0,10,10,-1,2.01
"20220922","1783","5385","5380",第一金-桃園,11,0,11,1,2.21
"20220922","1783","0037003000300063","7000",兆豐-民生,0,10,10,-1,2.01
"20220922","1783","9224","9200",凱基-新莊,10,0,10,1,2.01
"20220922","1783","0039003800390049","9800",元大-蘆洲,0,10,10,-1,2.01
"20220922","1783","8150","8150",台新證券,9,0,9,1,1.81
"20220922","1783","003900410039005a","9A00",永豐金-復興,0,10,10,-1,2.01
"20220922","1783","9852","9800",元大-永春,7,0,7,1,1.41
"20220922","1783","8848","8840",玉山-嘉義,0,10,10,-1,2.01
"20220922","1783","6460","6460",大昌,6,0,6,1,1.20
"20220922","1783","1520","1520",瑞士信貸,0,9,9,-1,1.81
"20220922","1783","9208","9200",凱基-桃園,5,0,5,1,1.00
"20220922","1783","0035003900320069","5920",元富-中港,1,10,9,-1,1.81
"20220922","1783","9266","9200",凱基-新豐,5,0,5,1,1.00
"20220922","1783","8843","8840",玉山-高雄,0,8,8,-1,1.61
"20220922","1783","9874","9800",元大-雙和,5,0,5,1,1.00
"20220922","1783","8888","8880",國泰-敦南,5,13,8,-1,1.61
"20220922","1783","003500390032004d","5920",元富-彰化,4,0,4,1,0.80
"20220922","1783","0039003600310057","9600",富邦-東花蓮,0,5,5,-1,1.00
"20220922","1783","6168","6160",中國信託-嘉義,5,1,4,1,0.80
"20220922","1783","0039003600320059","9600",富邦-土城,0,5,5,-1,1.00
"20220923","1783","9239","9200",凱基-市政,35,1,34,1,6.48
"20220923","1783","0035003900320042","5920",元富-永和,1,35,34,-1,6.48
"20220923","1783","003500380035004a","5850",統一-三重,39,15,24,1,4.57
"20220923","1783","1480","1480",美商高盛,3,28,25,-1,4.76
"20220923","1783","9238","9200",凱基-士林,20,0,20,1,3.81
"20220923","1783","8560","8560",新光,2,26,24,-1,4.57
"20220923","1783","8158","8150",台新-松江,15,0,15,1,2.86
"20220923","1783","5856","5850",統一-台中,1,21,20,-1,3.81
"20220923","1783","0037003000300063","7000",兆豐-民生,11,0,11,1,2.10
"20220923","1783","003900380033006a","9800",元大-仁愛,0,20,20,-1,3.81
"20220923","1783","8847","8840",玉山-台南,11,1,10,1,1.90
"20220923","1783","1040","1040",臺銀,0,15,15,-1,2.86
"20220923","1783","9278","9200",凱基-永康,10,0,10,1,1.90
"20220923","1783","8440","8440",摩根大通,2,14,12,-1,2.29
"20220923","1783","003500390032006d","5920",元富-成功,10,0,10,1,1.90
"20220923","1783","0039004100390032","9A00",永豐金-萬盛,0,11,11,-1,2.10
"20220923","1783","9875","9800",元大-土城永寧,9,0,9,1,1.71
"20220923","1783","9224","9200",凱基-新莊,0,10,10,-1,1.90
"20220923","1783","0038003400350045","8450",康和-澎湖,8,0,8,1,1.52
"20220923","1783","7008","7000",兆豐-三重,0,9,9,-1,1.71
"20220923","1783","1440","1440",美林,11,4,7,1,1.33
"20220923","1783","8150","8150",台新證券,0,8,8,-1,1.52
"20220923","1783","6950","6950",福勝,7,0,7,1,1.33
"20220923","1783","9822","9800",元大-土城學府,0,8,8,-1,1.52
"20220923","1783","9255","9200",凱基-和平,11,4,7,1,1.33
"20220923","1783","5852","5850",統一-敦南,0,6,6,-1,1.14
"20220923","1783","0039004100390059","9A00",永豐金-板盛,7,0,7,1,1.33
"20220923","1783","003500390032004d","5920",元富-彰化,0,6,6,-1,1.14
"20220926","1783","9268","9200",凱基-台北,77,45,32,1,5.65
"20220926","1783","8440","8440",摩根大通,1,21,20,-1,3.53
"20220926","1783","5856","5850",統一-台中,20,0,20,1,3.53
"20220926","1783","0038003100350042","8150",台新-台中,0,19,19,-1,3.36
"20220926","1783","8158","8150",台新-松江,20,0,20,1,3.53
"20220926","1783","0039004100390067","9A00",永豐金-內湖,0,15,15,-1,2.65
"20220926","1783","9239","9200",凱基-市政,20,0,20,1,3.53
"20220926","1783","1480","1480",美商高盛,5,19,14,-1,2.47
"20220926","1783","0038003800340048","8840",玉山-新竹,14,0,14,1,2.47
"20220926","1783","6380","6380",光和,0,12,12,-1,2.12
"20220926","1783","0035003900320042","5920",元富-永和,31,20,11,1,1.94
"20220926","1783","1650","1650",新加坡商瑞銀,3,14,11,-1,1.94
"20220926","1783","1030","1030",土銀,10,0,10,1,1.77
"20220926","1783","9223","9200",凱基-豐中,1,12,11,-1,1.94
"20220926","1783","7006","7000",兆豐-台南,10,0,10,1,1.77
"20220926","1783","003500390032004d","5920",元富-彰化,0,10,10,-1,1.77
"20220926","1783","0037003000300056","7000",兆豐-新竹,10,0,10,1,1.77
"20220926","1783","0038003400350058","8450",康和-屏東,0,10,10,-1,1.77
"20220926","1783","9867","9800",元大-北成功,10,0,10,1,1.77
"20220926","1783","5925","5920",元富-台中,0,8,8,-1,1.41
"20220926","1783","0039003600320047","9600",富邦-斗六,10,4,6,1,1.06
"20220926","1783","003500390032004c","5920",元富-中壢,0,8,8,-1,1.41
"20220926","1783","0035003900320076","5920",元富-桃園,6,0,6,1,1.06
"20220926","1783","9236","9200",凱基-虎尾,0,8,8,-1,1.41
"20220926","1783","8150","8150",台新證券,6,0,6,1,1.06
"20220926","1783","9307","9300",華南永昌-大安,0,7,7,-1,1.24
"20220926","1783","1040","1040",臺銀,5,0,5,1,0.88
"20220926","1783","0039003600310044","9600",富邦-忠孝,0,7,7,-1,1.24
"20220927","1783","8440","8440",摩根大通,28,6,22,1,7.36
"20220927","1783","8840","8840",玉山證券,0,11,11,-1,3.68
"20220927","1783","5855","5850",統一-台南,17,0,17,1,5.69
"20220927","1783","0039003600320050","9600",富邦-頭份,0,10,10,-1,3.34
"20220927","1783","9268","9200",凱基-台北,42,25,17,1,5.69
"20220927","1783","1034","1030",土銀-嘉義,0,7,7,-1,2.34
"20220927","1783","8560","8560",新光,11,0,11,1,3.68
"20220927","1783","0037003000300064","7000",兆豐-彰化,0,6,6,-1,2.01
"20220927","1783","7006","7000",兆豐-台南,10,0,10,1,3.34
"20220927","1783","0039003800310046","9800",元大-福營,0,6,6,-1,2.01
"20220927","1783","0039003100380045","9100",群益金鼎-南京,10,0,10,1,3.34
"20220927","1783","1040","1040",臺銀,0,5,5,-1,1.67
"20220927","1783","9614","9600",富邦-基隆,10,0,10,1,3.34
"20220927","1783","6460","6460",大昌,0,5,5,-1,1.67
"20220927","1783","9697","9600",富邦-虎尾,8,0,8,1,2.68
"20220927","1783","9331","9300",華南永昌-鳳山,0,5,5,-1,1.67
"20220927","1783","9859","9800",元大-新竹經國,7,1,6,1,2.01
"20220927","1783","0039003800380042","9800",元大-桃園,0,5,5,-1,1.67
"20220927","1783","1230","1230",彰銀,5,0,5,1,1.67
"20220927","1783","0038003100350041","8150",台新-高雄,1,5,4,-1,1.34
"20220927","1783","1480","1480",美商高盛,13,8,5,1,1.67
"20220927","1783","9272","9200",凱基-竹科,0,3,3,-1,1.00
"20220927","1783","5323","5320",高橋-內壢,5,0,5,1,1.67
"20220927","1783","9326","9300",華南永昌-南京,0,3,3,-1,1.00
"20220927","1783","8158","8150",台新-松江,5,1,4,1,1.34
"20220927","1783","1470","1470",台灣摩根士丹利,0,2,2,-1,0.67
"20220927","1783","7003","7000",兆豐-台中,3,0,3,1,1.00
"20220927","1783","9665","9600",富邦-桃園,0,2,2,-1,0.67
"20220928","1783","8158","8150",台新-松江,30,0,30,1,4.06
"20220928","1783","9268","9200",凱基-台北,21,117,96,-1,12.99
"20220928","1783","7006","7000",兆豐-台南,20,0,20,1,2.71
"20220928","1783","0037003000300053","7000",兆豐-大同,0,50,50,-1,6.77
"20220928","1783","0039003600320047","9600",富邦-斗六,20,1,19,1,2.57
"20220928","1783","9875","9800",元大-土城永寧,0,20,20,-1,2.71
"20220928","1783","9655","9600",富邦-板橋,12,0,12,1,1.62
"20220928","1783","0037003000300055","7000",兆豐-桃鶯,0,18,18,-1,2.44
"20220928","1783","8711","8710",陽信-石牌,11,0,11,1,1.49
"20220928","1783","8440","8440",摩根大通,11,24,13,-1,1.76
"20220928","1783","1030","1030",土銀,10,0,10,1,1.35
"20220928","1783","5266","5260",美好-中壢,0,10,10,-1,1.35
"20220928","1783","5384","5380",第一金-台南,10,0,10,1,1.35
"20220928","1783","8150","8150",台新證券,2,10,8,-1,1.08
"20220928","1783","9306","9300",華南永昌-台南,10,0,10,1,1.35
"20220928","1783","5383","5380",第一金-高雄,0,8,8,-1,1.08
"20220928","1783","0039003800390049","9800",元大-蘆洲,10,0,10,1,1.35
"20220928","1783","9331","9300",華南永昌-鳳山,0,8,8,-1,1.08
"20220928","1783","9676","9600",富邦-仁愛,9,0,9,1,1.22
"20220928","1783","1480","1480",美商高盛,9,16,7,-1,0.95
"20220928","1783","0035003300380050","5380",第一金-路竹,8,0,8,1,1.08
"20220928","1783","0039003200300044","9200",凱基-市府,0,6,6,-1,0.81
"20220928","1783","5856","5850",統一-台中,8,0,8,1,1.08
"20220928","1783","0039003800310046","9800",元大-福營,0,6,6,-1,0.81
"20220928","1783","9205","9200",凱基-三重,7,0,7,1,0.95
"20220928","1783","9833","9800",元大-敦化,0,6,6,-1,0.81
"20220928","1783","5855","5850",統一-台南,45,39,6,1,0.81
"20220928","1783","0039004100390045","9A00",永豐金-板橋,0,5,5,-1,0.68
"20220929","1783","8440","8440",摩根大通,25,0,25,1,6.27
"20220929","1783","5856","5850",統一-台中,2,13,11,-1,2.76
"20220929","1783","8711","8710",陽信-石牌,25,0,25,1,6.27
"20220929","1783","9239","9200",凱基-市政,2,13,11,-1,2.76
"20220929","1783","1440","1440",美林,18,2,16,1,4.01
"20220929","1783","8888","8880",國泰-敦南,0,8,8,-1,2.01
"20220929","1783","1650","1650",新加坡商瑞銀,20,9,11,1,2.76
"20220929","1783","1480","1480",美商高盛,1,8,7,-1,1.75
"20220929","1783","9302","9300",華南永昌-台中,10,0,10,1,2.51
"20220929","1783","9676","9600",富邦-仁愛,2,9,7,-1,1.75
"20220929","1783","9256","9200",凱基-南崁,8,0,8,1,2.01
"20220929","1783","1040","1040",臺銀,0,5,5,-1,1.25
"20220929","1783","8560","8560",新光,9,2,7,1,1.75
"20220929","1783","003900310038004b","9100",群益金鼎-東湖,0,5,5,-1,1.25
"20220929","1783","0037003000300063","7000",兆豐-民生,7,0,7,1,1.75
"20220929","1783","9217","9200",凱基-松山,0,5,5,-1,1.25
"20220929","1783","003900380039004a","9800",元大-彰化民生,5,0,5,1,1.25
"20220929","1783","0039003200320048","9200",凱基-復興,0,5,5,-1,1.25
"20220929","1783","0039003100380044","9100",群益金鼎-東門,2,0,2,1,0.50
"20220929","1783","0039003600330041","9600",富邦-八德,0,5,5,-1,1.25
"20220929","1783","9208","9200",凱基-桃園,2,0,2,1,0.50
"20220929","1783","0039004100390036","9A00",永豐金-博愛,0,5,5,-1,1.25
"20220929","1783","9624","9600",富邦-竹北,2,0,2,1,0.50
"20220929","1783","003900310038007a","9100",群益金鼎-宜蘭,0,4,4,-1,1.00
"20220929","1783","0039003800310079","9800",元大-善化,2,0,2,1,0.50
"20220929","1783","003500320036004b","5260",美好-富順,0,3,3,-1,0.75
"20220929","1783","9834","9800",元大-中壢,2,0,2,1,0.50
"20220929","1783","2180","2180",亞東,1,4,3,-1,0.75
"20220930","1783","8560","8560",新光,19,4,15,1,7.39
"20220930","1783","9268","9200",凱基-台北,17,34,17,-1,8.37
"20220930","1783","8440","8440",摩根大通,16,2,14,1,6.90
"20220930","1783","0039003100380045","9100",群益金鼎-南京,0,10,10,-1,4.93
"20220930","1783","2180","2180",亞東,10,0,10,1,4.93
"20220930","1783","1440","1440",美林,3,12,9,-1,4.43
"20220930","1783","9239","9200",凱基-市政,15,5,10,1,4.93
"20220930","1783","9272","9200",凱基-竹科,0,8,8,-1,3.94
"20220930","1783","9256","9200",凱基-南崁,7,0,7,1,3.45
"20220930","1783","5856","5850",統一-台中,0,6,6,-1,2.96
"20220930","1783","1560","1560",港商野村,6,1,5,1,2.46
"20220930","1783","1650","1650",新加坡商瑞銀,5,11,6,-1,2.96
"20220930","1783","8158","8150",台新-松江,5,0,5,1,2.46
"20220930","1783","8459","8450",康和-嘉義,0,6,6,-1,2.96
"20220930","1783","003900310038004b","9100",群益金鼎-東湖,5,0,5,1,2.46
"20220930","1783","9185","9100",群益金鼎-台南,0,5,5,-1,2.46
"20220930","1783","9302","9300",華南永昌-台中,5,0,5,1,2.46
"20220930","1783","9893","9800",元大-大天母,0,5,5,-1,2.46
"20220930","1783","5320","5320",高橋,3,0,3,1,1.48
"20220930","1783","1262","1260",宏遠-桃園,0,3,3,-1,1.48
"20220930","1783","0035003900320069","5920",元富-中港,3,0,3,1,1.48
"20220930","1783","9227","9200",凱基-城中,0,3,3,-1,1.48
"20220930","1783","0037003700390075","7790",國票-長城,5,3,2,1,0.99
"20220930","1783","0039003600320047","9600",富邦-斗六,2,5,3,-1,1.48
"20220930","1783","0039003100380063","9100",群益金鼎-鳳山,2,0,2,1,0.99
"20220930","1783","9852","9800",元大-永春,0,3,3,-1,1.48
"20220930","1783","0039003600320056","9600",富邦-復興,2,0,2,1,0.99
"20220930","1783","0039003800310079","9800",元大-善化,0,2,2,-1,0.99
"20220816","1783","003500390032004d","5920",元富-彰化,25,0,25,1,5.62
"20220816","1783","9879","9800",元大-板橋三民,0,20,20,-1,4.49
"20220816","1783","5856","5850",統一-台中,24,0,24,1,5.39
"20220816","1783","0039003800330056","9800",元大-竹南,4,17,13,-1,2.92
"20220816","1783","1470","1470",台灣摩根士丹利,16,0,16,1,3.60
"20220816","1783","9658","9600",富邦-建國,0,11,11,-1,2.47
"20220816","1783","9268","9200",凱基-台北,44,33,11,1,2.47
"20220816","1783","0039003800310046","9800",元大-福營,0,9,9,-1,2.02
"20220816","1783","1440","1440",美林,13,6,7,1,1.57
"20220816","1783","9892","9800",元大-屏東,4,13,9,-1,2.02
"20220816","1783","0039003800300052","9800",元大-南海,7,0,7,1,1.57
"20220816","1783","003700300030004a","7000",兆豐-公益,0,6,6,-1,1.35
"20220816","1783","0035003300380043","5380",第一金-光復,6,0,6,1,1.35
"20220816","1783","0039003600310048","9600",富邦-新板,2,8,6,-1,1.35
"20220816","1783","9359","9300",華南永昌-中正,8,2,6,1,1.35
"20220816","1783","0039003600320059","9600",富邦-土城,0,6,6,-1,1.35
"20220816","1783","0035003300380059","5380",第一金-中壢,4,0,4,1,0.90
"20220816","1783","9233","9200",凱基-長庚,0,5,5,-1,1.12
"20220816","1783","8847","8840",玉山-台南,5,1,4,1,0.90
"20220816","1783","7750","7750",北城證券,1,6,5,-1,1.12
"20220816","1783","0039003800310051","9800",元大-太平,4,0,4,1,0.90
"20220816","1783","0039003600310045","9600",富邦-府城,0,5,5,-1,1.12
"20220816","1783","0039003800340048","9800",元大-景美,4,0,4,1,0.90
"20220816","1783","0039003600310046","9600",富邦-中港,0,5,5,-1,1.12
"20220816","1783","5850","5850",統一,4,0,4,1,0.90
"20220816","1783","9655","9600",富邦-板橋,0,5,5,-1,1.12
"20220816","1783","1030","1030",土銀,3,0,3,1,0.67
"20220816","1783","1034","1030",土銀-嘉義,0,4,4,-1,0.90
"20220817","1783","9268","9200",凱基-台北,57,17,40,1,7.27
"20220817","1783","0037003000300056","7000",兆豐-新竹,0,10,10,-1,1.82
"20220817","1783","9285","9200",凱基-中壢,40,0,40,1,7.27
"20220817","1783","8583","8580",聯邦-忠孝,0,10,10,-1,1.82
"20220817","1783","8711","8710",陽信-石牌,28,0,28,1,5.09
"20220817","1783","9207","9200",凱基-永和,0,10,10,-1,1.82
"20220817","1783","1480","1480",美商高盛,30,9,21,1,3.82
"20220817","1783","9614","9600",富邦-基隆,0,10,10,-1,1.82
"20220817","1783","1650","1650",新加坡商瑞銀,20,4,16,1,2.91
"20220817","1783","0039003600310048","9600",富邦-新板,0,10,10,-1,1.82
"20220817","1783","9867","9800",元大-北成功,15,0,15,1,2.73
"20220817","1783","9254","9200",凱基-科園,0,9,9,-1,1.64
"20220817","1783","0039004100390058","9A00",永豐金-竹科,13,0,13,1,2.36
"20220817","1783","5858","5850",統一-嘉義,0,8,8,-1,1.45
"20220817","1783","8440","8440",摩根大通,24,12,12,1,2.18
"20220817","1783","9386","9300",華南永昌-東昇,0,8,8,-1,1.45
"20220817","1783","1560","1560",港商野村,17,6,11,1,2.00
"20220817","1783","003900380030004b","9800",元大-竹科,0,8,8,-1,1.45
"20220817","1783","0037003700390050","7790",國票-九鼎,10,0,10,1,1.82
"20220817","1783","6380","6380",光和,0,7,7,-1,1.27
"20220817","1783","003600310036004b","6160",中國信託-高雄,10,1,9,1,1.64
"20220817","1783","0038003100350048","8150",台新-屏東,0,7,7,-1,1.27
"20220817","1783","0039003600310050","9600",富邦-和美,10,2,8,1,1.45
"20220817","1783","0039003100380044","9100",群益金鼎-東門,0,7,7,-1,1.27
"20220817","1783","2180","2180",亞東,7,0,7,1,1.27
"20220817","1783","0039003800390061","9800",元大-苑裡,1,8,7,-1,1.27
"20220817","1783","9239","9200",凱基-市政,19,13,6,1,1.09
"20220817","1783","1034","1030",土銀-嘉義,0,6,6,-1,1.09
"20220818","1783","0038003100350053","8150",台新-中壢,19,0,19,1,2.59
"20220818","1783","9268","9200",凱基-台北,56,75,19,-1,2.59
"20220818","1783","9337","9300",華南永昌-內壢,17,0,17,1,2.32
"20220818","1783","1440","1440",美林,7,23,16,-1,2.18
"20220818","1783","003900380031004b","9800",元大-林園,15,0,15,1,2.05
"20220818","1783","0039003600310043","9600",富邦-南京,1,15,14,-1,1.91
"20220818","1783","003900380031004d","9800",元大-苗栗,15,0,15,1,2.05
"20220818","1783","1030","1030",土銀,0,13,13,-1,1.77
"20220818","1783","8888","8880",國泰-敦南,13,1,12,1,1.64
"20220818","1783","003700300030004a","7000",兆豐-公益,4,14,10,-1,1.36
"20220818","1783","1040","1040",臺銀,10,0,10,1,1.36
"20220818","1783","8440","8440",摩根大通,16,26,10,-1,1.36
"20220818","1783","9300","9300",華南永昌,15,6,9,1,1.23
"20220818","1783","9223","9200",凱基-豐中,1,11,10,-1,1.36
"20220818","1783","2187","2180",亞東-台中,8,0,8,1,1.09
"20220818","1783","0039003600310050","9600",富邦-和美,0,10,10,-1,1.36
"20220818","1783","0039003100380048","9100",群益金鼎-中山,8,0,8,1,1.09
"20220818","1783","003600310036004b","6160",中國信託-高雄,22,31,9,-1,1.23
"20220818","1783","0039004100390058","9A00",永豐金-竹科,8,0,8,1,1.09
"20220818","1783","1034","1030",土銀-嘉義,0,7,7,-1,0.95
"20220818","1783","9208","9200",凱基-桃園,7,0,7,1,0.95
"20220818","1783","1560","1560",港商野村,4,11,7,-1,0.95
"20220818","1783","0039004100390037","9A00",永豐金-新竹,7,0,7,1,0.95
"20220818","1783","9100","9100",群益金鼎,0,5,5,-1,0.68
"20220818","1783","003900380030004b","9800",元大-竹科,8,3,5,1,0.68
"20220818","1783","5850","5850",統一,3,7,4,-1,0.55
"20220818","1783","8848","8840",玉山-嘉義,5,0,5,1,0.68
"20220818","1783","0038003400350046","8450",康和-仁愛,0,4,4,-1,0.55
"20220819","1783","9268","9200",凱基-台北,41,20,21,1,5.41
"20220819","1783","9614","9600",富邦-基隆,0,30,30,-1,7.73
"20220819","1783","0039003800300052","9800",元大-南海,19,0,19,1,4.90
"20220819","1783","9337","9300",華南永昌-內壢,0,16,16,-1,4.12
"20220819","1783","9278","9200",凱基-永康,15,0,15,1,3.87
"20220819","1783","8150","8150",台新證券,1,10,9,-1,2.32
"20220819","1783","1034","1030",土銀-嘉義,13,0,13,1,3.35
"20220819","1783","003900380031006d","9800",元大-前金,0,8,8,-1,2.06
"20220819","1783","1480","1480",美商高盛,15,4,11,1,2.84
"20220819","1783","1440","1440",美林,6,11,5,-1,1.29
"20220819","1783","8440","8440",摩根大通,35,24,11,1,2.84
"20220819","1783","5322","5320",高橋-中壢,0,5,5,-1,1.29
"20220819","1783","1650","1650",新加坡商瑞銀,14,4,10,1,2.58
"20220819","1783","5856","5850",統一-台中,0,5,5,-1,1.29
"20220819","1783","9814","9800",元大-大益,9,1,8,1,2.06
"20220819","1783","003900320030004e","9200",凱基-湖口,9,14,5,-1,1.29
"20220819","1783","0031003200360055","1260",宏遠-館前,7,0,7,1,1.80
"20220819","1783","0039003600310058","9600",富邦-大墩,0,5,5,-1,1.29
"20220819","1783","5852","5850",統一-敦南,5,0,5,1,1.29
"20220819","1783","0039003100330049","9100",群益金鼎-萬華,0,4,4,-1,1.03
"20220819","1783","0037003000300067","7000",兆豐-南門,8,3,5,1,1.29
"20220819","1783","0039003800310051","9800",元大-太平,0,4,4,-1,1.03
"20220819","1783","9233","9200",凱基-長庚,7,2,5,1,1.29
"20220819","1783","0039004100390047","9A00",永豐金-天母,0,4,4,-1,1.03
"20220819","1783","9831","9800",元大-四維,9,4,5,1,1.29
"20220819","1783","003500390032004e","5920",元富-虎尾,0,3,3,-1,0.77
"20220819","1783","9867","9800",元大-北成功,5,0,5,1,1.29
"20220819","1783","8849","8840",玉山-景美,0,3,3,-1,0.77
"20220822","1783","6160","6160",中國信託,48,19,29,1,2.73
"20220822","1783","0039004100390037","9A00",永豐金-新竹,2,29,27,-1,2.54
"20220822","1783","1440","1440",美林,36,16,20,1,1.88
"20220822","1783","7006","7000",兆豐-台南,0,20,20,-1,1.88
"20220822","1783","5856","5850",統一-台中,27,7,20,1,1.88
"20220822","1783","8158","8150",台新-松江,0,20,20,-1,1.88
"20220822","1783","0035003800350048","5850",統一-桃園,22,4,18,1,1.69
"20220822","1783","9239","9200",凱基-市政,17,32,15,-1,1.41
"20220822","1783","0038003800380041","8880",國泰-館前,21,4,17,1,1.60
"20220822","1783","003900380031004d","9800",元大-苗栗,1,15,14,-1,1.32
"20220822","1783","9815","9800",元大-大灣,17,0,17,1,1.60
"20220822","1783","8888","8880",國泰-敦南,12,25,13,-1,1.22
"20220822","1783","003900410039004c","9A00",永豐金-台中,16,0,16,1,1.50
"20220822","1783","9856","9800",元大-花蓮,0,11,11,-1,1.03
"20220822","1783","0035003300380045","5380",第一金-自由,13,1,12,1,1.13
"20220822","1783","9867","9800",元大-北成功,0,11,11,-1,1.03
"20220822","1783","0039003600310050","9600",富邦-和美,11,0,11,1,1.03
"20220822","1783","9884","9800",元大-斗信,2,13,11,-1,1.03
"20220822","1783","5269","5260",美好-台中,10,0,10,1,0.94
"20220822","1783","5858","5850",統一-嘉義,0,10,10,-1,0.94
"20220822","1783","0039003800310071","9800",元大-萬華,12,2,10,1,0.94
"20220822","1783","9268","9200",凱基-台北,114,124,10,-1,0.94
"20220822","1783","0039003800310051","9800",元大-太平,12,2,10,1,0.94
"20220822","1783","8847","8840",玉山-台南,0,9,9,-1,0.85
"20220822","1783","0037003000300049","7000",兆豐-北高雄,9,0,9,1,0.85
"20220822","1783","2180","2180",亞東,0,7,7,-1,0.66
"20220822","1783","0037003000300063","7000",兆豐-民生,8,0,8,1,0.75
"20220822","1783","0038003800340042","8840",玉山-台中,0,7,7,-1,0.66
"20220823","1783","0037003000300056","7000",兆豐-新竹,25,0,25,1,4.23
"20220823","1783","1650","1650",新加坡商瑞銀,6,28,22,-1,3.72
"20220823","1783","9206","9200",凱基-高雄,23,0,23,1,3.89
"20220823","1783","8440","8440",摩根大通,18,39,21,-1,3.55
"20220823","1783","8158","8150",台新-松江,22,2,20,1,3.38
"20220823","1783","0039003600320055","9600",富邦-縣政,0,21,21,-1,3.55
"20220823","1783","9655","9600",富邦-板橋,20,0,20,1,3.38
"20220823","1783","0038003800380041","8880",國泰-館前,21,41,20,-1,3.38
"20220823","1783","9239","9200",凱基-市政,21,4,17,1,2.88
"20220823","1783","1480","1480",美商高盛,6,25,19,-1,3.21
"20220823","1783","9322","9300",華南永昌-公誠,14,1,13,1,2.20
"20220823","1783","0039003800310047","9800",元大-彰化,1,20,19,-1,3.21
"20220823","1783","1030","1030",土銀,10,0,10,1,1.69
"20220823","1783","1440","1440",美林,5,23,18,-1,3.05
"20220823","1783","0037003000300063","7000",兆豐-民生,10,0,10,1,1.69
"20220823","1783","9268","9200",凱基-台北,15,32,17,-1,2.88
"20220823","1783","0039003600310048","9600",富邦-新板,8,0,8,1,1.35
"20220823","1783","1470","1470",台灣摩根士丹利,0,13,13,-1,2.20
"20220823","1783","0039004100390037","9A00",永豐金-新竹,11,4,7,1,1.18
"20220823","1783","0039003600310050","9600",富邦-和美,0,11,11,-1,1.86
"20220823","1783","0039003100380063","9100",群益金鼎-鳳山,7,1,6,1,1.02
"20220823","1783","0035003900320044","5920",元富-大昌,0,5,5,-1,0.85
"20220823","1783","0039003800330056","9800",元大-竹南,5,0,5,1,0.85
"20220823","1783","0035003900320075","5920",元富-世貿,0,5,5,-1,0.85
"20220823","1783","5384","5380",第一金-台南,4,0,4,1,0.68
"20220823","1783","9634","9600",富邦-羅東,0,5,5,-1,0.85
"20220823","1783","0035003800350048","5850",統一-桃園,4,0,4,1,0.68
"20220823","1783","9872","9800",元大-復北,0,5,5,-1,0.85
"20220824","1783","1650","1650",新加坡商瑞銀,82,10,72,1,9.24
"20220824","1783","0039003800300064","9800",元大-沙鹿,0,41,41,-1,5.26
"20220824","1783","9268","9200",凱基-台北,101,48,53,1,6.80
"20220824","1783","9322","9300",華南永昌-公誠,5,27,22,-1,2.82
"20220824","1783","1480","1480",美商高盛,48,0,48,1,6.16
"20220824","1783","0039004100390059","9A00",永豐金-板盛,0,18,18,-1,2.31
"20220824","1783","1440","1440",美林,33,9,24,1,3.08
"20220824","1783","0035003800350048","5850",統一-桃園,0,16,16,-1,2.05
"20220824","1783","003900380039006a","9800",元大-樹林,21,0,21,1,2.70
"20220824","1783","0035003300380045","5380",第一金-自由,1,14,13,-1,1.67
"20220824","1783","1260","1260",宏遠證券,20,0,20,1,2.57
"20220824","1783","0039003600310048","9600",富邦-新板,1,14,13,-1,1.67
"20220824","1783","9815","9800",元大-大灣,13,0,13,1,1.67
"20220824","1783","0037003700390050","7790",國票-九鼎,0,12,12,-1,1.54
"20220824","1783","9205","9200",凱基-三重,14,2,12,1,1.54
"20220824","1783","9300","9300",華南永昌,0,12,12,-1,1.54
"20220824","1783","0035003800350044","5850",統一-新台中,13,2,11,1,1.41
"20220824","1783","8158","8150",台新-松江,0,10,10,-1,1.28
"20220824","1783","1470","1470",台灣摩根士丹利,12,2,10,1,1.28
"20220824","1783","0037003000300058","7000",兆豐-永和,0,9,9,-1,1.16
"20220824","1783","0039003600310050","9600",富邦-和美,10,0,10,1,1.28
"20220824","1783","0039003800310071","9800",元大-萬華,0,9,9,-1,1.16
"20220824","1783","0035003300380050","5380",第一金-路竹,10,1,9,1,1.16
"20220824","1783","0039004100390037","9A00",永豐金-新竹,0,9,9,-1,1.16
"20220824","1783","003600310036004b","6160",中國信託-高雄,11,2,9,1,1.16
"20220824","1783","003500380035004a","5850",統一-三重,0,8,8,-1,1.03
"20220824","1783","0037003000300063","7000",兆豐-民生,21,12,9,1,1.16
"20220824","1783","003500390032006c","5920",元富-大裕,0,8,8,-1,1.03
"20220825","1783","0038003100350053","8150",台新-中壢,21,0,21,1,4.40
"20220825","1783","1480","1480",美商高盛,0,33,33,-1,6.92
"20220825","1783","5856","5850",統一-台中,20,0,20,1,4.19
"20220825","1783","1650","1650",新加坡商瑞銀,9,37,28,-1,5.87
"20220825","1783","9614","9600",富邦-基隆,20,0,20,1,4.19
"20220825","1783","8440","8440",摩根大通,13,40,27,-1,5.66
"20220825","1783","5854","5850",統一-城中,16,0,16,1,3.35
"20220825","1783","1260","1260",宏遠證券,0,20,20,-1,4.19
"20220825","1783","2181","2180",亞東-板橋,15,0,15,1,3.14
"20220825","1783","003900410039004c","9A00",永豐金-台中,0,15,15,-1,3.14
"20220825","1783","5050","5050",大展,15,0,15,1,3.14
"20220825","1783","9205","9200",凱基-三重,0,14,14,-1,2.94
"20220825","1783","8158","8150",台新-松江,10,0,10,1,2.10
"20220825","1783","9208","9200",凱基-桃園,0,13,13,-1,2.73
"20220825","1783","9322","9300",華南永昌-公誠,10,0,10,1,2.10
"20220825","1783","0035003800350062","5850",統一-內湖,0,10,10,-1,2.10
"20220825","1783","1024","1020",合庫-嘉義,8,0,8,1,1.68
"20220825","1783","9858","9800",元大-龍潭,0,9,9,-1,1.89
"20220825","1783","0037003000300058","7000",兆豐-永和,8,0,8,1,1.68
"20220825","1783","0035003300380050","5380",第一金-路竹,1,10,9,-1,1.89
"20220825","1783","0039003100380063","9100",群益金鼎-鳳山,9,1,8,1,1.68
"20220825","1783","003600310036004b","6160",中國信託-高雄,0,9,9,-1,1.89
"20220825","1783","0038003400350046","8450",康和-仁愛,7,0,7,1,1.47
"20220825","1783","5922","5920",元富-新店,0,7,7,-1,1.47
"20220825","1783","0038003800380041","8880",國泰-館前,8,1,7,1,1.47
"20220825","1783","003500390032005a","5920",元富-安南,0,7,7,-1,1.47
"20220825","1783","9655","9600",富邦-板橋,7,0,7,1,1.47
"20220825","1783","1470","1470",台灣摩根士丹利,0,5,5,-1,1.05
"20220826","1783","8440","8440",摩根大通,59,9,50,1,9.12
"20220826","1783","9223","9200",凱基-豐中,0,21,21,-1,3.83
"20220826","1783","1480","1480",美商高盛,36,1,35,1,6.39
"20220826","1783","9215","9200",凱基-高美館,4,21,17,-1,3.10
"20220826","1783","5854","5850",統一-城中,25,0,25,1,4.56
"20220826","1783","9239","9200",凱基-市政,7,19,12,-1,2.19
"20220826","1783","1650","1650",新加坡商瑞銀,27,4,23,1,4.20
"20220826","1783","0035003300380045","5380",第一金-自由,1,12,11,-1,2.01
"20220826","1783","003500380035004a","5850",統一-三重,19,3,16,1,2.92
"20220826","1783","0035003800350048","5850",統一-桃園,0,11,11,-1,2.01
"20220826","1783","1560","1560",港商野村,16,2,14,1,2.55
"20220826","1783","0037003000300045","7000",兆豐-斗南(停),0,11,11,-1,2.01
"20220826","1783","9604","9600",富邦-陽明,11,0,11,1,2.01
"20220826","1783","003900410039004c","9A00",永豐金-台中,0,11,11,-1,2.01
"20220826","1783","7008","7000",兆豐-三重,10,0,10,1,1.82
"20220826","1783","9815","9800",元大-大灣,0,10,10,-1,1.82
"20220826","1783","9319","9300",華南永昌-鶯歌,11,1,10,1,1.82
"20220826","1783","003500390032006c","5920",元富-大裕,0,8,8,-1,1.46
"20220826","1783","0039003800310065","9800",元大-佳里,10,0,10,1,1.82
"20220826","1783","0038003800380041","8880",國泰-館前,0,8,8,-1,1.46
"20220826","1783","5856","5850",統一-台中,10,3,7,1,1.28
"20220826","1783","0035003800350044","5850",統一-新台中,3,9,6,-1,1.09
"20220826","1783","0035003900320057","5920",元富-吉利,7,0,7,1,1.28
"20220826","1783","003500390032006d","5920",元富-成功,0,5,5,-1,0.91
"20220826","1783","8150","8150",台新證券,9,2,7,1,1.28
"20220826","1783","1034","1030",土銀-嘉義,0,5,5,-1,0.91
"20220826","1783","0037003000300063","7000",兆豐-民生,6,0,6,1,1.09
"20220826","1783","5269","5260",美好-台中,0,5,5,-1,0.91
"20220829","1783","9239","9200",凱基-市政,24,1,23,1,5.00
"20220829","1783","9285","9200",凱基-中壢,0,40,40,-1,8.70
"20220829","1783","9867","9800",元大-北成功,20,0,20,1,4.35
"20220829","1783","9268","9200",凱基-台北,38,62,24,-1,5.22
"20220829","1783","1034","1030",土銀-嘉義,11,0,11,1,2.39
"20220829","1783","5856","5850",統一-台中,0,14,14,-1,3.04
"20220829","1783","0039003600310043","9600",富邦-南京,9,0,9,1,1.96
"20220829","1783","1480","1480",美商高盛,4,16,12,-1,2.61
"20220829","1783","0039003100380063","9100",群益金鼎-鳳山,11,3,8,1,1.74
"20220829","1783","5320","5320",高橋,0,7,7,-1,1.52
"20220829","1783","8440","8440",摩根大通,20,13,7,1,1.52
"20220829","1783","0037003000300049","7000",兆豐-北高雄,0,7,7,-1,1.52
"20220829","1783","9278","9200",凱基-永康,7,0,7,1,1.52
"20220829","1783","0039003800300065","9800",元大-清水,0,7,7,-1,1.52
"20220829","1783","9322","9300",華南永昌-公誠,7,0,7,1,1.52
"20220829","1783","1470","1470",台灣摩根士丹利,0,5,5,-1,1.09
"20220829","1783","9215","9200",凱基-高美館,9,2,7,1,1.52
"20220829","1783","9623","9600",富邦-台北,3,8,5,-1,1.09
"20220829","1783","9672","9600",富邦-員林,6,0,6,1,1.30
"20220829","1783","0037003000300070","7000",兆豐-復興,0,4,4,-1,0.87
"20220829","1783","0037003000300063","7000",兆豐-民生,12,7,5,1,1.09
"20220829","1783","0039003800390061","9800",元大-苑裡,1,5,4,-1,0.87
"20220829","1783","003700300030004a","7000",兆豐-公益,5,0,5,1,1.09
"20220829","1783","1440","1440",美林,15,18,3,-1,0.65
"20220829","1783","8846","8840",玉山-板橋,5,0,5,1,1.09
"20220829","1783","0037003000300068","7000",兆豐-三民,0,3,3,-1,0.65
"20220829","1783","9655","9600",富邦-板橋,5,0,5,1,1.09
"20220829","1783","003900380031006a","9800",元大-士林,0,3,3,-1,0.65
"20220830","1783","8440","8440",摩根大通,57,3,54,1,15.21
"20220830","1783","0037003000300064","7000",兆豐-彰化,0,10,10,-1,2.82
"20220830","1783","9268","9200",凱基-台北,77,24,53,1,14.93
"20220830","1783","9215","9200",凱基-高美館,0,8,8,-1,2.25
"20220830","1783","1470","1470",台灣摩根士丹利,14,0,14,1,3.94
"20220830","1783","0037003700390065","7790",國票-南科,0,7,7,-1,1.97
"20220830","1783","1560","1560",港商野村,14,0,14,1,3.94
"20220830","1783","0039003100380063","9100",群益金鼎-鳳山,0,7,7,-1,1.97
"20220830","1783","9659","9600",富邦-高雄,10,1,9,1,2.54
"20220830","1783","003700300030004a","7000",兆豐-公益,0,6,6,-1,1.69
"20220830","1783","1520","1520",瑞士信貸,7,0,7,1,1.97
"20220830","1783","003500390032006d","5920",元富-成功,0,5,5,-1,1.41
"20220830","1783","2187","2180",亞東-台中,6,0,6,1,1.69
"20220830","1783","0035003900320075","5920",元富-世貿,1,6,5,-1,1.41
"20220830","1783","1440","1440",美林,11,6,5,1,1.41
"20220830","1783","0037003000300063","7000",兆豐-民生,0,5,5,-1,1.41
"20220830","1783","0035003900320045","5920",元富-城中,5,0,5,1,1.41
"20220830","1783","9655","9600",富邦-板橋,0,5,5,-1,1.41
"20220830","1783","0037003700390050","7790",國票-九鼎,4,0,4,1,1.13
"20220830","1783","9815","9800",元大-大灣,0,5,5,-1,1.41
"20220830","1783","8848","8840",玉山-嘉義,2,0,2,1,0.56
"20220830","1783","0039003800330056","9800",元大-竹南,0,5,5,-1,1.41
"20220830","1783","9211","9200",凱基-台南,2,0,2,1,0.56
"20220830","1783","0039004100390066","9A00",永豐金-中盛,0,5,5,-1,1.41
"20220830","1783","9323","9300",華南永昌-小港,2,0,2,1,0.56
"20220830","1783","2181","2180",亞東-板橋,0,4,4,-1,1.13
"20220830","1783","0039003600310056","9600",富邦-板橋中山,2,0,2,1,0.56
"20220830","1783","7003","7000",兆豐-台中,0,4,4,-1,1.13
"20220831","1783","5854","5850",統一-城中,151,41,110,1,3.76
"20220831","1783","9623","9600",富邦-台北,3,56,53,-1,1.81
"20220831","1783","5850","5850",統一,102,3,99,1,3.38
"20220831","1783","1650","1650",新加坡商瑞銀,49,95,46,-1,1.57
"20220831","1783","9200","9200",凱基,90,0,90,1,3.07
"20220831","1783","8158","8150",台新-松江,0,40,40,-1,1.37
"20220831","1783","9658","9600",富邦-建國,90,7,83,1,2.83
"20220831","1783","9655","9600",富邦-板橋,32,72,40,-1,1.37
"20220831","1783","9100","9100",群益金鼎,83,0,83,1,2.83
"20220831","1783","9614","9600",富邦-基隆,0,39,39,-1,1.33
"20220831","1783","9268","9200",凱基-台北,183,133,50,1,1.71
"20220831","1783","0037003000300063","7000",兆豐-民生,4,40,36,-1,1.23
"20220831","1783","0035003900320072","5920",元富-城東,39,1,38,1,1.30
"20220831","1783","0035003900320065","5920",元富-古亭,1,32,31,-1,1.06
"20220831","1783","0035003800350055","5850",統一-南京,41,7,34,1,1.16
"20220831","1783","003900380039006a","9800",元大-樹林,1,31,30,-1,1.02
"20220831","1783","9300","9300",華南永昌,45,11,34,1,1.16
"20220831","1783","1470","1470",台灣摩根士丹利,0,28,28,-1,0.96
"20220831","1783","8440","8440",摩根大通,174,142,32,1,1.09
"20220831","1783","1560","1560",港商野村,12,39,27,-1,0.92
"20220831","1783","0037003000300048","7000",兆豐-東門,31,1,30,1,1.02
"20220831","1783","9296","9200",凱基-頭份,0,22,22,-1,0.75
"20220831","1783","0037003000300053","7000",兆豐-大同,30,0,30,1,1.02
"20220831","1783","9867","9800",元大-北成功,0,22,22,-1,0.75
"20220831","1783","9208","9200",凱基-桃園,24,2,22,1,0.75
"20220831","1783","9322","9300",華南永昌-公誠,14,35,21,-1,0.72
"20220831","1783","9135","9100",群益金鼎-東大,22,0,22,1,0.75
"20220831","1783","0039004100390045","9A00",永豐金-板橋,1,22,21,-1,0.72
"20220801","1783","1040","1040",臺銀,17,0,17,1,4.62
"20220801","1783","0039003800390044","9800",元大-左營,0,30,30,-1,8.15
"20220801","1783","0039003600310048","9600",富邦-新板,13,0,13,1,3.53
"20220801","1783","9229","9200",凱基-中山,0,21,21,-1,5.71
"20220801","1783","1480","1480",美商高盛,15,3,12,1,3.26
"20220801","1783","9268","9200",凱基-台北,14,35,21,-1,5.71
"20220801","1783","1030","1030",土銀,10,0,10,1,2.72
"20220801","1783","1650","1650",新加坡商瑞銀,12,31,19,-1,5.16
"20220801","1783","0037003000300077","7000",兆豐-新莊,10,0,10,1,2.72
"20220801","1783","0031003000320043","1020",合庫-自強,0,15,15,-1,4.08
"20220801","1783","8583","8580",聯邦-忠孝,10,0,10,1,2.72
"20220801","1783","8150","8150",台新證券,0,7,7,-1,1.90
"20220801","1783","0037003000300064","7000",兆豐-彰化,7,0,7,1,1.90
"20220801","1783","9239","9200",凱基-市政,3,10,7,-1,1.90
"20220801","1783","003700300030004a","7000",兆豐-公益,7,0,7,1,1.90
"20220801","1783","0039004100390048","9A00",永豐金-新莊,2,8,6,-1,1.63
"20220801","1783","8158","8150",台新-松江,7,0,7,1,1.90
"20220801","1783","003500330038006a","5380",第一金-安和,0,5,5,-1,1.36
"20220801","1783","0039003600310053","9600",富邦-景美,7,0,7,1,1.90
"20220801","1783","8440","8440",摩根大通,0,5,5,-1,1.36
"20220801","1783","8885","8880",國泰-桃園,5,0,5,1,1.36
"20220801","1783","5320","5320",高橋,1,5,4,-1,1.09
"20220801","1783","8152","8150",台新-新莊,5,0,5,1,1.36
"20220801","1783","003900310033004e","9100",群益金鼎-土城,0,4,4,-1,1.09
"20220801","1783","9872","9800",元大-復北,5,0,5,1,1.36
"20220801","1783","9677","9600",富邦-三重,0,4,4,-1,1.09
"20220801","1783","0031003000320046","1020",合庫-西台中,5,1,4,1,1.09
"20220801","1783","0039003800390059","9800",元大-基隆,0,4,4,-1,1.09
"20220802","1783","8885","8880",國泰-桃園,21,0,21,1,3.87
"20220802","1783","8884","8880",國泰-台南,1,40,39,-1,7.20
"20220802","1783","8158","8150",台新-松江,18,0,18,1,3.32
"20220802","1783","9658","9600",富邦-建國,0,20,20,-1,3.69
"20220802","1783","9239","9200",凱基-市政,14,0,14,1,2.58
"20220802","1783","9268","9200",凱基-台北,32,51,19,-1,3.51
"20220802","1783","1480","1480",美商高盛,21,8,13,1,2.40
"20220802","1783","0039004100380039","9A00",永豐金-敦北,0,13,13,-1,2.40
"20220802","1783","5858","5850",統一-嘉義,10,0,10,1,1.85
"20220802","1783","0039003800310041","9800",元大-鶯歌,0,12,12,-1,2.21
"20220802","1783","1650","1650",新加坡商瑞銀,30,20,10,1,1.85
"20220802","1783","0037003000300070","7000",兆豐-復興,0,10,10,-1,1.85
"20220802","1783","9892","9800",元大-屏東,10,0,10,1,1.85
"20220802","1783","003700370039005a","7790",國票-安和,0,10,10,-1,1.85
"20220802","1783","9215","9200",凱基-高美館,9,0,9,1,1.66
"20220802","1783","9208","9200",凱基-桃園,0,10,10,-1,1.85
"20220802","1783","9856","9800",元大-花蓮,10,1,9,1,1.66
"20220802","1783","6160","6160",中國信託,6,14,8,-1,1.48
"20220802","1783","0037003000300063","7000",兆豐-民生,7,0,7,1,1.29
"20220802","1783","003900410039006a","9A00",永豐金-嘉義,0,8,8,-1,1.48
"20220802","1783","0039003600310048","9600",富邦-新板,7,0,7,1,1.29
"20220802","1783","0039003800340048","9800",元大-景美,0,6,6,-1,1.11
"20220802","1783","0039003600310053","9600",富邦-景美,7,0,7,1,1.29
"20220802","1783","1440","1440",美林,6,12,6,-1,1.11
"20220802","1783","003700300030004a","7000",兆豐-公益,6,0,6,1,1.11
"20220802","1783","7008","7000",兆豐-三重,0,6,6,-1,1.11
"20220802","1783","9100","9100",群益金鼎,6,0,6,1,1.11
"20220802","1783","9686","9600",富邦-宜蘭,0,6,6,-1,1.11
"20220803","1783","8885","8880",國泰-桃園,31,10,21,1,3.90
"20220803","1783","0039003600310048","9600",富邦-新板,2,23,21,-1,3.90
"20220803","1783","0039003800310079","9800",元大-善化,20,0,20,1,3.72
"20220803","1783","8888","8880",國泰-敦南,7,26,19,-1,3.53
"20220803","1783","9879","9800",元大-板橋三民,20,0,20,1,3.72
"20220803","1783","9268","9200",凱基-台北,26,43,17,-1,3.16
"20220803","1783","9319","9300",華南永昌-鶯歌,15,0,15,1,2.79
"20220803","1783","0039004100390068","9A00",永豐金-台南,0,14,14,-1,2.60
"20220803","1783","0035003800350048","5850",統一-桃園,13,0,13,1,2.42
"20220803","1783","8882","8880",國泰-台中,0,12,12,-1,2.23
"20220803","1783","9239","9200",凱基-市政,13,0,13,1,2.42
"20220803","1783","9666","9600",富邦-南屯,0,11,11,-1,2.04
"20220803","1783","5858","5850",統一-嘉義,11,0,11,1,2.04
"20220803","1783","9800","9800",元大證券,4,14,10,-1,1.86
"20220803","1783","0035003300380049","5380",第一金-頭份,11,0,11,1,2.04
"20220803","1783","0036003300380041","6380",光和-嘉義,0,10,10,-1,1.86
"20220803","1783","1650","1650",新加坡商瑞銀,22,12,10,1,1.86
"20220803","1783","9854","9800",元大-文心興安,0,10,10,-1,1.86
"20220803","1783","8158","8150",台新-松江,10,0,10,1,1.86
"20220803","1783","003500320036004b","5260",美好-富順,1,10,9,-1,1.67
"20220803","1783","9205","9200",凱基-三重,10,1,9,1,1.67
"20220803","1783","0039003100380078","9100",群益金鼎-延平,0,8,8,-1,1.49
"20220803","1783","9215","9200",凱基-高美館,9,0,9,1,1.67
"20220803","1783","0039003200300046","9200",凱基-站前,0,8,8,-1,1.49
"20220803","1783","9302","9300",華南永昌-台中,15,6,9,1,1.67
"20220803","1783","9328","9300",華南永昌-潮州,0,8,8,-1,1.49
"20220803","1783","0039003800310044","9800",元大-南投,8,0,8,1,1.49
"20220803","1783","9300","9300",華南永昌,3,9,6,-1,1.12
"20220804","1783","6012","6010",(牛牛牛)亞-網路,15,0,15,1,5.24
"20220804","1783","9268","9200",凱基-台北,5,15,10,-1,3.50
"20220804","1783","003500380035004a","5850",統一-三重,11,0,11,1,3.85
"20220804","1783","9686","9600",富邦-宜蘭,0,10,10,-1,3.50
"20220804","1783","1030","1030",土銀,10,0,10,1,3.50
"20220804","1783","0038003400350044","8450",康和-板橋,0,9,9,-1,3.15
"20220804","1783","9239","9200",凱基-市政,7,0,7,1,2.45
"20220804","1783","1440","1440",美林,1,9,8,-1,2.80
"20220804","1783","0039003100330049","9100",群益金鼎-萬華,6,0,6,1,2.10
"20220804","1783","9319","9300",華南永昌-鶯歌,3,10,7,-1,2.45
"20220804","1783","0039003800370041","9800",元大-楊梅,9,3,6,1,2.10
"20220804","1783","9868","9800",元大-文心,0,7,7,-1,2.45
"20220804","1783","9893","9800",元大-大天母,6,0,6,1,2.10
"20220804","1783","5323","5320",高橋-內壢,0,4,4,-1,1.40
"20220804","1783","0035003900320072","5920",元富-城東,5,0,5,1,1.75
"20220804","1783","1650","1650",新加坡商瑞銀,7,11,4,-1,1.40
"20220804","1783","8150","8150",台新證券,6,1,5,1,1.75
"20220804","1783","8888","8880",國泰-敦南,1,5,4,-1,1.40
"20220804","1783","8560","8560",新光,6,1,5,1,1.75
"20220804","1783","0038003100350041","8150",台新-高雄,0,3,3,-1,1.05
"20220804","1783","9233","9200",凱基-長庚,5,0,5,1,1.75
"20220804","1783","0038003100350042","8150",台新-台中,0,3,3,-1,1.05
"20220804","1783","9362","9300",華南永昌-苗栗,5,0,5,1,1.75
"20220804","1783","0039003600320042","9600",富邦-二林,0,3,3,-1,1.05
"20220804","1783","003900380039006b","9800",元大-古亭,5,0,5,1,1.75
"20220804","1783","0039003800300068","9800",元大-台北,0,3,3,-1,1.05
"20220804","1783","0039004100390066","9A00",永豐金-中盛,5,0,5,1,1.75
"20220804","1783","0031003200360044","1260",宏遠-台南,0,2,2,-1,0.70
"20220805","1783","9268","9200",凱基-台北,22,8,14,1,6.33
"20220805","1783","003500380035004a","5850",統一-三重,0,21,21,-1,9.50
"20220805","1783","1440","1440",美林,14,1,13,1,5.88
"20220805","1783","1650","1650",新加坡商瑞銀,2,13,11,-1,4.98
"20220805","1783","0031003000320046","1020",合庫-西台中,10,0,10,1,4.52
"20220805","1783","7008","7000",兆豐-三重,0,11,11,-1,4.98
"20220805","1783","0039003100330067","9100",群益金鼎-三重,10,0,10,1,4.52
"20220805","1783","5927","5920",元富-林園,0,10,10,-1,4.52
"20220805","1783","8847","8840",玉山-台南,10,1,9,1,4.07
"20220805","1783","5265","5260",美好-苗栗,0,6,6,-1,2.71
"20220805","1783","1034","1030",土銀-嘉義,7,0,7,1,3.17
"20220805","1783","0035003800350048","5850",統一-桃園,0,5,5,-1,2.26
"20220805","1783","9239","9200",凱基-市政,6,0,6,1,2.71
"20220805","1783","9862","9800",元大-南京,0,5,5,-1,2.26
"20220805","1783","0039004100390058","9A00",永豐金-竹科,6,0,6,1,2.71
"20220805","1783","9893","9800",元大-大天母,0,5,5,-1,2.26
"20220805","1783","5856","5850",統一-台中,4,0,4,1,1.81
"20220805","1783","003900380039006b","9800",元大-古亭,0,5,5,-1,2.26
"20220805","1783","0039003600320048","9600",富邦-鳳山,4,0,4,1,1.81
"20220805","1783","1020","1020",合庫證券,0,4,4,-1,1.81
"20220805","1783","8440","8440",摩根大通,3,0,3,1,1.36
"20220805","1783","003500330038004e","5380",第一金-豐原,0,3,3,-1,1.36
"20220805","1783","9233","9200",凱基-長庚,4,1,3,1,1.36
"20220805","1783","003700370039007a","7790",國票-博愛,0,3,3,-1,1.36
"20220805","1783","0039003600310048","9600",富邦-新板,3,0,3,1,1.36
"20220805","1783","9896","9800",元大-台南,0,3,3,-1,1.36
"20220805","1783","0039003800330056","9800",元大-竹南,3,0,3,1,1.36
"20220805","1783","0039003800390047","9800",元大-大同,0,3,3,-1,1.36
"20220808","1783","1560","1560",港商野村,23,0,23,1,4.55
"20220808","1783","9322","9300",華南永昌-公誠,0,23,23,-1,4.55
"20220808","1783","1480","1480",美商高盛,34,15,19,1,3.76
"20220808","1783","9237","9200",凱基-敦北,0,20,20,-1,3.96
"20220808","1783","5856","5850",統一-台中,13,0,13,1,2.57
"20220808","1783","0039003800310065","9800",元大-佳里,0,18,18,-1,3.56
"20220808","1783","0039003800390049","9800",元大-蘆洲,13,0,13,1,2.57
"20220808","1783","0037003000300077","7000",兆豐-新莊,0,16,16,-1,3.17
"20220808","1783","6161","6160",中國信託-三重,12,1,11,1,2.18
"20220808","1783","6012","6010",(牛牛牛)亞-網路,0,15,15,-1,2.97
"20220808","1783","8560","8560",新光,10,0,10,1,1.98
"20220808","1783","8848","8840",玉山-嘉義,0,14,14,-1,2.77
"20220808","1783","5384","5380",第一金-台南,9,0,9,1,1.78
"20220808","1783","0037003000300063","7000",兆豐-民生,0,12,12,-1,2.38
"20220808","1783","003600310036004b","6160",中國信託-高雄,9,0,9,1,1.78
"20220808","1783","0035003300380044","5380",第一金-忠孝,0,11,11,-1,2.18
"20220808","1783","8150","8150",台新證券,11,2,9,1,1.78
"20220808","1783","6210","6210",新百王,0,10,10,-1,1.98
"20220808","1783","9205","9200",凱基-三重,9,0,9,1,1.78
"20220808","1783","8847","8840",玉山-台南,1,11,10,-1,1.98
"20220808","1783","0039003100330049","9100",群益金鼎-萬華,8,0,8,1,1.58
"20220808","1783","0039003100330067","9100",群益金鼎-三重,0,10,10,-1,1.98
"20220808","1783","9239","9200",凱基-市政,25,17,8,1,1.58
"20220808","1783","0039004100390067","9A00",永豐金-內湖,0,10,10,-1,1.98
"20220808","1783","9268","9200",凱基-台北,49,42,7,1,1.39
"20220808","1783","0035003800350049","5850",統一-員林,2,10,8,-1,1.58
"20220808","1783","9215","9200",凱基-高美館,7,1,6,1,1.19
"20220808","1783","9319","9300",華南永昌-鶯歌,0,8,8,-1,1.58
"20220809","1783","8440","8440",摩根大通,36,3,33,1,6.50
"20220809","1783","1033","1030",土銀-高雄,0,50,50,-1,9.84
"20220809","1783","9268","9200",凱基-台北,76,44,32,1,6.30
"20220809","1783","003500390032006c","5920",元富-大裕,0,26,26,-1,5.12
"20220809","1783","0035003300380043","5380",第一金-光復,30,0,30,1,5.91
"20220809","1783","0035003800350048","5850",統一-桃園,0,10,10,-1,1.97
"20220809","1783","1560","1560",港商野村,19,0,19,1,3.74
"20220809","1783","003600310036004b","6160",中國信託-高雄,2,12,10,-1,1.97
"20220809","1783","8158","8150",台新-松江,10,0,10,1,1.97
"20220809","1783","003900380039004c","9800",元大-成功,0,10,10,-1,1.97
"20220809","1783","9319","9300",華南永昌-鶯歌,10,0,10,1,1.97
"20220809","1783","5323","5320",高橋-內壢,0,7,7,-1,1.38
"20220809","1783","9322","9300",華南永昌-公誠,10,0,10,1,1.97
"20220809","1783","8152","8150",台新-新莊,0,5,5,-1,0.98
"20220809","1783","7003","7000",兆豐-台中,10,1,9,1,1.77
"20220809","1783","0035003800350046","5850",統一-彰化,0,3,3,-1,0.59
"20220809","1783","9600","9600",富邦證券,7,0,7,1,1.38
"20220809","1783","003500320036004b","5260",美好-富順,0,2,2,-1,0.39
"20220809","1783","0037003000300063","7000",兆豐-民生,6,0,6,1,1.18
"20220809","1783","003500380035004a","5850",統一-三重,0,2,2,-1,0.39
"20220809","1783","9235","9200",凱基-永華,6,0,6,1,1.18
"20220809","1783","0037003700390050","7790",國票-九鼎,0,2,2,-1,0.39
"20220809","1783","9627","9600",富邦-內湖,6,0,6,1,1.18
"20220809","1783","8885","8880",國泰-桃園,1,3,2,-1,0.39
"20220809","1783","0039003800330055","9800",元大-頭份,6,0,6,1,1.18
"20220809","1783","0039003800310067","9800",元大-大里,0,2,2,-1,0.39
"20220809","1783","5322","5320",高橋-中壢,5,0,5,1,0.98
"20220809","1783","003800380038004b","8880",國泰-板橋,1,2,1,-1,0.20
"20220810","1783","9278","9200",凱基-永康,26,0,26,1,11.66
"20220810","1783","9268","9200",凱基-台北,5,26,21,-1,9.42
"20220810","1783","8560","8560",新光,13,1,12,1,5.38
"20220810","1783","9302","9300",華南永昌-台中,0,15,15,-1,6.73
"20220810","1783","9239","9200",凱基-市政,12,0,12,1,5.38
"20220810","1783","003500330038006a","5380",第一金-安和,0,10,10,-1,4.48
"20220810","1783","0037003000300071","7000",兆豐-內湖,10,0,10,1,4.48
"20220810","1783","0037003000300043","7000",兆豐-來福,0,10,10,-1,4.48
"20220810","1783","9676","9600",富邦-仁愛,10,0,10,1,4.48
"20220810","1783","7003","7000",兆豐-台中,0,9,9,-1,4.04
"20220810","1783","003900380034004b","9800",元大-館前,10,0,10,1,4.48
"20220810","1783","9600","9600",富邦證券,0,7,7,-1,3.14
"20220810","1783","1560","1560",港商野村,5,0,5,1,2.24
"20220810","1783","0035003800350048","5850",統一-桃園,0,5,5,-1,2.24
"20220810","1783","8841","8840",玉山-雙和,5,0,5,1,2.24
"20220810","1783","0039003100380041","9100",群益金鼎-中壢,0,5,5,-1,2.24
"20220810","1783","9862","9800",元大-南京,5,0,5,1,2.24
"20220810","1783","9208","9200",凱基-桃園,0,5,5,-1,2.24
"20220810","1783","1650","1650",新加坡商瑞銀,4,0,4,1,1.79
"20220810","1783","0039003800330055","9800",元大-頭份,0,5,5,-1,2.24
"20220810","1783","003700370039006a","7790",國票-和平,3,0,3,1,1.35
"20220810","1783","5265","5260",美好-苗栗,0,4,4,-1,1.79
"20220810","1783","0039003600330041","9600",富邦-八德,3,0,3,1,1.35
"20220810","1783","0039003800300064","9800",元大-沙鹿,0,4,4,-1,1.79
"20220810","1783","1440","1440",美林,11,9,2,1,0.90
"20220810","1783","5323","5320",高橋-內壢,0,3,3,-1,1.35
"20220810","1783","0038003100350042","8150",台新-台中,2,0,2,1,0.90
"20220810","1783","0037003000300067","7000",兆豐-南門,6,9,3,-1,1.35
"20220811","1783","1480","1480",美商高盛,33,1,32,1,13.79
"20220811","1783","1440","1440",美林,2,20,18,-1,7.76
"20220811","1783","0039003100330067","9100",群益金鼎-三重,15,0,15,1,6.47
"20220811","1783","9268","9200",凱基-台北,16,30,14,-1,6.03
"20220811","1783","0035003300380043","5380",第一金-光復,11,0,11,1,4.74
"20220811","1783","0039003800390049","9800",元大-蘆洲,0,11,11,-1,4.74
"20220811","1783","0039003800330056","9800",元大-竹南,11,0,11,1,4.74
"20220811","1783","1650","1650",新加坡商瑞銀,1,11,10,-1,4.31
"20220811","1783","5856","5850",統一-台中,8,0,8,1,3.45
"20220811","1783","0037003000300077","7000",兆豐-新莊,0,8,8,-1,3.45
"20220811","1783","0039003800310046","9800",元大-福營,8,0,8,1,3.45
"20220811","1783","5921","5920",元富-高雄,0,6,6,-1,2.59
"20220811","1783","9239","9200",凱基-市政,9,2,7,1,3.02
"20220811","1783","0037003000300063","7000",兆豐-民生,2,8,6,-1,2.59
"20220811","1783","0039003800390055","9800",元大-大甲,5,0,5,1,2.16
"20220811","1783","8841","8840",玉山-雙和,0,5,5,-1,2.16
"20220811","1783","0039003100380063","9100",群益金鼎-鳳山,4,0,4,1,1.72
"20220811","1783","8884","8880",國泰-台南,0,5,5,-1,2.16
"20220811","1783","0035003300380049","5380",第一金-頭份,4,1,3,1,1.29
"20220811","1783","8886","8880",國泰-新莊,0,5,5,-1,2.16
"20220811","1783","1034","1030",土銀-嘉義,3,0,3,1,1.29
"20220811","1783","0039003100330049","9100",群益金鼎-萬華,0,5,5,-1,2.16
"20220811","1783","0037003700390056","7790",國票-天祥,3,0,3,1,1.29
"20220811","1783","003500330038006a","5380",第一金-安和,0,4,4,-1,1.72
"20220811","1783","8560","8560",新光,6,3,3,1,1.29
"20220811","1783","0039003800390044","9800",元大-左營,0,4,4,-1,1.72
"20220811","1783","0039003100330044","9100",群益金鼎-潭子,3,0,3,1,1.29
"20220811","1783","1560","1560",港商野村,0,3,3,-1,1.29
"20220812","1783","9268","9200",凱基-台北,35,12,23,1,9.83
"20220812","1783","0037003000300063","7000",兆豐-民生,0,16,16,-1,6.84
"20220812","1783","0039003800310047","9800",元大-彰化,20,0,20,1,8.55
"20220812","1783","0037003000300077","7000",兆豐-新莊,0,10,10,-1,4.27
"20220812","1783","1480","1480",美商高盛,10,2,8,1,3.42
"20220812","1783","5855","5850",統一-台南,0,8,8,-1,3.42
"20220812","1783","8440","8440",摩根大通,7,0,7,1,2.99
"20220812","1783","1040","1040",臺銀,0,7,7,-1,2.99
"20220812","1783","003900320030004e","9200",凱基-湖口,6,0,6,1,2.56
"20220812","1783","0039003800330056","9800",元大-竹南,0,6,6,-1,2.56
"20220812","1783","0035003300380043","5380",第一金-光復,5,0,5,1,2.14
"20220812","1783","5266","5260",美好-中壢,0,5,5,-1,2.14
"20220812","1783","0039003600320047","9600",富邦-斗六,5,1,4,1,1.71
"20220812","1783","8560","8560",新光,0,5,5,-1,2.14
"20220812","1783","8882","8880",國泰-台中,5,2,3,1,1.28
"20220812","1783","0039003600310048","9600",富邦-新板,0,5,5,-1,2.14
"20220812","1783","0035003300380049","5380",第一金-頭份,3,0,3,1,1.28
"20220812","1783","1440","1440",美林,2,6,4,-1,1.71
"20220812","1783","7003","7000",兆豐-台中,3,0,3,1,1.28
"20220812","1783","0035003800350048","5850",統一-桃園,0,4,4,-1,1.71
"20220812","1783","0039003100330044","9100",群益金鼎-潭子,3,0,3,1,1.28
"20220812","1783","9655","9600",富邦-板橋,0,4,4,-1,1.71
"20220812","1783","0039003600310043","9600",富邦-南京,3,0,3,1,1.28
"20220812","1783","1650","1650",新加坡商瑞銀,0,3,3,-1,1.28
"20220812","1783","0039003800300068","9800",元大-台北,3,0,3,1,1.28
"20220812","1783","1560","1560",港商野村,0,3,3,-1,1.28
"20220812","1783","0039004100390050","9A00",永豐金-竹北,3,0,3,1,1.28
"20220812","1783","5858","5850",統一-嘉義,0,3,3,-1,1.28
"20220815","1783","1480","1480",美商高盛,17,0,17,1,7.94
"20220815","1783","0039003100330067","9100",群益金鼎-三重,0,15,15,-1,7.01
"20220815","1783","0037003000300056","7000",兆豐-新竹,10,0,10,1,4.67
"20220815","1783","003600310036004b","6160",中國信託-高雄,0,10,10,-1,4.67
"20220815","1783","0039003800330056","9800",元大-竹南,10,0,10,1,4.67
"20220815","1783","0038003800340046","8840",玉山-桃園,0,10,10,-1,4.67
"20220815","1783","8440","8440",摩根大通,10,2,8,1,3.74
"20220815","1783","9235","9200",凱基-永華,0,6,6,-1,2.80
"20220815","1783","1034","1030",土銀-嘉義,7,0,7,1,3.27
"20220815","1783","9896","9800",元大-台南,0,6,6,-1,2.80
"20220815","1783","9268","9200",凱基-台北,22,15,7,1,3.27
"20220815","1783","8882","8880",國泰-台中,0,5,5,-1,2.34
"20220815","1783","8888","8880",國泰-敦南,5,0,5,1,2.34
"20220815","1783","1440","1440",美林,4,7,3,-1,1.40
"20220815","1783","9303","9300",華南永昌-高雄,5,0,5,1,2.34
"20220815","1783","5850","5850",統一,0,3,3,-1,1.40
"20220815","1783","9892","9800",元大-屏東,5,0,5,1,2.34
"20220815","1783","6161","6160",中國信託-三重,0,3,3,-1,1.40
"20220815","1783","1650","1650",新加坡商瑞銀,4,0,4,1,1.87
"20220815","1783","0035003300380046","5380",第一金-大稻埕,0,2,2,-1,0.93
"20220815","1783","0035003300380043","5380",第一金-光復,4,0,4,1,1.87
"20220815","1783","6385","6380",光和-花壇,0,2,2,-1,0.93
"20220815","1783","0036003100310041","6110",台中銀-豐原,4,0,4,1,1.87
"20220815","1783","003800340035004a","8450",康和-高雄,0,2,2,-1,0.93
"20220815","1783","003700300030004a","7000",兆豐-公益,4,0,4,1,1.87
"20220815","1783","0038003400350058","8450",康和-屏東,0,2,2,-1,0.93
"20220815","1783","9658","9600",富邦-建國,4,0,4,1,1.87
"20220815","1783","0039003200310045","9200",凱基-三峽,0,2,2,-1,0.93
"20220718","1783","0035003800350048","5850",統一-桃園,20,3,17,1,2.82
"20220718","1783","0037003700390050","7790",國票-九鼎,0,25,25,-1,4.15
"20220718","1783","9614","9600",富邦-基隆,15,0,15,1,2.49
"20220718","1783","003900360031004c","9600",富邦-士林,0,18,18,-1,2.99
"20220718","1783","8888","8880",國泰-敦南,17,6,11,1,1.83
"20220718","1783","9800","9800",元大證券,0,15,15,-1,2.49
"20220718","1783","1030","1030",土銀,10,0,10,1,1.66
"20220718","1783","8450","8450",康和,0,14,14,-1,2.33
"20220718","1783","5266","5260",美好-中壢,10,0,10,1,1.66
"20220718","1783","0039003100380045","9100",群益金鼎-南京,0,14,14,-1,2.33
"20220718","1783","0039003800310047","9800",元大-彰化,10,0,10,1,1.66
"20220718","1783","5855","5850",統一-台南,18,29,11,-1,1.83
"20220718","1783","6380","6380",光和,9,0,9,1,1.50
"20220718","1783","7790","7790",國票證券,0,10,10,-1,1.66
"20220718","1783","0038003800380041","8880",國泰-館前,10,2,8,1,1.33
"20220718","1783","1650","1650",新加坡商瑞銀,24,34,10,-1,1.66
"20220718","1783","9278","9200",凱基-永康,11,3,8,1,1.33
"20220718","1783","8840","8840",玉山證券,0,10,10,-1,1.66
"20220718","1783","0039004100390037","9A00",永豐金-新竹,8,0,8,1,1.33
"20220718","1783","0035003900320075","5920",元富-世貿,0,9,9,-1,1.50
"20220718","1783","003500390032007a","5920",元富-文心,6,0,6,1,1.00
"20220718","1783","003700300030004a","7000",兆豐-公益,1,10,9,-1,1.50
"20220718","1783","0037003000300067","7000",兆豐-南門,10,4,6,1,1.00
"20220718","1783","0039003800390064","9800",元大-北屯,1,10,9,-1,1.50
"20220718","1783","8849","8840",玉山-景美,6,0,6,1,1.00
"20220718","1783","9266","9200",凱基-新豐,0,8,8,-1,1.33
"20220718","1783","0039003600310043","9600",富邦-南京,6,0,6,1,1.00
"20220718","1783","8440","8440",摩根大通,2,9,7,-1,1.16
"20220719","1783","003700300030004a","7000",兆豐-公益,13,0,13,1,1.82
"20220719","1783","9302","9300",華南永昌-台中,1,15,14,-1,1.96
"20220719","1783","1043","1040",臺銀-民權,10,0,10,1,1.40
"20220719","1783","0039003200320048","9200",凱基-復興,0,14,14,-1,1.96
"20220719","1783","9204","9200",凱基-台中,12,2,10,1,1.40
"20220719","1783","0037003000300070","7000",兆豐-復興,2,13,11,-1,1.54
"20220719","1783","9235","9200",凱基-永華,10,0,10,1,1.40
"20220719","1783","0039003800310061","9800",元大-歸仁,0,11,11,-1,1.54
"20220719","1783","003900410039004c","9A00",永豐金-台中,10,0,10,1,1.40
"20220719","1783","1028","1020",合庫-彰化,0,10,10,-1,1.40
"20220719","1783","8440","8440",摩根大通,19,12,7,1,0.98
"20220719","1783","7007","7000",兆豐-竹北,2,12,10,-1,1.40
"20220719","1783","9600","9600",富邦證券,7,0,7,1,0.98
"20220719","1783","0039003100380050","9100",群益金鼎-天母,0,10,10,-1,1.40
"20220719","1783","5854","5850",統一-城中,6,0,6,1,0.84
"20220719","1783","9834","9800",元大-中壢,5,14,9,-1,1.26
"20220719","1783","9858","9800",元大-龍潭,6,0,6,1,0.84
"20220719","1783","0035003800350048","5850",統一-桃園,14,22,8,-1,1.12
"20220719","1783","5050","5050",大展,5,0,5,1,0.70
"20220719","1783","1650","1650",新加坡商瑞銀,13,20,7,-1,0.98
"20220719","1783","003600310036004b","6160",中國信託-高雄,9,4,5,1,0.70
"20220719","1783","8849","8840",玉山-景美,0,6,6,-1,0.84
"20220719","1783","0038003400350053","8450",康和-南崁,5,0,5,1,0.70
"20220719","1783","5058","5050",大展-台南,0,5,5,-1,0.70
"20220719","1783","8888","8880",國泰-敦南,20,15,5,1,0.70
"20220719","1783","003700370039006a","7790",國票-和平,0,5,5,-1,0.70
"20220719","1783","9801","9800",元大-城東,5,0,5,1,0.70
"20220719","1783","0039003800390047","9800",元大-大同,1,6,5,-1,0.70
"20220720","1783","9614","9600",富邦-基隆,20,0,20,1,3.91
"20220720","1783","0038003800380041","8880",國泰-館前,0,12,12,-1,2.34
"20220720","1783","1650","1650",新加坡商瑞銀,23,8,15,1,2.93
"20220720","1783","003900410039004c","9A00",永豐金-台中,0,11,11,-1,2.15
"20220720","1783","0035003800350048","5850",統一-桃園,15,0,15,1,2.93
"20220720","1783","9235","9200",凱基-永華,0,10,10,-1,1.95
"20220720","1783","8158","8150",台新-松江,10,0,10,1,1.95
"20220720","1783","0039003800310072","9800",元大-屏南,0,10,10,-1,1.95
"20220720","1783","8583","8580",聯邦-忠孝,10,0,10,1,1.95
"20220720","1783","9834","9800",元大-中壢,2,12,10,-1,1.95
"20220720","1783","9879","9800",元大-板橋三民,10,0,10,1,1.95
"20220720","1783","8847","8840",玉山-台南,1,10,9,-1,1.76
"20220720","1783","7750","7750",北城證券,10,2,8,1,1.56
"20220720","1783","0039003100330044","9100",群益金鼎-潭子,0,9,9,-1,1.76
"20220720","1783","8885","8880",國泰-桃園,8,0,8,1,1.56
"20220720","1783","0038003100350041","8150",台新-高雄,1,9,8,-1,1.56
"20220720","1783","0039003600310043","9600",富邦-南京,7,0,7,1,1.37
"20220720","1783","9863","9800",元大-和平,0,7,7,-1,1.37
"20220720","1783","0039003600350055","9600",富邦-彰化,7,0,7,1,1.37
"20220720","1783","1470","1470",台灣摩根士丹利,7,13,6,-1,1.17
"20220720","1783","0039004100390037","9A00",永豐金-新竹,7,0,7,1,1.37
"20220720","1783","9308","9300",華南永昌-麻豆,0,6,6,-1,1.17
"20220720","1783","8882","8880",國泰-台中,8,2,6,1,1.17
"20220720","1783","0039003800320043","9800",元大-六合,0,6,6,-1,1.17
"20220720","1783","0037003000300071","7000",兆豐-內湖,6,0,6,1,1.17
"20220720","1783","9868","9800",元大-文心,0,6,6,-1,1.17
"20220720","1783","5058","5050",大展-台南,5,0,5,1,0.98
"20220720","1783","0039004100380039","9A00",永豐金-敦北,0,6,6,-1,1.17
"20220721","1783","9239","9200",凱基-市政,25,0,25,1,7.02
"20220721","1783","9838","9800",元大-豐原,0,11,11,-1,3.09
"20220721","1783","1470","1470",台灣摩根士丹利,23,4,19,1,5.34
"20220721","1783","003100320036004c","1260",宏遠-台中,0,10,10,-1,2.81
"20220721","1783","0039004100390042","9A00",永豐金-中和,10,0,10,1,2.81
"20220721","1783","8711","8710",陽信-石牌,0,10,10,-1,2.81
"20220721","1783","8440","8440",摩根大通,11,2,9,1,2.53
"20220721","1783","9359","9300",華南永昌-中正,0,10,10,-1,2.81
"20220721","1783","9266","9200",凱基-新豐,7,0,7,1,1.97
"20220721","1783","9315","9300",華南永昌-苑裡,0,8,8,-1,2.25
"20220721","1783","0039003600310053","9600",富邦-景美,7,0,7,1,1.97
"20220721","1783","003900380039004e","9800",元大-內湖,1,9,8,-1,2.25
"20220721","1783","9889","9800",元大-員林,7,0,7,1,1.97
"20220721","1783","003900310038004d","9100",群益金鼎-嘉義,0,7,7,-1,1.97
"20220721","1783","1560","1560",港商野村,6,0,6,1,1.69
"20220721","1783","8560","8560",新光,3,9,6,-1,1.69
"20220721","1783","003600310036004b","6160",中國信託-高雄,8,2,6,1,1.69
"20220721","1783","9211","9200",凱基-台南,0,6,6,-1,1.69
"20220721","1783","0039003100300044","9100",群益金鼎-大興,6,0,6,1,1.69
"20220721","1783","9676","9600",富邦-仁愛,4,10,6,-1,1.69
"20220721","1783","0037003000300077","7000",兆豐-新莊,5,0,5,1,1.40
"20220721","1783","0031003000340041","1040",臺銀-臺中,0,5,5,-1,1.40
"20220721","1783","9209","9200",凱基-岡山,5,0,5,1,1.40
"20220721","1783","5058","5050",大展-台南,0,5,5,-1,1.40
"20220721","1783","9322","9300",華南永昌-公誠,5,0,5,1,1.40
"20220721","1783","8848","8840",玉山-嘉義,0,5,5,-1,1.40
"20220721","1783","9604","9600",富邦-陽明,5,0,5,1,1.40
"20220721","1783","003900310038004b","9100",群益金鼎-東湖,0,5,5,-1,1.40
"20220722","1783","0037003000300067","7000",兆豐-南門,31,6,25,1,3.04
"20220722","1783","0039003600310043","9600",富邦-南京,0,29,29,-1,3.53
"20220722","1783","1560","1560",港商野村,25,2,23,1,2.80
"20220722","1783","9208","9200",凱基-桃園,2,26,24,-1,2.92
"20220722","1783","5855","5850",統一-台南,24,10,14,1,1.70
"20220722","1783","0035003800350048","5850",統一-桃園,4,27,23,-1,2.80
"20220722","1783","9858","9800",元大-龍潭,11,0,11,1,1.34
"20220722","1783","8888","8880",國泰-敦南,6,20,14,-1,1.70
"20220722","1783","8159","8150",台新-台南,11,0,11,1,1.34
"20220722","1783","9268","9200",凱基-台北,51,64,13,-1,1.58
"20220722","1783","0039003600310052","9600",富邦-南員林,10,0,10,1,1.22
"20220722","1783","7798","7790",國票-內壢,0,10,10,-1,1.22
"20220722","1783","9676","9600",富邦-仁愛,11,1,10,1,1.22
"20220722","1783","0039004100390042","9A00",永豐金-中和,0,10,10,-1,1.22
"20220722","1783","0039003800310043","9800",元大-路竹,10,0,10,1,1.22
"20220722","1783","9226","9200",凱基-汐止,0,9,9,-1,1.09
"20220722","1783","0039003800310053","9800",元大-崇德,10,0,10,1,1.22
"20220722","1783","9239","9200",凱基-市政,1,10,9,-1,1.09
"20220722","1783","9302","9300",華南永昌-台中,10,1,9,1,1.09
"20220722","1783","9636","9600",富邦-中壢,0,8,8,-1,0.97
"20220722","1783","0035003800350049","5850",統一-員林,9,1,8,1,0.97
"20220722","1783","9889","9800",元大-員林,5,12,7,-1,0.85
"20220722","1783","1650","1650",新加坡商瑞銀,44,37,7,1,0.85
"20220722","1783","5266","5260",美好-中壢,0,6,6,-1,0.73
"20220722","1783","1480","1480",美商高盛,6,0,6,1,0.73
"20220722","1783","5603","5600",永興-台中,0,6,6,-1,0.73
"20220722","1783","8882","8880",國泰-台中,12,6,6,1,0.73
"20220722","1783","0039003600310048","9600",富邦-新板,1,7,6,-1,0.73
"20220725","1783","9623","9600",富邦-台北,67,12,55,1,1.31
"20220725","1783","9204","9200",凱基-台中,9,106,97,-1,2.31
"20220725","1783","9268","9200",凱基-台北,333,284,49,1,1.17
"20220725","1783","9614","9600",富邦-基隆,8,53,45,-1,1.07
"20220725","1783","0039003800390044","9800",元大-左營,43,1,42,1,1.00
"20220725","1783","5854","5850",統一-城中,30,63,33,-1,0.79
"20220725","1783","9658","9600",富邦-建國,74,39,35,1,0.83
"20220725","1783","9208","9200",凱基-桃園,12,42,30,-1,0.72
"20220725","1783","5382","5380",第一金-台中,36,6,30,1,0.72
"20220725","1783","1560","1560",港商野村,17,46,29,-1,0.69
"20220725","1783","6464","6460",大昌-新店,34,5,29,1,0.69
"20220725","1783","8440","8440",摩根大通,107,136,29,-1,0.69
"20220725","1783","0039003600310057","9600",富邦-東花蓮,30,1,29,1,0.69
"20220725","1783","9278","9200",凱基-永康,0,26,26,-1,0.62
"20220725","1783","9200","9200",凱基,23,0,23,1,0.55
"20220725","1783","9296","9200",凱基-頭份,0,22,22,-1,0.52
"20220725","1783","0039003800390051","9800",元大-汐止,23,0,23,1,0.55
"20220725","1783","8560","8560",新光,47,68,21,-1,0.50
"20220725","1783","9138","9100",群益金鼎-中港,22,1,21,1,0.50
"20220725","1783","5058","5050",大展-台南,1,21,20,-1,0.48
"20220725","1783","8888","8880",國泰-敦南,74,53,21,1,0.50
"20220725","1783","0035003900320065","5920",元富-古亭,0,20,20,-1,0.48
"20220725","1783","0037003700390075","7790",國票-長城,25,5,20,1,0.48
"20220725","1783","9873","9800",元大-西門,0,19,19,-1,0.45
"20220725","1783","8884","8880",國泰-台南,28,8,20,1,0.48
"20220725","1783","9854","9800",元大-文心興安,3,21,18,-1,0.43
"20220725","1783","5850","5850",統一,26,7,19,1,0.45
"20220725","1783","0039004100390037","9A00",永豐金-新竹,0,18,18,-1,0.43
"20220726","1783","9200","9200",凱基,45,0,45,1,2.26
"20220726","1783","6464","6460",大昌-新店,2,36,34,-1,1.70
"20220726","1783","9100","9100",群益金鼎,41,0,41,1,2.06
"20220726","1783","5382","5380",第一金-台中,0,30,30,-1,1.50
"20220726","1783","6380","6380",光和,23,0,23,1,1.15
"20220726","1783","8440","8440",摩根大通,14,40,26,-1,1.30
"20220726","1783","9296","9200",凱基-頭份,24,2,22,1,1.10
"20220726","1783","6161","6160",中國信託-三重,0,25,25,-1,1.25
"20220726","1783","9229","9200",凱基-中山,21,1,20,1,1.00
"20220726","1783","6164","6160",中國信託-文心,3,26,23,-1,1.15
"20220726","1783","8884","8880",國泰-台南,19,1,18,1,0.90
"20220726","1783","9614","9600",富邦-基隆,0,23,23,-1,1.15
"20220726","1783","0039003600330041","9600",富邦-八德,18,1,17,1,0.85
"20220726","1783","0039003800390051","9800",元大-汐止,0,23,23,-1,1.15
"20220726","1783","9815","9800",元大-大灣,13,0,13,1,0.65
"20220726","1783","5850","5850",統一,1,23,22,-1,1.10
"20220726","1783","0035003900320072","5920",元富-城東,12,1,11,1,0.55
"20220726","1783","1480","1480",美商高盛,0,20,20,-1,1.00
"20220726","1783","0039003800300064","9800",元大-沙鹿,15,4,11,1,0.55
"20220726","1783","9366","9300",華南永昌-豐原,0,20,20,-1,1.00
"20220726","1783","1040","1040",臺銀,10,0,10,1,0.50
"20220726","1783","8158","8150",台新-松江,29,46,17,-1,0.85
"20220726","1783","5322","5320",高橋-中壢,10,0,10,1,0.50
"20220726","1783","8711","8710",陽信-石牌,0,15,15,-1,0.75
"20220726","1783","5323","5320",高橋-內壢,10,0,10,1,0.50
"20220726","1783","0039003600310057","9600",富邦-東花蓮,0,14,14,-1,0.70
"20220726","1783","0038003800340046","8840",玉山-桃園,10,0,10,1,0.50
"20220726","1783","9268","9200",凱基-台北,130,143,13,-1,0.65
"20220727","1783","9239","9200",凱基-市政,29,2,27,1,4.43
"20220727","1783","0039003800330069","9800",元大-大雅,0,15,15,-1,2.46
"20220727","1783","5855","5850",統一-台南,26,0,26,1,4.27
"20220727","1783","1650","1650",新加坡商瑞銀,26,40,14,-1,2.30
"20220727","1783","0039004100390037","9A00",永豐金-新竹,36,17,19,1,3.12
"20220727","1783","8158","8150",台新-松江,0,13,13,-1,2.13
"20220727","1783","8560","8560",新光,15,1,14,1,2.30
"20220727","1783","003900310038004c","9100",群益金鼎-建成,0,12,12,-1,1.97
"20220727","1783","9278","9200",凱基-永康,11,0,11,1,1.81
"20220727","1783","9302","9300",華南永昌-台中,1,13,12,-1,1.97
"20220727","1783","6210","6210",新百王,11,1,10,1,1.64
"20220727","1783","1028","1020",合庫-彰化,0,10,10,-1,1.64
"20220727","1783","9854","9800",元大-文心興安,10,0,10,1,1.64
"20220727","1783","0037003000300048","7000",兆豐-東門,0,10,10,-1,1.64
"20220727","1783","003900410039004c","9A00",永豐金-台中,10,1,9,1,1.48
"20220727","1783","0039003800310047","9800",元大-彰化,0,10,10,-1,1.64
"20220727","1783","8882","8880",國泰-台中,7,0,7,1,1.15
"20220727","1783","9872","9800",元大-復北,4,14,10,-1,1.64
"20220727","1783","003700300030004e","7000",兆豐-埔墘,7,0,7,1,1.15
"20220727","1783","5266","5260",美好-中壢,0,9,9,-1,1.48
"20220727","1783","0035003800350048","5850",統一-桃園,8,2,6,1,0.99
"20220727","1783","0039003800310043","9800",元大-路竹,1,10,9,-1,1.48
"20220727","1783","7750","7750",北城證券,6,0,6,1,0.99
"20220727","1783","9604","9600",富邦-陽明,1,9,8,-1,1.31
"20220727","1783","0039003800310079","9800",元大-善化,7,1,6,1,0.99
"20220727","1783","003900410039005a","9A00",永豐金-復興,0,8,8,-1,1.31
"20220727","1783","1440","1440",美林,12,7,5,1,0.82
"20220727","1783","9659","9600",富邦-高雄,0,7,7,-1,1.15
"20220728","1783","003900380031006a","9800",元大-士林,15,0,15,1,4.08
"20220728","1783","0035003300380050","5380",第一金-路竹,0,10,10,-1,2.72
"20220728","1783","9278","9200",凱基-永康,14,0,14,1,3.80
"20220728","1783","8440","8440",摩根大通,8,18,10,-1,2.72
"20220728","1783","9239","9200",凱基-市政,19,8,11,1,2.99
"20220728","1783","0039003600310050","9600",富邦-和美,0,10,10,-1,2.72
"20220728","1783","9676","9600",富邦-仁愛,6,0,6,1,1.63
"20220728","1783","0039004100390032","9A00",永豐金-萬盛,0,7,7,-1,1.90
"20220728","1783","0031003100310045","1110",台灣企銀-桃園,5,0,5,1,1.36
"20220728","1783","0035003900320072","5920",元富-城東,0,5,5,-1,1.36
"20220728","1783","9207","9200",凱基-永和,5,0,5,1,1.36
"20220728","1783","8158","8150",台新-松江,0,5,5,-1,1.36
"20220728","1783","9302","9300",華南永昌-台中,11,6,5,1,1.36
"20220728","1783","8888","8880",國泰-敦南,4,9,5,-1,1.36
"20220728","1783","9692","9600",富邦-嘉義,5,0,5,1,1.36
"20220728","1783","0039003100330044","9100",群益金鼎-潭子,0,5,5,-1,1.36
"20220728","1783","0039003800390059","9800",元大-基隆,4,0,4,1,1.09
"20220728","1783","003900380031006e","9800",元大-旗山,0,5,5,-1,1.36
"20220728","1783","1034","1030",土銀-嘉義,3,0,3,1,0.82
"20220728","1783","0039003800330056","9800",元大-竹南,0,5,5,-1,1.36
"20220728","1783","0037003000300067","7000",兆豐-南門,7,4,3,1,0.82
"20220728","1783","1440","1440",美林,2,6,4,-1,1.09
"20220728","1783","9322","9300",華南永昌-公誠,4,1,3,1,0.82
"20220728","1783","0035003900320044","5920",元富-大昌,0,4,4,-1,1.09
"20220728","1783","0039003600310043","9600",富邦-南京,3,0,3,1,0.82
"20220728","1783","003900360032004b","9600",富邦-中和,0,4,4,-1,1.09
"20220728","1783","0039003800310046","9800",元大-福營,3,0,3,1,0.82
"20220728","1783","9856","9800",元大-花蓮,0,4,4,-1,1.09
"20220729","1783","0037003000300063","7000",兆豐-民生,23,0,23,1,5.78
"20220729","1783","9208","9200",凱基-桃園,4,20,16,-1,4.02
"20220729","1783","1650","1650",新加坡商瑞銀,25,9,16,1,4.02
"20220729","1783","003900380031006a","9800",元大-士林,0,14,14,-1,3.52
"20220729","1783","0035003800350059","5850",統一-土城,11,0,11,1,2.76
"20220729","1783","9831","9800",元大-四維,2,14,12,-1,3.02
"20220729","1783","1440","1440",美林,10,0,10,1,2.51
"20220729","1783","9867","9800",元大-北成功,0,10,10,-1,2.51
"20220729","1783","5921","5920",元富-高雄,8,0,8,1,2.01
"20220729","1783","9105","9100",群益金鼎-高盛,0,8,8,-1,2.01
"20220729","1783","6160","6160",中國信託,18,10,8,1,2.01
"20220729","1783","0039003800300064","9800",元大-沙鹿,0,8,8,-1,2.01
"20220729","1783","9386","9300",華南永昌-東昇,8,0,8,1,2.01
"20220729","1783","0031003100310047","1110",台灣企銀-埔墘,0,5,5,-1,1.26
"20220729","1783","9676","9600",富邦-仁愛,7,0,7,1,1.76
"20220729","1783","0035003800350041","5850",統一-基隆,0,5,5,-1,1.26
"20220729","1783","0037003000300064","7000",兆豐-彰化,6,0,6,1,1.51
"20220729","1783","8882","8880",國泰-台中,0,5,5,-1,1.26
"20220729","1783","5603","5600",永興-台中,5,0,5,1,1.26
"20220729","1783","8888","8880",國泰-敦南,3,8,5,-1,1.26
"20220729","1783","9239","9200",凱基-市政,12,7,5,1,1.26
"20220729","1783","0039003200310045","9200",凱基-三峽,0,5,5,-1,1.26
"20220729","1783","9604","9600",富邦-陽明,5,0,5,1,1.26
"20220729","1783","9289","9200",凱基-興隆,0,5,5,-1,1.26
"20220729","1783","003900380031005a","9800",元大-潮州,5,0,5,1,1.26
"20220729","1783","9302","9300",華南永昌-台中,0,5,5,-1,1.26
"20220729","1783","9896","9800",元大-台南,4,0,4,1,1.01
"20220729","1783","9661","9600",富邦-新店,0,5,5,-1,1.26
"20220701","1783","8560","8560",新光,145,58,87,1,1.31
"20220701","1783","8440","8440",摩根大通,201,333,132,-1,1.99
"20220701","1783","0035003800350063","5850",統一-仁愛,65,5,60,1,0.90
"20220701","1783","9268","9200",凱基-台北,371,478,107,-1,1.61
"20220701","1783","9363","9300",華南永昌-彰化,53,5,48,1,0.72
"20220701","1783","0039003600310057","9600",富邦-東花蓮,2,71,69,-1,1.04
"20220701","1783","0039003100380065","9100",群益金鼎-大安,50,10,40,1,0.60
"20220701","1783","9676","9600",富邦-仁愛,4,65,61,-1,0.92
"20220701","1783","9208","9200",凱基-桃園,46,7,39,1,0.59
"20220701","1783","1480","1480",美商高盛,13,56,43,-1,0.65
"20220701","1783","0039003800310072","9800",元大-屏南,49,10,39,1,0.59
"20220701","1783","9863","9800",元大-和平,2,44,42,-1,0.63
"20220701","1783","0039004100390078","9A00",永豐金-桃園,52,14,38,1,0.57
"20220701","1783","9621","9600",富邦-花蓮,60,95,35,-1,0.53
"20220701","1783","0039003200300041","9200",凱基-板橋,40,3,37,1,0.56
"20220701","1783","0037003000300046","7000",兆豐-虎尾,0,27,27,-1,0.41
"20220701","1783","0031003000330046","1030",土銀-南港,35,0,35,1,0.53
"20220701","1783","9227","9200",凱基-城中,3,26,23,-1,0.35
"20220701","1783","9856","9800",元大-花蓮,86,53,33,1,0.50
"20220701","1783","9800","9800",元大證券,45,66,21,-1,0.32
"20220701","1783","1117","1110",台灣企銀-竹北,30,0,30,1,0.45
"20220701","1783","0035003800350062","5850",統一-內湖,0,21,21,-1,0.32
"20220701","1783","6385","6380",光和-花壇,30,0,30,1,0.45
"20220701","1783","0038003100350053","8150",台新-中壢,9,30,21,-1,0.32
"20220701","1783","0035003300380043","5380",第一金-光復,37,9,28,1,0.42
"20220701","1783","9347","9300",華南永昌-敦南,30,51,21,-1,0.32
"20220701","1783","8157","8150",台新-左楠,30,2,28,1,0.42
"20220701","1783","5854","5850",統一-城中,3,23,20,-1,0.30
"20220704","1783","0035003300380043","5380",第一金-光復,133,5,128,1,5.00
"20220704","1783","0035003800350063","5850",統一-仁愛,5,65,60,-1,2.34
"20220704","1783","9614","9600",富邦-基隆,90,1,89,1,3.48
"20220704","1783","0039003100380065","9100",群益金鼎-大安,0,50,50,-1,1.95
"20220704","1783","9800","9800",元大證券,102,23,79,1,3.09
"20220704","1783","9363","9300",華南永昌-彰化,0,40,40,-1,1.56
"20220704","1783","9268","9200",凱基-台北,226,163,63,1,2.46
"20220704","1783","8157","8150",台新-左楠,1,28,27,-1,1.06
"20220704","1783","9283","9200",凱基-北門,55,0,55,1,2.15
"20220704","1783","9871","9800",元大-忠孝,0,27,27,-1,1.06
"20220704","1783","9204","9200",凱基-台中,51,0,51,1,1.99
"20220704","1783","0039004100380046","9A00",永豐金-敦南,16,43,27,-1,1.06
"20220704","1783","1650","1650",新加坡商瑞銀,94,65,29,1,1.13
"20220704","1783","0037003000300068","7000",兆豐-三民,2,28,26,-1,1.02
"20220704","1783","5384","5380",第一金-台南,30,7,23,1,0.90
"20220704","1783","0037003700390050","7790",國票-九鼎,0,26,26,-1,1.02
"20220704","1783","8440","8440",摩根大通,85,64,21,1,0.82
"20220704","1783","0036003000310064","6010",(牛牛牛)亞-鑫豐,1,23,22,-1,0.86
"20220704","1783","9208","9200",凱基-桃園,33,13,20,1,0.78
"20220704","1783","0039004100390078","9A00",永豐金-桃園,19,41,22,-1,0.86
"20220704","1783","0037003000300048","7000",兆豐-東門,44,29,15,1,0.59
"20220704","1783","003600310036004b","6160",中國信託-高雄,4,24,20,-1,0.78
"20220704","1783","9300","9300",華南永昌,16,2,14,1,0.55
"20220704","1783","7000","7000",兆豐證券,0,20,20,-1,0.78
"20220704","1783","1480","1480",美商高盛,28,15,13,1,0.51
"20220704","1783","0039003200300041","9200",凱基-板橋,0,20,20,-1,0.78
"20220704","1783","8848","8840",玉山-嘉義,17,5,12,1,0.47
"20220704","1783","0039003800390055","9800",元大-大甲,0,20,20,-1,0.78
"20220705","1783","9204","9200",凱基-台中,34,0,34,1,2.69
"20220705","1783","1650","1650",新加坡商瑞銀,29,85,56,-1,4.43
"20220705","1783","0039003100380065","9100",群益金鼎-大安,30,0,30,1,2.37
"20220705","1783","8440","8440",摩根大通,40,92,52,-1,4.11
"20220705","1783","1470","1470",台灣摩根士丹利,41,12,29,1,2.29
"20220705","1783","0031003000330046","1030",土銀-南港,0,26,26,-1,2.06
"20220705","1783","5850","5850",統一,41,17,24,1,1.90
"20220705","1783","1023","1020",合庫-高雄,0,26,26,-1,2.06
"20220705","1783","0035003900320043","5920",元富-潮州,22,2,20,1,1.58
"20220705","1783","9800","9800",元大證券,8,34,26,-1,2.06
"20220705","1783","9614","9600",富邦-基隆,20,0,20,1,1.58
"20220705","1783","1480","1480",美商高盛,0,23,23,-1,1.82
"20220705","1783","8158","8150",台新-松江,19,0,19,1,1.50
"20220705","1783","0036003300380041","6380",光和-嘉義,0,20,20,-1,1.58
"20220705","1783","8560","8560",新光,25,9,16,1,1.27
"20220705","1783","9208","9200",凱基-桃園,0,20,20,-1,1.58
"20220705","1783","0039003800390049","9800",元大-蘆洲,20,5,15,1,1.19
"20220705","1783","0039004100390078","9A00",永豐金-桃園,0,20,20,-1,1.58
"20220705","1783","9268","9200",凱基-台北,72,57,15,1,1.19
"20220705","1783","1560","1560",港商野村,10,29,19,-1,1.50
"20220705","1783","5855","5850",統一-台南,14,2,12,1,0.95
"20220705","1783","9878","9800",元大-金華,0,16,16,-1,1.27
"20220705","1783","9322","9300",華南永昌-公誠,16,4,12,1,0.95
"20220705","1783","9317","9300",華南永昌-林口,0,13,13,-1,1.03
"20220705","1783","0039003100330067","9100",群益金鼎-三重,11,0,11,1,0.87
"20220705","1783","9677","9600",富邦-三重,2,14,12,-1,0.95
"20220705","1783","1117","1110",台灣企銀-竹北,10,0,10,1,0.79
"20220705","1783","9366","9300",華南永昌-豐原,0,10,10,-1,0.79
"20220706","1783","9614","9600",富邦-基隆,40,0,40,1,1.60
"20220706","1783","9871","9800",元大-忠孝,0,38,38,-1,1.52
"20220706","1783","5855","5850",統一-台南,32,0,32,1,1.28
"20220706","1783","1470","1470",台灣摩根士丹利,0,29,29,-1,1.16
"20220706","1783","5382","5380",第一金-台中,30,0,30,1,1.20
"20220706","1783","003900380039004c","9800",元大-成功,2,28,26,-1,1.04
"20220706","1783","0038003100350041","8150",台新-高雄,45,19,26,1,1.04
"20220706","1783","5850","5850",統一,4,29,25,-1,1.00
"20220706","1783","6161","6160",中國信託-三重,45,25,20,1,0.80
"20220706","1783","0039003100380065","9100",群益金鼎-大安,10,30,20,-1,0.80
"20220706","1783","0039003600320042","9600",富邦-二林,20,0,20,1,0.80
"20220706","1783","0039003200300041","9200",凱基-板橋,0,20,20,-1,0.80
"20220706","1783","0037003000300067","7000",兆豐-南門,20,1,19,1,0.76
"20220706","1783","9268","9200",凱基-台北,168,188,20,-1,0.80
"20220706","1783","0039003600310057","9600",富邦-東花蓮,17,0,17,1,0.68
"20220706","1783","8440","8440",摩根大通,78,97,19,-1,0.76
"20220706","1783","0035003300380043","5380",第一金-光復,16,0,16,1,0.64
"20220706","1783","9300","9300",華南永昌,5,22,17,-1,0.68
"20220706","1783","0039003800300043","9800",元大-斗六,16,0,16,1,0.64
"20220706","1783","0038003800380041","8880",國泰-館前,0,16,16,-1,0.64
"20220706","1783","9878","9800",元大-金華,17,1,16,1,0.64
"20220706","1783","0039004100390078","9A00",永豐金-桃園,0,16,16,-1,0.64
"20220706","1783","8158","8150",台新-松江,15,1,14,1,0.56
"20220706","1783","8884","8880",國泰-台南,0,14,14,-1,0.56
"20220706","1783","9289","9200",凱基-興隆,13,1,12,1,0.48
"20220706","1783","003500380035004a","5850",統一-三重,1,14,13,-1,0.52
"20220706","1783","1040","1040",臺銀,10,0,10,1,0.40
"20220706","1783","9208","9200",凱基-桃園,5,18,13,-1,0.52
"20220707","1783","9614","9600",富邦-基隆,30,0,30,1,1.98
"20220707","1783","5382","5380",第一金-台中,0,30,30,-1,1.98
"20220707","1783","8560","8560",新光,30,9,21,1,1.39
"20220707","1783","003700370039005a","7790",國票-安和,0,25,25,-1,1.65
"20220707","1783","1440","1440",美林,19,1,18,1,1.19
"20220707","1783","0039003800310072","9800",元大-屏南,0,20,20,-1,1.32
"20220707","1783","1650","1650",新加坡商瑞銀,53,37,16,1,1.06
"20220707","1783","0039003600310057","9600",富邦-東花蓮,0,17,17,-1,1.12
"20220707","1783","8440","8440",摩根大通,37,21,16,1,1.06
"20220707","1783","0039003800300043","9800",元大-斗六,0,16,16,-1,1.06
"20220707","1783","5855","5850",統一-台南,29,14,15,1,0.99
"20220707","1783","9268","9200",凱基-台北,82,95,13,-1,0.86
"20220707","1783","1560","1560",港商野村,24,10,14,1,0.92
"20220707","1783","0038003800340041","8840",玉山-士林,0,10,10,-1,0.66
"20220707","1783","8158","8150",台新-松江,18,5,13,1,0.86
"20220707","1783","0039003100380065","9100",群益金鼎-大安,0,10,10,-1,0.66
"20220707","1783","9319","9300",華南永昌-鶯歌,13,0,13,1,0.86
"20220707","1783","9659","9600",富邦-高雄,0,10,10,-1,0.66
"20220707","1783","9616","9600",富邦-岡山,12,0,12,1,0.79
"20220707","1783","0039003800320041","9800",元大-羅東,3,13,10,-1,0.66
"20220707","1783","9636","9600",富邦-中壢,16,5,11,1,0.73
"20220707","1783","003900410039006a","9A00",永豐金-嘉義,0,10,10,-1,0.66
"20220707","1783","9898","9800",元大-新莊,11,0,11,1,0.73
"20220707","1783","8157","8150",台新-左楠,1,8,7,-1,0.46
"20220707","1783","1030","1030",土銀,10,0,10,1,0.66
"20220707","1783","9658","9600",富邦-建國,0,7,7,-1,0.46
"20220707","1783","9185","9100",群益金鼎-台南,10,0,10,1,0.66
"20220707","1783","9834","9800",元大-中壢,3,10,7,-1,0.46
"20220708","1783","1650","1650",新加坡商瑞銀,276,154,122,1,4.11
"20220708","1783","9614","9600",富邦-基隆,0,60,60,-1,2.02
"20220708","1783","7006","7000",兆豐-台南,73,2,71,1,2.39
"20220708","1783","1470","1470",台灣摩根士丹利,21,80,59,-1,1.99
"20220708","1783","9268","9200",凱基-台北,205,150,55,1,1.85
"20220708","1783","8560","8560",新光,41,73,32,-1,1.08
"20220708","1783","9871","9800",元大-忠孝,52,2,50,1,1.69
"20220708","1783","5855","5850",統一-台南,51,81,30,-1,1.01
"20220708","1783","5854","5850",統一-城中,48,20,28,1,0.94
"20220708","1783","0038003100350041","8150",台新-高雄,3,33,30,-1,1.01
"20220708","1783","6161","6160",中國信託-三重,21,0,21,1,0.71
"20220708","1783","8150","8150",台新證券,2,26,24,-1,0.81
"20220708","1783","6164","6160",中國信託-文心,20,0,20,1,0.67
"20220708","1783","0039003800330066","9800",元大-竹東,5,25,20,-1,0.67
"20220708","1783","003900410039006a","9A00",永豐金-嘉義,20,0,20,1,0.67
"20220708","1783","5384","5380",第一金-台南,0,18,18,-1,0.61
"20220708","1783","8158","8150",台新-松江,21,2,19,1,0.64
"20220708","1783","8450","8450",康和,0,17,17,-1,0.57
"20220708","1783","0035003300380043","5380",第一金-光復,16,0,16,1,0.54
"20220708","1783","9278","9200",凱基-永康,2,18,16,-1,0.54
"20220708","1783","8440","8440",摩根大通,144,128,16,1,0.54
"20220708","1783","1560","1560",港商野村,15,30,15,-1,0.51
"20220708","1783","0039004100390039","9A00",永豐金-中壢,15,0,15,1,0.51
"20220708","1783","0037003000300077","7000",兆豐-新莊,0,15,15,-1,0.51
"20220708","1783","0035003300380044","5380",第一金-忠孝,12,0,12,1,0.40
"20220708","1783","0031003200360055","1260",宏遠-館前,1,15,14,-1,0.47
"20220708","1783","0035003900320049","5920",元富-嘉義,13,1,12,1,0.40
"20220708","1783","9878","9800",元大-金華,0,14,14,-1,0.47
"20220711","1783","0035003300380043","5380",第一金-光復,46,3,43,1,1.71
"20220711","1783","1650","1650",新加坡商瑞銀,178,201,23,-1,0.91
"20220711","1783","7000","7000",兆豐證券,36,1,35,1,1.39
"20220711","1783","5854","5850",統一-城中,10,30,20,-1,0.79
"20220711","1783","9658","9600",富邦-建國,38,14,24,1,0.95
"20220711","1783","5855","5850",統一-台南,8,28,20,-1,0.79
"20220711","1783","9302","9300",華南永昌-台中,21,1,20,1,0.79
"20220711","1783","9871","9800",元大-忠孝,0,20,20,-1,0.79
"20220711","1783","003900380033006a","9800",元大-仁愛,20,1,19,1,0.75
"20220711","1783","8562","8560",新光-高雄,1,14,13,-1,0.52
"20220711","1783","0039003600310057","9600",富邦-東花蓮,17,1,16,1,0.64
"20220711","1783","0035003800350059","5850",統一-土城,1,13,12,-1,0.48
"20220711","1783","1480","1480",美商高盛,27,12,15,1,0.60
"20220711","1783","9852","9800",元大-永春,0,12,12,-1,0.48
"20220711","1783","0039003100380065","9100",群益金鼎-大安,40,25,15,1,0.60
"20220711","1783","0039003800300043","9800",元大-斗六,26,37,11,-1,0.44
"20220711","1783","0037003000300048","7000",兆豐-東門,15,1,14,1,0.56
"20220711","1783","003900410039006a","9A00",永豐金-嘉義,14,25,11,-1,0.44
"20220711","1783","0039003100380045","9100",群益金鼎-南京,14,0,14,1,0.56
"20220711","1783","1040","1040",臺銀,0,10,10,-1,0.40
"20220711","1783","0039003600310043","9600",富邦-南京,23,9,14,1,0.56
"20220711","1783","003500390032006c","5920",元富-大裕,1,11,10,-1,0.40
"20220711","1783","0039003800390045","9800",元大-草屯,15,1,14,1,0.56
"20220711","1783","7750","7750",北城證券,2,12,10,-1,0.40
"20220711","1783","8584","8580",聯邦-雙和,12,0,12,1,0.48
"20220711","1783","9208","9200",凱基-桃園,3,13,10,-1,0.40
"20220711","1783","0039003200300043","9200",凱基-雙和,12,0,12,1,0.48
"20220711","1783","9366","9300",華南永昌-豐原,0,10,10,-1,0.40
"20220712","1783","9208","9200",凱基-桃園,47,2,45,1,2.25
"20220712","1783","8440","8440",摩根大通,37,135,98,-1,4.89
"20220712","1783","9655","9600",富邦-板橋,31,9,22,1,1.10
"20220712","1783","9268","9200",凱基-台北,132,179,47,-1,2.35
"20220712","1783","5854","5850",統一-城中,23,5,18,1,0.90
"20220712","1783","7000","7000",兆豐證券,0,36,36,-1,1.80
"20220712","1783","0037003700390063","7790",國票-敦北法人,16,0,16,1,0.80
"20220712","1783","003900380033006a","9800",元大-仁愛,2,20,18,-1,0.90
"20220712","1783","0035003900320041","5920",元富-緯城,15,0,15,1,0.75
"20220712","1783","003900320030004e","9200",凱基-湖口,0,17,17,-1,0.85
"20220712","1783","9614","9600",富邦-基隆,15,0,15,1,0.75
"20220712","1783","8450","8450",康和,0,16,16,-1,0.80
"20220712","1783","003900360031004a","9600",富邦-興業,15,0,15,1,0.75
"20220712","1783","0039003800310072","9800",元大-屏南,0,16,16,-1,0.80
"20220712","1783","8560","8560",新光,49,36,13,1,0.65
"20220712","1783","0039003100380065","9100",群益金鼎-大安,0,15,15,-1,0.75
"20220712","1783","0035003800350059","5850",統一-土城,13,0,13,1,0.65
"20220712","1783","8584","8580",聯邦-雙和,0,14,14,-1,0.70
"20220712","1783","9101","9100",群益金鼎-敦南,18,6,12,1,0.60
"20220712","1783","0039003600390043","9600",富邦-北港,0,14,14,-1,0.70
"20220712","1783","9692","9600",富邦-嘉義,12,0,12,1,0.60
"20220712","1783","1470","1470",台灣摩根士丹利,11,24,13,-1,0.65
"20220712","1783","9800","9800",元大證券,21,10,11,1,0.55
"20220712","1783","0039003600310057","9600",富邦-東花蓮,6,18,12,-1,0.60
"20220712","1783","1040","1040",臺銀,20,10,10,1,0.50
"20220712","1783","003900360032004c","9600",富邦-雙和,8,20,12,-1,0.60
"20220712","1783","1028","1020",合庫-彰化,10,0,10,1,0.50
"20220712","1783","9362","9300",華南永昌-苗栗,0,11,11,-1,0.55
"20220705","1783","9204","9200",凱基-台中,34,0,34,1,2.69
"20220705","1783","1650","1650",新加坡商瑞銀,29,85,56,-1,4.43
"20220705","1783","0039003100380065","9100",群益金鼎-大安,30,0,30,1,2.37
"20220705","1783","8440","8440",摩根大通,40,92,52,-1,4.11
"20220705","1783","1470","1470",台灣摩根士丹利,41,12,29,1,2.29
"20220705","1783","0031003000330046","1030",土銀-南港,0,26,26,-1,2.06
"20220705","1783","5850","5850",統一,41,17,24,1,1.90
"20220705","1783","1023","1020",合庫-高雄,0,26,26,-1,2.06
"20220705","1783","0035003900320043","5920",元富-潮州,22,2,20,1,1.58
"20220705","1783","9800","9800",元大證券,8,34,26,-1,2.06
"20220705","1783","9614","9600",富邦-基隆,20,0,20,1,1.58
"20220705","1783","1480","1480",美商高盛,0,23,23,-1,1.82
"20220705","1783","8158","8150",台新-松江,19,0,19,1,1.50
"20220705","1783","0036003300380041","6380",光和-嘉義,0,20,20,-1,1.58
"20220705","1783","8560","8560",新光,25,9,16,1,1.27
"20220705","1783","9208","9200",凱基-桃園,0,20,20,-1,1.58
"20220705","1783","0039003800390049","9800",元大-蘆洲,20,5,15,1,1.19
"20220705","1783","0039004100390078","9A00",永豐金-桃園,0,20,20,-1,1.58
"20220705","1783","9268","9200",凱基-台北,72,57,15,1,1.19
"20220705","1783","1560","1560",港商野村,10,29,19,-1,1.50
"20220705","1783","5855","5850",統一-台南,14,2,12,1,0.95
"20220705","1783","9878","9800",元大-金華,0,16,16,-1,1.27
"20220705","1783","9322","9300",華南永昌-公誠,16,4,12,1,0.95
"20220705","1783","9317","9300",華南永昌-林口,0,13,13,-1,1.03
"20220705","1783","0039003100330067","9100",群益金鼎-三重,11,0,11,1,0.87
"20220705","1783","9677","9600",富邦-三重,2,14,12,-1,0.95
"20220705","1783","1117","1110",台灣企銀-竹北,10,0,10,1,0.79
"20220705","1783","9366","9300",華南永昌-豐原,0,10,10,-1,0.79
"20220706","1783","9614","9600",富邦-基隆,40,0,40,1,1.60
"20220706","1783","9871","9800",元大-忠孝,0,38,38,-1,1.52
"20220706","1783","5855","5850",統一-台南,32,0,32,1,1.28
"20220706","1783","1470","1470",台灣摩根士丹利,0,29,29,-1,1.16
"20220706","1783","5382","5380",第一金-台中,30,0,30,1,1.20
"20220706","1783","003900380039004c","9800",元大-成功,2,28,26,-1,1.04
"20220706","1783","0038003100350041","8150",台新-高雄,45,19,26,1,1.04
"20220706","1783","5850","5850",統一,4,29,25,-1,1.00
"20220706","1783","6161","6160",中國信託-三重,45,25,20,1,0.80
"20220706","1783","0039003100380065","9100",群益金鼎-大安,10,30,20,-1,0.80
"20220706","1783","0039003600320042","9600",富邦-二林,20,0,20,1,0.80
"20220706","1783","0039003200300041","9200",凱基-板橋,0,20,20,-1,0.80
"20220706","1783","0037003000300067","7000",兆豐-南門,20,1,19,1,0.76
"20220706","1783","9268","9200",凱基-台北,168,188,20,-1,0.80
"20220706","1783","0039003600310057","9600",富邦-東花蓮,17,0,17,1,0.68
"20220706","1783","8440","8440",摩根大通,78,97,19,-1,0.76
"20220706","1783","0035003300380043","5380",第一金-光復,16,0,16,1,0.64
"20220706","1783","9300","9300",華南永昌,5,22,17,-1,0.68
"20220706","1783","0039003800300043","9800",元大-斗六,16,0,16,1,0.64
"20220706","1783","0038003800380041","8880",國泰-館前,0,16,16,-1,0.64
"20220706","1783","9878","9800",元大-金華,17,1,16,1,0.64
"20220706","1783","0039004100390078","9A00",永豐金-桃園,0,16,16,-1,0.64
"20220706","1783","8158","8150",台新-松江,15,1,14,1,0.56
"20220706","1783","8884","8880",國泰-台南,0,14,14,-1,0.56
"20220706","1783","9289","9200",凱基-興隆,13,1,12,1,0.48
"20220706","1783","003500380035004a","5850",統一-三重,1,14,13,-1,0.52
"20220706","1783","1040","1040",臺銀,10,0,10,1,0.40
"20220706","1783","9208","9200",凱基-桃園,5,18,13,-1,0.52
"20220707","1783","9614","9600",富邦-基隆,30,0,30,1,1.98
"20220707","1783","5382","5380",第一金-台中,0,30,30,-1,1.98
"20220707","1783","8560","8560",新光,30,9,21,1,1.39
"20220707","1783","003700370039005a","7790",國票-安和,0,25,25,-1,1.65
"20220707","1783","1440","1440",美林,19,1,18,1,1.19
"20220707","1783","0039003800310072","9800",元大-屏南,0,20,20,-1,1.32
"20220707","1783","1650","1650",新加坡商瑞銀,53,37,16,1,1.06
"20220707","1783","0039003600310057","9600",富邦-東花蓮,0,17,17,-1,1.12
"20220707","1783","8440","8440",摩根大通,37,21,16,1,1.06
"20220707","1783","0039003800300043","9800",元大-斗六,0,16,16,-1,1.06
"20220707","1783","5855","5850",統一-台南,29,14,15,1,0.99
"20220707","1783","9268","9200",凱基-台北,82,95,13,-1,0.86
"20220707","1783","1560","1560",港商野村,24,10,14,1,0.92
"20220707","1783","0038003800340041","8840",玉山-士林,0,10,10,-1,0.66
"20220707","1783","8158","8150",台新-松江,18,5,13,1,0.86
"20220707","1783","0039003100380065","9100",群益金鼎-大安,0,10,10,-1,0.66
"20220707","1783","9319","9300",華南永昌-鶯歌,13,0,13,1,0.86
"20220707","1783","9659","9600",富邦-高雄,0,10,10,-1,0.66
"20220707","1783","9616","9600",富邦-岡山,12,0,12,1,0.79
"20220707","1783","0039003800320041","9800",元大-羅東,3,13,10,-1,0.66
"20220707","1783","9636","9600",富邦-中壢,16,5,11,1,0.73
"20220707","1783","003900410039006a","9A00",永豐金-嘉義,0,10,10,-1,0.66
"20220707","1783","9898","9800",元大-新莊,11,0,11,1,0.73
"20220707","1783","8157","8150",台新-左楠,1,8,7,-1,0.46
"20220707","1783","1030","1030",土銀,10,0,10,1,0.66
"20220707","1783","9658","9600",富邦-建國,0,7,7,-1,0.46
"20220707","1783","9185","9100",群益金鼎-台南,10,0,10,1,0.66
"20220707","1783","9834","9800",元大-中壢,3,10,7,-1,0.46
"20220708","1783","1650","1650",新加坡商瑞銀,276,154,122,1,4.11
"20220708","1783","9614","9600",富邦-基隆,0,60,60,-1,2.02
"20220708","1783","7006","7000",兆豐-台南,73,2,71,1,2.39
"20220708","1783","1470","1470",台灣摩根士丹利,21,80,59,-1,1.99
"20220708","1783","9268","9200",凱基-台北,205,150,55,1,1.85
"20220708","1783","8560","8560",新光,41,73,32,-1,1.08
"20220708","1783","9871","9800",元大-忠孝,52,2,50,1,1.69
"20220708","1783","5855","5850",統一-台南,51,81,30,-1,1.01
"20220708","1783","5854","5850",統一-城中,48,20,28,1,0.94
"20220708","1783","0038003100350041","8150",台新-高雄,3,33,30,-1,1.01
"20220708","1783","6161","6160",中國信託-三重,21,0,21,1,0.71
"20220708","1783","8150","8150",台新證券,2,26,24,-1,0.81
"20220708","1783","6164","6160",中國信託-文心,20,0,20,1,0.67
"20220708","1783","0039003800330066","9800",元大-竹東,5,25,20,-1,0.67
"20220708","1783","003900410039006a","9A00",永豐金-嘉義,20,0,20,1,0.67
"20220708","1783","5384","5380",第一金-台南,0,18,18,-1,0.61
"20220708","1783","8158","8150",台新-松江,21,2,19,1,0.64
"20220708","1783","8450","8450",康和,0,17,17,-1,0.57
"20220708","1783","0035003300380043","5380",第一金-光復,16,0,16,1,0.54
"20220708","1783","9278","9200",凱基-永康,2,18,16,-1,0.54
"20220708","1783","8440","8440",摩根大通,144,128,16,1,0.54
"20220708","1783","1560","1560",港商野村,15,30,15,-1,0.51
"20220708","1783","0039004100390039","9A00",永豐金-中壢,15,0,15,1,0.51
"20220708","1783","0037003000300077","7000",兆豐-新莊,0,15,15,-1,0.51
"20220708","1783","0035003300380044","5380",第一金-忠孝,12,0,12,1,0.40
"20220708","1783","0031003200360055","1260",宏遠-館前,1,15,14,-1,0.47
"20220708","1783","0035003900320049","5920",元富-嘉義,13,1,12,1,0.40
"20220708","1783","9878","9800",元大-金華,0,14,14,-1,0.47
"20220711","1783","0035003300380043","5380",第一金-光復,46,3,43,1,1.71
"20220711","1783","1650","1650",新加坡商瑞銀,178,201,23,-1,0.91
"20220711","1783","7000","7000",兆豐證券,36,1,35,1,1.39
"20220711","1783","5854","5850",統一-城中,10,30,20,-1,0.79
"20220711","1783","9658","9600",富邦-建國,38,14,24,1,0.95
"20220711","1783","5855","5850",統一-台南,8,28,20,-1,0.79
"20220711","1783","9302","9300",華南永昌-台中,21,1,20,1,0.79
"20220711","1783","9871","9800",元大-忠孝,0,20,20,-1,0.79
"20220711","1783","003900380033006a","9800",元大-仁愛,20,1,19,1,0.75
"20220711","1783","8562","8560",新光-高雄,1,14,13,-1,0.52
"20220711","1783","0039003600310057","9600",富邦-東花蓮,17,1,16,1,0.64
"20220711","1783","0035003800350059","5850",統一-土城,1,13,12,-1,0.48
"20220711","1783","1480","1480",美商高盛,27,12,15,1,0.60
"20220711","1783","9852","9800",元大-永春,0,12,12,-1,0.48
"20220711","1783","0039003100380065","9100",群益金鼎-大安,40,25,15,1,0.60
"20220711","1783","0039003800300043","9800",元大-斗六,26,37,11,-1,0.44
"20220711","1783","0037003000300048","7000",兆豐-東門,15,1,14,1,0.56
"20220711","1783","003900410039006a","9A00",永豐金-嘉義,14,25,11,-1,0.44
"20220711","1783","0039003100380045","9100",群益金鼎-南京,14,0,14,1,0.56
"20220711","1783","1040","1040",臺銀,0,10,10,-1,0.40
"20220711","1783","0039003600310043","9600",富邦-南京,23,9,14,1,0.56
"20220711","1783","003500390032006c","5920",元富-大裕,1,11,10,-1,0.40
"20220711","1783","0039003800390045","9800",元大-草屯,15,1,14,1,0.56
"20220711","1783","7750","7750",北城證券,2,12,10,-1,0.40
"20220711","1783","8584","8580",聯邦-雙和,12,0,12,1,0.48
"20220711","1783","9208","9200",凱基-桃園,3,13,10,-1,0.40
"20220711","1783","0039003200300043","9200",凱基-雙和,12,0,12,1,0.48
"20220711","1783","9366","9300",華南永昌-豐原,0,10,10,-1,0.40
"20220712","1783","9208","9200",凱基-桃園,47,2,45,1,2.25
"20220712","1783","8440","8440",摩根大通,37,135,98,-1,4.89
"20220712","1783","9655","9600",富邦-板橋,31,9,22,1,1.10
"20220712","1783","9268","9200",凱基-台北,132,179,47,-1,2.35
"20220712","1783","5854","5850",統一-城中,23,5,18,1,0.90
"20220712","1783","7000","7000",兆豐證券,0,36,36,-1,1.80
"20220712","1783","0037003700390063","7790",國票-敦北法人,16,0,16,1,0.80
"20220712","1783","003900380033006a","9800",元大-仁愛,2,20,18,-1,0.90
"20220712","1783","0035003900320041","5920",元富-緯城,15,0,15,1,0.75
"20220712","1783","003900320030004e","9200",凱基-湖口,0,17,17,-1,0.85
"20220712","1783","9614","9600",富邦-基隆,15,0,15,1,0.75
"20220712","1783","8450","8450",康和,0,16,16,-1,0.80
"20220712","1783","003900360031004a","9600",富邦-興業,15,0,15,1,0.75
"20220712","1783","0039003800310072","9800",元大-屏南,0,16,16,-1,0.80
"20220712","1783","8560","8560",新光,49,36,13,1,0.65
"20220712","1783","0039003100380065","9100",群益金鼎-大安,0,15,15,-1,0.75
"20220712","1783","0035003800350059","5850",統一-土城,13,0,13,1,0.65
"20220712","1783","8584","8580",聯邦-雙和,0,14,14,-1,0.70
"20220712","1783","9101","9100",群益金鼎-敦南,18,6,12,1,0.60
"20220712","1783","0039003600390043","9600",富邦-北港,0,14,14,-1,0.70
"20220712","1783","9692","9600",富邦-嘉義,12,0,12,1,0.60
"20220712","1783","1470","1470",台灣摩根士丹利,11,24,13,-1,0.65
"20220712","1783","9800","9800",元大證券,21,10,11,1,0.55
"20220712","1783","0039003600310057","9600",富邦-東花蓮,6,18,12,-1,0.60
"20220712","1783","1040","1040",臺銀,20,10,10,1,0.50
"20220712","1783","003900360032004c","9600",富邦-雙和,8,20,12,-1,0.60
"20220712","1783","1028","1020",合庫-彰化,10,0,10,1,0.50
"20220712","1783","9362","9300",華南永昌-苗栗,0,11,11,-1,0.55
"20220713","1783","1650","1650",新加坡商瑞銀,126,70,56,1,2.65
"20220713","1783","9302","9300",華南永昌-台中,6,37,31,-1,1.47
"20220713","1783","9661","9600",富邦-新店,63,7,56,1,2.65
"20220713","1783","8560","8560",新光,43,67,24,-1,1.13
"20220713","1783","1470","1470",台灣摩根士丹利,60,6,54,1,2.55
"20220713","1783","9655","9600",富邦-板橋,4,28,24,-1,1.13
"20220713","1783","9268","9200",凱基-台北,164,114,50,1,2.36
"20220713","1783","9658","9600",富邦-建國,73,96,23,-1,1.09
"20220713","1783","9200","9200",凱基,44,0,44,1,2.08
"20220713","1783","8158","8150",台新-松江,0,20,20,-1,0.95
"20220713","1783","9100","9100",群益金鼎,43,2,41,1,1.94
"20220713","1783","0039003600320042","9600",富邦-二林,1,21,20,-1,0.95
"20220713","1783","0039003800310051","9800",元大-太平,25,3,22,1,1.04
"20220713","1783","8842","8840",玉山-新莊,1,20,19,-1,0.90
"20220713","1783","9300","9300",華南永昌,22,1,21,1,0.99
"20220713","1783","0039003100380078","9100",群益金鼎-延平,0,18,18,-1,0.85
"20220713","1783","8840","8840",玉山證券,23,2,21,1,0.99
"20220713","1783","0039004100390039","9A00",永豐金-中壢,0,17,17,-1,0.80
"20220713","1783","8843","8840",玉山-高雄,21,0,21,1,0.99
"20220713","1783","5855","5850",統一-台南,0,16,16,-1,0.76
"20220713","1783","0039003800300052","9800",元大-南海,20,0,20,1,0.95
"20220713","1783","0037003700390063","7790",國票-敦北法人,0,15,15,-1,0.71
"20220713","1783","0039004100380039","9A00",永豐金-敦北,20,1,19,1,0.90
"20220713","1783","9614","9600",富邦-基隆,0,15,15,-1,0.71
"20220713","1783","1440","1440",美林,46,28,18,1,0.85
"20220713","1783","003900380033004d","9800",元大-木柵,0,15,15,-1,0.71
"20220713","1783","9208","9200",凱基-桃園,19,2,17,1,0.80
"20220713","1783","003500390032006d","5920",元富-成功,5,20,15,-1,0.71
"20220714","1783","9692","9600",富邦-嘉義,41,0,41,1,3.33
"20220714","1783","1650","1650",新加坡商瑞銀,33,81,48,-1,3.90
"20220714","1783","9204","9200",凱基-台中,38,0,38,1,3.09
"20220714","1783","1470","1470",台灣摩根士丹利,40,72,32,-1,2.60
"20220714","1783","9100","9100",群益金鼎,24,0,24,1,1.95
"20220714","1783","9302","9300",華南永昌-台中,0,24,24,-1,1.95
"20220714","1783","8843","8840",玉山-高雄,23,0,23,1,1.87
"20220714","1783","1440","1440",美林,13,33,20,-1,1.63
"20220714","1783","5058","5050",大展-台南,20,0,20,1,1.63
"20220714","1783","8158","8150",台新-松江,0,20,20,-1,1.63
"20220714","1783","5856","5850",統一-台中,17,0,17,1,1.38
"20220714","1783","8840","8840",玉山證券,1,21,20,-1,1.63
"20220714","1783","9200","9200",凱基,16,0,16,1,1.30
"20220714","1783","0039003800310047","9800",元大-彰化,0,14,14,-1,1.14
"20220714","1783","9616","9600",富邦-岡山,15,0,15,1,1.22
"20220714","1783","0039003800330069","9800",元大-大雅,0,13,13,-1,1.06
"20220714","1783","0039003800390046","9800",元大-高雄,14,0,14,1,1.14
"20220714","1783","0035003900320075","5920",元富-世貿,9,21,12,-1,0.98
"20220714","1783","5854","5850",統一-城中,15,3,12,1,0.98
"20220714","1783","0035003800350059","5850",統一-土城,2,12,10,-1,0.81
"20220714","1783","0037003000300048","7000",兆豐-東門,19,7,12,1,0.98
"20220714","1783","0039003600310046","9600",富邦-中港,0,10,10,-1,0.81
"20220714","1783","003700300030004a","7000",兆豐-公益,12,0,12,1,0.98
"20220714","1783","0039003800310071","9800",元大-萬華,0,10,10,-1,0.81
"20220714","1783","0037003000300070","7000",兆豐-復興,11,0,11,1,0.89
"20220714","1783","003900410039004c","9A00",永豐金-台中,0,10,10,-1,0.81
"20220714","1783","8151","8150",台新-建北,11,0,11,1,0.89
"20220714","1783","8882","8880",國泰-台中,8,17,9,-1,0.73
"20220715","1783","8158","8150",台新-松江,50,0,50,1,4.75
"20220715","1783","9661","9600",富邦-新店,0,71,71,-1,6.74
"20220715","1783","5858","5850",統一-嘉義,40,0,40,1,3.80
"20220715","1783","9692","9600",富邦-嘉義,7,45,38,-1,3.61
"20220715","1783","9204","9200",凱基-台中,38,0,38,1,3.61
"20220715","1783","5855","5850",統一-台南,19,40,21,-1,1.99
"20220715","1783","9834","9800",元大-中壢,21,0,21,1,1.99
"20220715","1783","1560","1560",港商野村,0,20,20,-1,1.90
"20220715","1783","0039003800300064","9800",元大-沙鹿,20,0,20,1,1.90
"20220715","1783","0039003600310050","9600",富邦-和美,0,20,20,-1,1.90
"20220715","1783","8561","8560",新光-台中,15,0,15,1,1.42
"20220715","1783","1480","1480",美商高盛,2,20,18,-1,1.71
"20220715","1783","003900380031006d","9800",元大-前金,15,0,15,1,1.42
"20220715","1783","0037003000300048","7000",兆豐-東門,5,23,18,-1,1.71
"20220715","1783","0035003800350059","5850",統一-土城,14,1,13,1,1.23
"20220715","1783","0039003800300043","9800",元大-斗六,1,19,18,-1,1.71
"20220715","1783","003900360031004c","9600",富邦-士林,18,5,13,1,1.23
"20220715","1783","9859","9800",元大-新竹經國,1,19,18,-1,1.71
"20220715","1783","9623","9600",富邦-台北,15,3,12,1,1.14
"20220715","1783","1650","1650",新加坡商瑞銀,41,57,16,-1,1.52
"20220715","1783","1030","1030",土銀,10,0,10,1,0.95
"20220715","1783","0039003100330067","9100",群益金鼎-三重,0,15,15,-1,1.42
"20220715","1783","0035003900320069","5920",元富-中港,10,0,10,1,0.95
"20220715","1783","9871","9800",元大-忠孝,6,20,14,-1,1.33
"20220715","1783","0037003000300077","7000",兆豐-新莊,10,0,10,1,0.95
"20220715","1783","0039004100380039","9A00",永豐金-敦北,0,13,13,-1,1.23
"20220715","1783","0039004100390067","9A00",永豐金-內湖,26,16,10,1,0.95
"20220715","1783","8151","8150",台新-建北,0,11,11,-1,1.04
"20220616","1783","0035003300380043","5380",第一金-光復,17,0,17,1,9.39
"20220616","1783","9812","9800",元大-台中,0,30,30,-1,16.57
"20220616","1783","1470","1470",台灣摩根士丹利,19,3,16,1,8.84
"20220616","1783","9208","9200",凱基-桃園,0,7,7,-1,3.87
"20220616","1783","0039004100390067","9A00",永豐金-內湖,14,0,14,1,7.73
"20220616","1783","8560","8560",新光,0,6,6,-1,3.31
"20220616","1783","003900410039004b","9A00",永豐金-三重,12,0,12,1,6.63
"20220616","1783","0039003800390058","9800",元大-民生,0,6,6,-1,3.31
"20220616","1783","003900310038004b","9100",群益金鼎-東湖,11,0,11,1,6.08
"20220616","1783","0039004100360031","9A00",永豐金-鳳山,0,6,6,-1,3.31
"20220616","1783","0039003200310047","9200",凱基-五股,10,0,10,1,5.52
"20220616","1783","0035003900320041","5920",元富-緯城,0,4,4,-1,2.21
"20220616","1783","1034","1030",土銀-嘉義,9,0,9,1,4.97
"20220616","1783","8451","8450",康和-延平,0,4,4,-1,2.21
"20220616","1783","8440","8440",摩根大通,10,5,5,1,2.76
"20220616","1783","9255","9200",凱基-和平,0,4,4,-1,2.21
"20220616","1783","9205","9200",凱基-三重,3,0,3,1,1.66
"20220616","1783","0035003900320050","5920",元富-同大,0,3,3,-1,1.66
"20220616","1783","0039004100390066","9A00",永豐金-中盛,3,0,3,1,1.66
"20220616","1783","0039003200320048","9200",凱基-復興,0,3,3,-1,1.66
"20220616","1783","1440","1440",美林,5,3,2,1,1.10
"20220616","1783","5660","5660",日進,0,2,2,-1,1.10
"20220616","1783","0035003900320045","5920",元富-城中,2,0,2,1,1.10
"20220616","1783","003500330038006a","5380",第一金-安和,0,2,2,-1,1.10
"20220616","1783","6210","6210",新百王,2,0,2,1,1.10
"20220616","1783","8563","8560",新光-新竹,0,2,2,-1,1.10
"20220616","1783","7008","7000",兆豐-三重,2,0,2,1,1.10
"20220616","1783","8843","8840",玉山-高雄,0,2,2,-1,1.10
"20220617","1783","1470","1470",台灣摩根士丹利,13,1,12,1,15.79
"20220617","1783","0039004100360031","9A00",永豐金-鳳山,0,8,8,-1,10.53
"20220617","1783","9322","9300",華南永昌-公誠,5,0,5,1,6.58
"20220617","1783","1650","1650",新加坡商瑞銀,1,8,7,-1,9.21
"20220617","1783","0035003300380050","5380",第一金-路竹,4,0,4,1,5.26
"20220617","1783","6385","6380",光和-花壇,0,3,3,-1,3.95
"20220617","1783","003700300030004b","7000",兆豐-新營,2,0,2,1,2.63
"20220617","1783","8886","8880",國泰-新莊,0,2,2,-1,2.63
"20220617","1783","9268","9200",凱基-台北,5,3,2,1,2.63
"20220617","1783","9215","9200",凱基-高美館,0,2,2,-1,2.63
"20220617","1783","003900410039004b","9A00",永豐金-三重,2,0,2,1,2.63
"20220617","1783","0039003600320043","9600",富邦-東門,0,2,2,-1,2.63
"20220617","1783","003500390032006d","5920",元富-成功,1,0,1,1,1.32
"20220617","1783","9838","9800",元大-豐原,0,2,2,-1,2.63
"20220617","1783","7797","7790",國票-中正,1,0,1,1,1.32
"20220617","1783","5925","5920",元富-台中,0,1,1,-1,1.32
"20220617","1783","8560","8560",新光,1,0,1,1,1.32
"20220617","1783","0035003800350067","5850",統一-平鎮,0,1,1,-1,1.32
"20220617","1783","0038003800340045","8840",玉山-城中,1,0,1,1,1.32
"20220617","1783","1440","1440",美林,2,3,1,-1,1.32
"20220617","1783","9208","9200",凱基-桃園,1,0,1,1,1.32
"20220617","1783","003500330038006a","5380",第一金-安和,0,1,1,-1,1.32
"20220617","1783","9358","9300",華南永昌-東勢,1,0,1,1,1.32
"20220617","1783","0035003900320072","5920",元富-城東,0,1,1,-1,1.32
"20220617","1783","003900380033005a","9800",元大-鳳山,1,0,1,1,1.32
"20220617","1783","003700300030004a","7000",兆豐-公益,0,1,1,-1,1.32
"20220617","1783","9854","9800",元大-文心興安,1,0,1,1,1.32
"20220617","1783","7750","7750",北城證券,0,1,1,-1,1.32
"20220620","1783","1470","1470",台灣摩根士丹利,26,3,23,1,13.77
"20220620","1783","9255","9200",凱基-和平,0,10,10,-1,5.99
"20220620","1783","8560","8560",新光,18,4,14,1,8.38
"20220620","1783","8158","8150",台新-松江,0,9,9,-1,5.39
"20220620","1783","6210","6210",新百王,12,0,12,1,7.19
"20220620","1783","8888","8880",國泰-敦南,0,8,8,-1,4.79
"20220620","1783","1440","1440",美林,12,7,5,1,2.99
"20220620","1783","5929","5920",元富-台南,0,6,6,-1,3.59
"20220620","1783","1111","1110",台灣企銀-台中,4,0,4,1,2.40
"20220620","1783","0039003800390058","9800",元大-民生,0,6,6,-1,3.59
"20220620","1783","0039003800320041","9800",元大-羅東,4,0,4,1,2.40
"20220620","1783","0039004100360031","9A00",永豐金-鳳山,0,6,6,-1,3.59
"20220620","1783","0039004100390071","9A00",永豐金-潮州,4,0,4,1,2.40
"20220620","1783","0031003100310041","1110",台灣企銀-民雄,0,5,5,-1,2.99
"20220620","1783","0035003900320069","5920",元富-中港,3,0,3,1,1.80
"20220620","1783","003500390032004c","5920",元富-中壢,0,5,5,-1,2.99
"20220620","1783","8843","8840",玉山-高雄,3,0,3,1,1.80
"20220620","1783","0039004100390078","9A00",永豐金-桃園,0,5,5,-1,2.99
"20220620","1783","6380","6380",光和,2,0,2,1,1.20
"20220620","1783","0035003900320041","5920",元富-緯城,0,4,4,-1,2.40
"20220620","1783","0038003100350042","8150",台新-台中,2,0,2,1,1.20
"20220620","1783","1650","1650",新加坡商瑞銀,2,6,4,-1,2.40
"20220620","1783","8440","8440",摩根大通,4,2,2,1,1.20
"20220620","1783","8881","8880",國泰-高雄,0,3,3,-1,1.80
"20220620","1783","8711","8710",陽信-石牌,2,0,2,1,1.20
"20220620","1783","1480","1480",美商高盛,0,2,2,-1,1.20
"20220620","1783","0039003600310053","9600",富邦-景美,2,0,2,1,1.20
"20220620","1783","8563","8560",新光-新竹,0,2,2,-1,1.20
"20220621","1783","1470","1470",台灣摩根士丹利,16,1,15,1,15.31
"20220621","1783","9324","9300",華南永昌-岡山,0,8,8,-1,8.16
"20220621","1783","8440","8440",摩根大通,9,1,8,1,8.16
"20220621","1783","9255","9200",凱基-和平,0,6,6,-1,6.12
"20220621","1783","1590","1590",花旗環球,7,0,7,1,7.14
"20220621","1783","5603","5600",永興-台中,0,5,5,-1,5.10
"20220621","1783","9212","9200",凱基-東港,5,0,5,1,5.10
"20220621","1783","9319","9300",華南永昌-鶯歌,0,5,5,-1,5.10
"20220621","1783","9800","9800",元大證券,5,1,4,1,4.08
"20220621","1783","9692","9600",富邦-嘉義,0,5,5,-1,5.10
"20220621","1783","0038003100350053","8150",台新-中壢,3,0,3,1,3.06
"20220621","1783","0035003900320041","5920",元富-緯城,0,4,4,-1,4.08
"20220621","1783","9200","9200",凱基,3,0,3,1,3.06
"20220621","1783","0039003200320048","9200",凱基-復興,0,4,4,-1,4.08
"20220621","1783","1440","1440",美林,2,0,2,1,2.04
"20220621","1783","0039004100390045","9A00",永豐金-板橋,0,4,4,-1,4.08
"20220621","1783","9302","9300",華南永昌-台中,2,0,2,1,2.04
"20220621","1783","0031003000320045","1020",合庫-桃園,0,2,2,-1,2.04
"20220621","1783","9604","9600",富邦-陽明,2,0,2,1,2.04
"20220621","1783","1116","1110",台灣企銀-屏東,0,2,2,-1,2.04
"20220621","1783","003500320036004b","5260",美好-富順,2,1,1,1,1.02
"20220621","1783","0039003100330044","9100",群益金鼎-潭子,0,2,2,-1,2.04
"20220621","1783","0035003900320045","5920",元富-城中,1,0,1,1,1.02
"20220621","1783","9852","9800",元大-永春,0,2,2,-1,2.04
"20220621","1783","003500390032006d","5920",元富-成功,1,0,1,1,1.02
"20220621","1783","0035003900320061","5920",元富-松德,0,1,1,-1,1.02
"20220621","1783","0038003100350041","8150",台新-高雄,1,0,1,1,1.02
"20220621","1783","5929","5920",元富-台南,0,1,1,-1,1.02
"20220622","1783","5854","5850",統一-城中,103,0,103,1,1.74
"20220622","1783","9614","9600",富邦-基隆,0,60,60,-1,1.01
"20220622","1783","9268","9200",凱基-台北,159,64,95,1,1.60
"20220622","1783","1650","1650",新加坡商瑞銀,44,103,59,-1,0.99
"20220622","1783","5850","5850",統一,120,33,87,1,1.47
"20220622","1783","9215","9200",凱基-高美館,4,62,58,-1,0.98
"20220622","1783","9871","9800",元大-忠孝,81,1,80,1,1.35
"20220622","1783","9655","9600",富邦-板橋,1,49,48,-1,0.81
"20220622","1783","0039003800330042","9800",元大-林森,435,365,70,1,1.18
"20220622","1783","9665","9600",富邦-桃園,0,45,45,-1,0.76
"20220622","1783","5382","5380",第一金-台中,70,0,70,1,1.18
"20220622","1783","6161","6160",中國信託-三重,0,38,38,-1,0.64
"20220622","1783","9300","9300",華南永昌,67,7,60,1,1.01
"20220622","1783","003700370039006d","7790",國票-中港,5,38,33,-1,0.56
"20220622","1783","0039004100390044","9A00",永豐金-忠孝,50,0,50,1,0.84
"20220622","1783","8848","8840",玉山-嘉義,3,34,31,-1,0.52
"20220622","1783","9817","9800",元大-東泰,43,0,43,1,0.73
"20220622","1783","0039003600310043","9600",富邦-南京,1,24,23,-1,0.39
"20220622","1783","9816","9800",元大-新竹,146,107,39,1,0.66
"20220622","1783","9324","9300",華南永昌-岡山,0,20,20,-1,0.34
"20220622","1783","0039004100390067","9A00",永豐金-內湖,30,0,30,1,0.51
"20220622","1783","0039003600320057","9600",富邦-龍潭,0,20,20,-1,0.34
"20220622","1783","9202","9200",凱基-中港,30,1,29,1,0.49
"20220622","1783","0039004100390066","9A00",永豐金-中盛,2,22,20,-1,0.34
"20220622","1783","0035003300380057","5380",第一金-華江,33,5,28,1,0.47
"20220622","1783","7005","7000",兆豐-台中港,1,20,19,-1,0.32
"20220622","1783","0039003800300043","9800",元大-斗六,33,5,28,1,0.47
"20220622","1783","7006","7000",兆豐-台南,1,20,19,-1,0.32
"20220623","1783","0031003000340044","1040",臺銀-金山,52,0,52,1,1.51
"20220623","1783","1470","1470",台灣摩根士丹利,0,172,172,-1,5.01
"20220623","1783","5384","5380",第一金-台南,36,6,30,1,0.87
"20220623","1783","5850","5850",統一,0,95,95,-1,2.77
"20220623","1783","9655","9600",富邦-板橋,31,1,30,1,0.87
"20220623","1783","0039003800330042","9800",元大-林森,0,70,70,-1,2.04
"20220623","1783","8560","8560",新光,41,12,29,1,0.84
"20220623","1783","1650","1650",新加坡商瑞銀,109,176,67,-1,1.95
"20220623","1783","0035003300380043","5380",第一金-光復,26,0,26,1,0.76
"20220623","1783","8440","8440",摩根大通,66,132,66,-1,1.92
"20220623","1783","1117","1110",台灣企銀-竹北,25,0,25,1,0.73
"20220623","1783","9871","9800",元大-忠孝,35,85,50,-1,1.46
"20220623","1783","0039003600310043","9600",富邦-南京,26,1,25,1,0.73
"20220623","1783","9256","9200",凱基-南崁,0,40,40,-1,1.17
"20220623","1783","0037003000300077","7000",兆豐-新莊,22,0,22,1,0.64
"20220623","1783","9300","9300",華南永昌,12,50,38,-1,1.11
"20220623","1783","0039003800390046","9800",元大-高雄,19,0,19,1,0.55
"20220623","1783","9816","9800",元大-新竹,0,36,36,-1,1.05
"20220623","1783","9834","9800",元大-中壢,33,15,18,1,0.52
"20220623","1783","9817","9800",元大-東泰,9,43,34,-1,0.99
"20220623","1783","1034","1030",土銀-嘉義,17,0,17,1,0.50
"20220623","1783","1440","1440",美林,22,49,27,-1,0.79
"20220623","1783","003900320030004e","9200",凱基-湖口,17,0,17,1,0.50
"20220623","1783","0039003100380063","9100",群益金鼎-鳳山,5,28,23,-1,0.67
"20220623","1783","0039003100330045","9100",群益金鼎-基隆,15,0,15,1,0.44
"20220623","1783","9659","9600",富邦-高雄,2,24,22,-1,0.64
"20220623","1783","5857","5850",統一-新竹,14,0,14,1,0.41
"20220623","1783","8888","8880",國泰-敦南,22,43,21,-1,0.61
"20220624","1783","0035003300380043","5380",第一金-光復,32,0,32,1,3.73
"20220624","1783","0031003000340044","1040",臺銀-金山,0,50,50,-1,5.82
"20220624","1783","9604","9600",富邦-陽明,32,0,32,1,3.73
"20220624","1783","0039004100390067","9A00",永豐金-內湖,1,30,29,-1,3.38
"20220624","1783","9800","9800",元大證券,21,2,19,1,2.21
"20220624","1783","0039003600310050","9600",富邦-和美,1,20,19,-1,2.21
"20220624","1783","9300","9300",華南永昌,17,0,17,1,1.98
"20220624","1783","0038003100350042","8150",台新-台中,0,14,14,-1,1.63
"20220624","1783","1650","1650",新加坡商瑞銀,33,18,15,1,1.75
"20220624","1783","003700300030004d","7000",兆豐-桃園,0,13,13,-1,1.51
"20220624","1783","0039003600320057","9600",富邦-龍潭,15,0,15,1,1.75
"20220624","1783","0039003800390043","9800",元大-板橋,0,12,12,-1,1.40
"20220624","1783","9834","9800",元大-中壢,17,2,15,1,1.75
"20220624","1783","0031003100310043","1110",台灣企銀-三民,0,10,10,-1,1.16
"20220624","1783","8440","8440",摩根大通,34,21,13,1,1.51
"20220624","1783","2180","2180",亞東,3,13,10,-1,1.16
"20220624","1783","9875","9800",元大-土城永寧,12,1,11,1,1.28
"20220624","1783","003900320030004e","9200",凱基-湖口,0,10,10,-1,1.16
"20220624","1783","1034","1030",土銀-嘉義,10,0,10,1,1.16
"20220624","1783","9285","9200",凱基-中壢,0,10,10,-1,1.16
"20220624","1783","1030","1030",土銀,10,0,10,1,1.16
"20220624","1783","9231","9200",凱基-員林,0,9,9,-1,1.05
"20220624","1783","0037003000300048","7000",兆豐-東門,10,0,10,1,1.16
"20220624","1783","9658","9600",富邦-建國,1,10,9,-1,1.05
"20220624","1783","8158","8150",台新-松江,10,0,10,1,1.16
"20220624","1783","003500330038006a","5380",第一金-安和,0,8,8,-1,0.93
"20220624","1783","8841","8840",玉山-雙和,10,0,10,1,1.16
"20220624","1783","9852","9800",元大-永春,1,9,8,-1,0.93
"20220627","1783","9278","9200",凱基-永康,26,0,26,1,7.76
"20220627","1783","003900320030004e","9200",凱基-湖口,0,7,7,-1,2.09
"20220627","1783","0035003300380043","5380",第一金-光復,18,0,18,1,5.37
"20220627","1783","0039003600390043","9600",富邦-北港,0,6,6,-1,1.79
"20220627","1783","5850","5850",統一,15,0,15,1,4.48
"20220627","1783","0039003800300061","9800",元大-承德,0,6,6,-1,1.79
"20220627","1783","1650","1650",新加坡商瑞銀,12,2,10,1,2.99
"20220627","1783","5854","5850",統一-城中,0,5,5,-1,1.49
"20220627","1783","1040","1040",臺銀,10,0,10,1,2.99
"20220627","1783","0035003900320079","5920",元富-花蓮,0,5,5,-1,1.49
"20220627","1783","9871","9800",元大-忠孝,10,0,10,1,2.99
"20220627","1783","9316","9300",華南永昌-淡水,0,5,5,-1,1.49
"20220627","1783","5855","5850",統一-台南,8,0,8,1,2.39
"20220627","1783","003900360032004c","9600",富邦-雙和,0,5,5,-1,1.49
"20220627","1783","8150","8150",台新證券,7,0,7,1,2.09
"20220627","1783","0039004100380039","9A00",永豐金-敦北,0,5,5,-1,1.49
"20220627","1783","8560","8560",新光,7,1,6,1,1.79
"20220627","1783","0039004100390047","9A00",永豐金-天母,0,5,5,-1,1.49
"20220627","1783","5322","5320",高橋-中壢,5,0,5,1,1.49
"20220627","1783","0039003100380078","9100",群益金鼎-延平,2,6,4,-1,1.19
"20220627","1783","0037003000300077","7000",兆豐-新莊,5,0,5,1,1.49
"20220627","1783","9234","9200",凱基-竹北,0,4,4,-1,1.19
"20220627","1783","9207","9200",凱基-永和,5,0,5,1,1.49
"20220627","1783","9317","9300",華南永昌-林口,0,4,4,-1,1.19
"20220627","1783","9692","9600",富邦-嘉義,5,0,5,1,1.49
"20220627","1783","003900360031004d","9600",富邦-木柵,0,4,4,-1,1.19
"20220627","1783","1117","1110",台灣企銀-竹北,4,0,4,1,1.19
"20220627","1783","5320","5320",高橋,0,3,3,-1,0.90
"20220628","1783","8157","8150",台新-左楠,97,3,94,1,2.40
"20220628","1783","1470","1470",台灣摩根士丹利,0,47,47,-1,1.20
"20220628","1783","9268","9200",凱基-台北,160,81,79,1,2.02
"20220628","1783","9655","9600",富邦-板橋,9,45,36,-1,0.92
"20220628","1783","0039003800310051","9800",元大-太平,71,1,70,1,1.79
"20220628","1783","5384","5380",第一金-台南,7,40,33,-1,0.84
"20220628","1783","1650","1650",新加坡商瑞銀,127,81,46,1,1.18
"20220628","1783","9604","9600",富邦-陽明,3,36,33,-1,0.84
"20220628","1783","0039004100300030","9A00",永豐金證券,168,124,44,1,1.13
"20220628","1783","0038003800340048","8840",玉山-新竹,8,40,32,-1,0.82
"20220628","1783","0037003700390063","7790",國票-敦北法人,41,1,40,1,1.02
"20220628","1783","0039003800320043","9800",元大-六合,6,38,32,-1,0.82
"20220628","1783","9235","9200",凱基-永華,40,0,40,1,1.02
"20220628","1783","0037003000300077","7000",兆豐-新莊,0,26,26,-1,0.66
"20220628","1783","003500380035004d","5850",統一-士林,33,3,30,1,0.77
"20220628","1783","0037003700390065","7790",國票-南科,0,24,24,-1,0.61
"20220628","1783","0035003900320079","5920",元富-花蓮,30,0,30,1,0.77
"20220628","1783","9300","9300",華南永昌,26,50,24,-1,0.61
"20220628","1783","8450","8450",康和,30,0,30,1,0.77
"20220628","1783","5603","5600",永興-台中,3,24,21,-1,0.54
"20220628","1783","1440","1440",美林,51,24,27,1,0.69
"20220628","1783","7000","7000",兆豐證券,0,21,21,-1,0.54
"20220628","1783","0039003800310069","9800",元大-西螺,29,5,24,1,0.61
"20220628","1783","5320","5320",高橋,2,22,20,-1,0.51
"20220628","1783","9256","9200",凱基-南崁,23,0,23,1,0.59
"20220628","1783","8583","8580",聯邦-忠孝,0,20,20,-1,0.51
"20220628","1783","0038003100350041","8150",台新-高雄,24,5,19,1,0.49
"20220628","1783","0039003800390058","9800",元大-民生,0,18,18,-1,0.46
"20220629","1783","0037003000300057","7000",兆豐-城中,382,125,257,1,2.85
"20220629","1783","5858","5850",統一-嘉義,0,202,202,-1,2.24
"20220629","1783","1650","1650",新加坡商瑞銀,465,301,164,1,1.82
"20220629","1783","8157","8150",台新-左楠,2,103,101,-1,1.12
"20220629","1783","9268","9200",凱基-台北,315,193,122,1,1.35
"20220629","1783","1470","1470",台灣摩根士丹利,1,57,56,-1,0.62
"20220629","1783","0039003800330042","9800",元大-林森,492,375,117,1,1.30
"20220629","1783","9302","9300",華南永昌-台中,2,51,49,-1,0.54
"20220629","1783","5920","5920",元富,591,489,102,1,1.13
"20220629","1783","0039003800310051","9800",元大-太平,12,56,44,-1,0.49
"20220629","1783","9200","9200",凱基,100,0,100,1,1.11
"20220629","1783","0037003700390063","7790",國票-敦北法人,14,52,38,-1,0.42
"20220629","1783","9235","9200",凱基-永華,125,40,85,1,0.94
"20220629","1783","9834","9800",元大-中壢,12,50,38,-1,0.42
"20220629","1783","1480","1480",美商高盛,91,24,67,1,0.74
"20220629","1783","003500380035004a","5850",統一-三重,34,71,37,-1,0.41
"20220629","1783","0031003000320046","1020",合庫-西台中,60,0,60,1,0.66
"20220629","1783","8560","8560",新光,36,70,34,-1,0.38
"20220629","1783","9204","9200",凱基-台中,94,35,59,1,0.65
"20220629","1783","0031003100310042","1110",台灣企銀-建成,4,38,34,-1,0.38
"20220629","1783","0037003000300069","7000",兆豐-松德,106,51,55,1,0.61
"20220629","1783","7001","7000",兆豐-嘉義,0,31,31,-1,0.34
"20220629","1783","0039004100390044","9A00",永豐金-忠孝,62,10,52,1,0.58
"20220629","1783","9655","9600",富邦-板橋,5,36,31,-1,0.34
"20220629","1783","9135","9100",群益金鼎-東大,58,8,50,1,0.55
"20220629","1783","003500380035004d","5850",統一-士林,6,37,31,-1,0.34
"20220629","1783","003900380031006d","9800",元大-前金,57,9,48,1,0.53
"20220629","1783","1034","1030",土銀-嘉義,0,29,29,-1,0.32
"20220630","1783","8150","8150",台新證券,466,354,112,1,0.45
"20220630","1783","5384","5380",第一金-台南,13,282,269,-1,1.08
"20220630","1783","0039003800310079","9800",元大-善化,202,115,87,1,0.35
"20220630","1783","0037003000300057","7000",兆豐-城中,11,268,257,-1,1.03
"20220630","1783","8888","8880",國泰-敦南,686,619,67,1,0.27
"20220630","1783","9268","9200",凱基-台北,824,993,169,-1,0.68
"20220630","1783","8440","8440",摩根大通,457,394,63,1,0.25
"20220630","1783","8580","8580",聯邦商銀,8,139,131,-1,0.52
"20220630","1783","9676","9600",富邦-仁愛,161,99,62,1,0.25
"20220630","1783","0039003800330042","9800",元大-林森,9,127,118,-1,0.47
"20220630","1783","9833","9800",元大-敦化,119,58,61,1,0.24
"20220630","1783","8560","8560",新光,363,474,111,-1,0.44
"20220630","1783","1650","1650",新加坡商瑞銀,586,526,60,1,0.24
"20220630","1783","0039004100390044","9A00",永豐金-忠孝,46,146,100,-1,0.40
"20220630","1783","6910","6910",德信,64,11,53,1,0.21
"20220630","1783","5920","5920",元富,25,122,97,-1,0.39
"20220630","1783","0037003700390050","7790",國票-九鼎,94,41,53,1,0.21
"20220630","1783","9256","9200",凱基-南崁,5,83,78,-1,0.31
"20220630","1783","9300","9300",華南永昌,151,98,53,1,0.21
"20220630","1783","9204","9200",凱基-台中,78,151,73,-1,0.29
"20220630","1783","0039003600310057","9600",富邦-東花蓮,67,18,49,1,0.20
"20220630","1783","0031003000320046","1020",合庫-西台中,0,70,70,-1,0.28
"20220630","1783","9863","9800",元大-和平,60,15,45,1,0.18
"20220630","1783","5854","5850",統一-城中,135,203,68,-1,0.27
"20220630","1783","9621","9600",富邦-花蓮,80,45,35,1,0.14
"20220630","1783","0035003900320079","5920",元富-花蓮,4,68,64,-1,0.26
"20220630","1783","0038003100350041","8150",台新-高雄,98,63,35,1,0.14
"20220630","1783","5603","5600",永興-台中,0,58,58,-1,0.23
"20220601","1783","0035003300380043","5380",第一金-光復,18,0,18,1,11.76
"20220601","1783","0039003800390064","9800",元大-北屯,0,25,25,-1,16.34
"20220601","1783","003500380035004a","5850",統一-三重,12,0,12,1,7.84
"20220601","1783","9300","9300",華南永昌,0,4,4,-1,2.61
"20220601","1783","8158","8150",台新-松江,10,0,10,1,6.54
"20220601","1783","0039003800310044","9800",元大-南投,0,4,4,-1,2.61
"20220601","1783","1650","1650",新加坡商瑞銀,13,4,9,1,5.88
"20220601","1783","5856","5850",統一-台中,0,2,2,-1,1.31
"20220601","1783","9800","9800",元大證券,7,1,6,1,3.92
"20220601","1783","0035003900320072","5920",元富-城東,0,2,2,-1,1.31
"20220601","1783","9322","9300",華南永昌-公誠,5,0,5,1,3.27
"20220601","1783","9268","9200",凱基-台北,3,5,2,-1,1.31
"20220601","1783","8846","8840",玉山-板橋,4,0,4,1,2.61
"20220601","1783","8440","8440",摩根大通,0,1,1,-1,0.65
"20220601","1783","003900380039004e","9800",元大-內湖,4,1,3,1,1.96
"20220601","1783","9137","9100",群益金鼎-士林,2,3,1,-1,0.65
"20220601","1783","1034","1030",土銀-嘉義,2,0,2,1,1.31
"20220601","1783","0039003600320045","9600",富邦-樹林,0,1,1,-1,0.65
"20220601","1783","1440","1440",美林,3,1,2,1,1.31
"20220601","1783","0039004100300030","9A00",永豐金證券,0,1,1,-1,0.65
"20220601","1783","0037003700390065","7790",國票-南科,2,0,2,1,1.31
"20220601","1783","9255","9200",凱基-和平,2,0,2,1,1.31
"20220601","1783","9343","9300",華南永昌-頭份,2,0,2,1,1.31
"20220601","1783","003500320036004b","5260",美好-富順,1,0,1,1,0.65
"20220602","1783","8440","8440",摩根大通,13,0,13,1,13.27
"20220602","1783","9800","9800",元大證券,0,8,8,-1,8.16
"20220602","1783","003500390032005a","5920",元富-安南,5,0,5,1,5.10
"20220602","1783","9875","9800",元大-土城永寧,0,8,8,-1,8.16
"20220602","1783","9872","9800",元大-復北,5,0,5,1,5.10
"20220602","1783","9359","9300",華南永昌-中正,0,5,5,-1,5.10
"20220602","1783","9322","9300",華南永昌-公誠,4,0,4,1,4.08
"20220602","1783","1440","1440",美林,1,5,4,-1,4.08
"20220602","1783","5858","5850",統一-嘉義,3,0,3,1,3.06
"20220602","1783","8846","8840",玉山-板橋,0,4,4,-1,4.08
"20220602","1783","8888","8880",國泰-敦南,3,0,3,1,3.06
"20220602","1783","9636","9600",富邦-中壢,0,4,4,-1,4.08
"20220602","1783","9206","9200",凱基-高雄,4,1,3,1,3.06
"20220602","1783","0039003800310071","9800",元大-萬華,0,4,4,-1,4.08
"20220602","1783","9268","9200",凱基-台北,3,0,3,1,3.06
"20220602","1783","9252","9200",凱基-嘉義,0,3,3,-1,3.06
"20220602","1783","1650","1650",新加坡商瑞銀,4,2,2,1,2.04
"20220602","1783","1470","1470",台灣摩根士丹利,0,2,2,-1,2.04
"20220602","1783","0037003700390047","7790",國票-新莊,2,0,2,1,2.04
"20220602","1783","8157","8150",台新-左楠,0,2,2,-1,2.04
"20220602","1783","003500380035004a","5850",統一-三重,1,0,1,1,1.02
"20220602","1783","8560","8560",新光,0,2,2,-1,2.04
"20220602","1783","0039003100330049","9100",群益金鼎-萬華,1,0,1,1,1.02
"20220602","1783","9255","9200",凱基-和平,0,2,2,-1,2.04
"20220602","1783","0039003600310043","9600",富邦-南京,1,0,1,1,1.02
"20220602","1783","0039003800300068","9800",元大-台北,0,2,2,-1,2.04
"20220602","1783","0039003600320045","9600",富邦-樹林,1,0,1,1,1.02
"20220602","1783","9892","9800",元大-屏東,0,2,2,-1,2.04
"20220606","1783","003500380035004a","5850",統一-三重,23,0,23,1,12.43
"20220606","1783","8159","8150",台新-台南,0,15,15,-1,8.11
"20220606","1783","8440","8440",摩根大通,25,2,23,1,12.43
"20220606","1783","0039003600310050","9600",富邦-和美,0,10,10,-1,5.41
"20220606","1783","0035003300380043","5380",第一金-光復,21,0,21,1,11.35
"20220606","1783","003900380031004b","9800",元大-林園,0,10,10,-1,5.41
"20220606","1783","1480","1480",美商高盛,13,0,13,1,7.03
"20220606","1783","1470","1470",台灣摩根士丹利,0,8,8,-1,4.32
"20220606","1783","9268","9200",凱基-台北,17,7,10,1,5.41
"20220606","1783","9891","9800",元大-永和,0,7,7,-1,3.78
"20220606","1783","7008","7000",兆豐-三重,8,0,8,1,4.32
"20220606","1783","9215","9200",凱基-高美館,0,6,6,-1,3.24
"20220606","1783","1440","1440",美林,11,6,5,1,2.70
"20220606","1783","5858","5850",統一-嘉義,0,5,5,-1,2.70
"20220606","1783","0031003000340043","1040",臺銀-高雄,5,0,5,1,2.70
"20220606","1783","0038003800340042","8840",玉山-台中,0,5,5,-1,2.70
"20220606","1783","8888","8880",國泰-敦南,5,0,5,1,2.70
"20220606","1783","9206","9200",凱基-高雄,0,5,5,-1,2.70
"20220606","1783","0039003800310044","9800",元大-南投,4,0,4,1,2.16
"20220606","1783","9322","9300",華南永昌-公誠,0,5,5,-1,2.70
"20220606","1783","003700370039007a","7790",國票-博愛,3,0,3,1,1.62
"20220606","1783","0039004100390061","9A00",永豐金-苓雅,0,5,5,-1,2.70
"20220606","1783","5112","5110",富隆-長安(停),2,0,2,1,1.08
"20220606","1783","0035003900320049","5920",元富-嘉義,0,3,3,-1,1.62
"20220606","1783","0035003800350049","5850",統一-員林,2,0,2,1,1.08
"20220606","1783","0039003200300056","9200",凱基-新店,0,3,3,-1,1.62
"20220606","1783","0035003900320069","5920",元富-中港,2,0,2,1,1.08
"20220606","1783","0039003600360046","9600",富邦-左營,0,3,3,-1,1.62
"20220607","1783","0035003300380043","5380",第一金-光復,21,0,21,1,9.59
"20220607","1783","0039003800390058","9800",元大-民生,0,9,9,-1,4.11
"20220607","1783","0037003000300048","7000",兆豐-東門,21,10,11,1,5.02
"20220607","1783","5384","5380",第一金-台南,0,8,8,-1,3.65
"20220607","1783","9655","9600",富邦-板橋,6,0,6,1,2.74
"20220607","1783","0039003600310048","9600",富邦-新板,0,7,7,-1,3.20
"20220607","1783","0039003100380073","9100",群益金鼎-丹鳳,5,0,5,1,2.28
"20220607","1783","1034","1030",土銀-嘉義,0,6,6,-1,2.74
"20220607","1783","003900380031005a","9800",元大-潮州,5,0,5,1,2.28
"20220607","1783","0031003000340043","1040",臺銀-高雄,0,5,5,-1,2.28
"20220607","1783","0039004100390078","9A00",永豐金-桃園,5,0,5,1,2.28
"20220607","1783","9268","9200",凱基-台北,0,5,5,-1,2.28
"20220607","1783","0039003600310058","9600",富邦-大墩,4,0,4,1,1.83
"20220607","1783","1470","1470",台灣摩根士丹利,0,4,4,-1,1.83
"20220607","1783","0035003900320067","5920",元富-中原,3,0,3,1,1.37
"20220607","1783","1440","1440",美林,6,10,4,-1,1.83
"20220607","1783","6161","6160",中國信託-三重,3,0,3,1,1.37
"20220607","1783","0035003900320041","5920",元富-緯城,0,4,4,-1,1.83
"20220607","1783","003900380039004a","9800",元大-彰化民生,3,0,3,1,1.37
"20220607","1783","7034","7030",致和-金華,0,4,4,-1,1.83
"20220607","1783","5602","5600",永興-水湳,2,0,2,1,0.91
"20220607","1783","9184","9100",群益金鼎-台中,0,3,3,-1,1.37
"20220607","1783","0037003700390045","7790",國票-南崁,2,0,2,1,0.91
"20220607","1783","9322","9300",華南永昌-公誠,0,3,3,-1,1.37
"20220607","1783","003800340035004a","8450",康和-高雄,3,1,2,1,0.91
"20220607","1783","9324","9300",華南永昌-岡山,0,3,3,-1,1.37
"20220607","1783","0038003800340044","8840",玉山-左營,2,0,2,1,0.91
"20220607","1783","0039003800390056","9800",元大-北三重,0,3,3,-1,1.37
"20220608","1783","0035003300380043","5380",第一金-光復,14,0,14,1,7.00
"20220608","1783","0037003000300048","7000",兆豐-東門,0,11,11,-1,5.50
"20220608","1783","1030","1030",土銀,10,0,10,1,5.00
"20220608","1783","0039003800390053","9800",元大-鹿港,0,10,10,-1,5.00
"20220608","1783","9208","9200",凱基-桃園,10,0,10,1,5.00
"20220608","1783","0039003800390058","9800",元大-民生,0,6,6,-1,3.00
"20220608","1783","9308","9300",華南永昌-麻豆,10,0,10,1,5.00
"20220608","1783","9233","9200",凱基-長庚,0,4,4,-1,2.00
"20220608","1783","1650","1650",新加坡商瑞銀,23,15,8,1,4.00
"20220608","1783","9268","9200",凱基-台北,1,5,4,-1,2.00
"20220608","1783","0031003000330046","1030",土銀-南港,5,0,5,1,2.50
"20220608","1783","9322","9300",華南永昌-公誠,0,4,4,-1,2.00
"20220608","1783","6915","6910",德信-和平,5,0,5,1,2.50
"20220608","1783","003900360031004b","9600",富邦-七賢,0,4,4,-1,2.00
"20220608","1783","1470","1470",台灣摩根士丹利,4,0,4,1,2.00
"20220608","1783","9676","9600",富邦-仁愛,0,4,4,-1,2.00
"20220608","1783","8888","8880",國泰-敦南,7,3,4,1,2.00
"20220608","1783","0039003800310071","9800",元大-萬華,5,9,4,-1,2.00
"20220608","1783","9800","9800",元大證券,5,1,4,1,2.00
"20220608","1783","9831","9800",元大-四維,0,4,4,-1,2.00
"20220608","1783","0031003000320043","1020",合庫-自強,3,0,3,1,1.50
"20220608","1783","5384","5380",第一金-台南,0,2,2,-1,1.00
"20220608","1783","1440","1440",美林,5,2,3,1,1.50
"20220608","1783","0031003000320045","1020",合庫-桃園,0,2,2,-1,1.00
"20220608","1783","0035003900320045","5920",元富-城中,3,0,3,1,1.50
"20220608","1783","003800340035004a","8450",康和-高雄,0,2,2,-1,1.00
"20220608","1783","8440","8440",摩根大通,4,1,3,1,1.50
"20220608","1783","0039003800300068","9800",元大-台北,0,2,2,-1,1.00
"20220609","1783","1650","1650",新加坡商瑞銀,11,0,11,1,20.37
"20220609","1783","0039003100380047","9100",群益金鼎-新莊,0,5,5,-1,9.26
"20220609","1783","0035003900320067","5920",元富-中原,3,0,3,1,5.56
"20220609","1783","0039003100380073","9100",群益金鼎-丹鳳,0,5,5,-1,9.26
"20220609","1783","9209","9200",凱基-岡山,3,0,3,1,5.56
"20220609","1783","0039003600310048","9600",富邦-新板,0,4,4,-1,7.41
"20220609","1783","1034","1030",土銀-嘉義,2,0,2,1,3.70
"20220609","1783","0031003000320043","1020",合庫-自強,0,3,3,-1,5.56
"20220609","1783","8848","8840",玉山-嘉義,2,0,2,1,3.70
"20220609","1783","003600310036004b","6160",中國信託-高雄,0,2,2,-1,3.70
"20220609","1783","9268","9200",凱基-台北,2,0,2,1,3.70
"20220609","1783","0038003800340042","8840",玉山-台中,0,2,2,-1,3.70
"20220609","1783","1470","1470",台灣摩根士丹利,5,4,1,1,1.85
"20220609","1783","9274","9200",凱基-鳳山,0,2,2,-1,3.70
"20220609","1783","1440","1440",美林,2,1,1,1,1.85
"20220609","1783","1113","1110",台灣企銀-九如,0,1,1,-1,1.85
"20220609","1783","0035003800350045","5850",統一-新營,1,0,1,1,1.85
"20220609","1783","6950","6950",福勝,0,1,1,-1,1.85
"20220609","1783","1023","1020",合庫-高雄,1,0,1,1,1.85
"20220609","1783","0038003100350042","8150",台新-台中,0,1,1,-1,1.85
"20220609","1783","003700300030005a","7000",兆豐-高雄,1,0,1,1,1.85
"20220609","1783","8560","8560",新光,1,2,1,-1,1.85
"20220609","1783","0039003100330044","9100",群益金鼎-潭子,1,0,1,1,1.85
"20220609","1783","8888","8880",國泰-敦南,0,1,1,-1,1.85
"20220609","1783","9627","9600",富邦-內湖,1,0,1,1,1.85
"20220609","1783","0039003100330049","9100",群益金鼎-萬華,0,1,1,-1,1.85
"20220609","1783","0039003800310047","9800",元大-彰化,1,0,1,1,1.85
"20220609","1783","9206","9200",凱基-高雄,0,1,1,-1,1.85
"20220610","1783","9268","9200",凱基-台北,15,0,15,1,12.50
"20220610","1783","003500320036004b","5260",美好-富順,0,6,6,-1,5.00
"20220610","1783","1650","1650",新加坡商瑞銀,15,2,13,1,10.83
"20220610","1783","9856","9800",元大-花蓮,0,6,6,-1,5.00
"20220610","1783","9889","9800",元大-員林,10,0,10,1,8.33
"20220610","1783","0039003800390058","9800",元大-民生,0,6,6,-1,5.00
"20220610","1783","8711","8710",陽信-石牌,5,0,5,1,4.17
"20220610","1783","0035003800350049","5850",統一-員林,1,6,5,-1,4.17
"20220610","1783","8150","8150",台新證券,7,3,4,1,3.33
"20220610","1783","6160","6160",中國信託,0,5,5,-1,4.17
"20220610","1783","8440","8440",摩根大通,5,1,4,1,3.33
"20220610","1783","0039003200320048","9200",凱基-復興,2,7,5,-1,4.17
"20220610","1783","1470","1470",台灣摩根士丹利,9,6,3,1,2.50
"20220610","1783","0039004100390061","9A00",永豐金-苓雅,0,5,5,-1,4.17
"20220610","1783","003500380035004a","5850",統一-三重,2,0,2,1,1.67
"20220610","1783","0039004100360031","9A00",永豐金-鳳山,0,4,4,-1,3.33
"20220610","1783","0037003000300043","7000",兆豐-來福,2,0,2,1,1.67
"20220610","1783","0039003800310044","9800",元大-南投,0,3,3,-1,2.50
"20220610","1783","9800","9800",元大證券,2,0,2,1,1.67
"20220610","1783","0036003300380041","6380",光和-嘉義,0,2,2,-1,1.67
"20220610","1783","1480","1480",美商高盛,1,0,1,1,0.83
"20220610","1783","9255","9200",凱基-和平,0,2,2,-1,1.67
"20220610","1783","1440","1440",美林,5,4,1,1,0.83
"20220610","1783","9324","9300",華南永昌-岡山,0,2,2,-1,1.67
"20220610","1783","7003","7000",兆豐-台中,1,0,1,1,0.83
"20220610","1783","003900380031004b","9800",元大-林園,0,2,2,-1,1.67
"20220610","1783","7791","7790",國票-台東,1,0,1,1,0.83
"20220610","1783","0039004100390053","9A00",永豐金-南京,0,2,2,-1,1.67
"20220613","1783","1470","1470",台灣摩根士丹利,12,0,12,1,15.00
"20220613","1783","0037003700390065","7790",國票-南科,0,7,7,-1,8.75
"20220613","1783","1650","1650",新加坡商瑞銀,8,1,7,1,8.75
"20220613","1783","8459","8450",康和-嘉義,0,5,5,-1,6.25
"20220613","1783","8158","8150",台新-松江,5,0,5,1,6.25
"20220613","1783","003900380033006a","9800",元大-仁愛,0,5,5,-1,6.25
"20220613","1783","9800","9800",元大證券,3,0,3,1,3.75
"20220613","1783","0038003100350059","8150",台新-新營,0,4,4,-1,5.00
"20220613","1783","8840","8840",玉山證券,3,0,3,1,3.75
"20220613","1783","8440","8440",摩根大通,0,4,4,-1,5.00
"20220613","1783","9856","9800",元大-花蓮,2,0,2,1,2.50
"20220613","1783","9268","9200",凱基-台北,3,6,3,-1,3.75
"20220613","1783","7001","7000",兆豐-嘉義,1,0,1,1,1.25
"20220613","1783","9287","9200",凱基-內湖,0,3,3,-1,3.75
"20220613","1783","6461","6460",大昌-樹林,1,0,1,1,1.25
"20220613","1783","0031003000320043","1020",合庫-自強,0,2,2,-1,2.50
"20220613","1783","003600310036004b","6160",中國信託-高雄,1,0,1,1,1.25
"20220613","1783","8711","8710",陽信-石牌,0,2,2,-1,2.50
"20220613","1783","5660","5660",日進,1,0,1,1,1.25
"20220613","1783","0039003200320048","9200",凱基-復興,0,2,2,-1,2.50
"20220613","1783","003500320036004b","5260",美好-富順,2,1,1,1,1.25
"20220613","1783","003900360032004b","9600",富邦-中和,0,2,2,-1,2.50
"20220613","1783","1440","1440",美林,7,6,1,1,1.25
"20220613","1783","0039003800310058","9800",元大-新生,0,2,2,-1,2.50
"20220613","1783","8150","8150",台新證券,1,0,1,1,1.25
"20220613","1783","1590","1590",花旗環球,0,1,1,-1,1.25
"20220613","1783","8560","8560",新光,1,0,1,1,1.25
"20220613","1783","6163","6160",中國信託-永康,0,1,1,-1,1.25
"20220614","1783","1650","1650",新加坡商瑞銀,6,0,6,1,8.00
"20220614","1783","8440","8440",摩根大通,2,12,10,-1,13.33
"20220614","1783","8158","8150",台新-松江,5,0,5,1,6.67
"20220614","1783","003800380038004b","8880",國泰-板橋,0,8,8,-1,10.67
"20220614","1783","003900410039006a","9A00",永豐金-嘉義,5,0,5,1,6.67
"20220614","1783","0035003900320041","5920",元富-緯城,0,4,4,-1,5.33
"20220614","1783","8843","8840",玉山-高雄,3,0,3,1,4.00
"20220614","1783","0039003200320048","9200",凱基-復興,0,3,3,-1,4.00
"20220614","1783","9324","9300",華南永昌-岡山,3,0,3,1,4.00
"20220614","1783","1440","1440",美林,1,3,2,-1,2.67
"20220614","1783","9654","9600",富邦-永和,3,0,3,1,4.00
"20220614","1783","0036003300380044","6380",光和-高雄,0,2,2,-1,2.67
"20220614","1783","0035003900320072","5920",元富-城東,2,0,2,1,2.67
"20220614","1783","0038003800340044","8840",玉山-左營,0,2,2,-1,2.67
"20220614","1783","6160","6160",中國信託,2,0,2,1,2.67
"20220614","1783","1590","1590",花旗環球,0,1,1,-1,1.33
"20220614","1783","8560","8560",新光,1,0,1,1,1.33
"20220614","1783","1040","1040",臺銀,0,1,1,-1,1.33
"20220614","1783","0031003000320045","1020",合庫-桃園,1,0,1,1,1.33
"20220614","1783","8157","8150",台新-左楠,0,1,1,-1,1.33
"20220614","1783","0035003900320077","5920",元富-佳里,1,0,1,1,1.33
"20220614","1783","0039003100330049","9100",群益金鼎-萬華,0,1,1,-1,1.33
"20220614","1783","7003","7000",兆豐-台中,1,0,1,1,1.33
"20220614","1783","9303","9300",華南永昌-高雄,0,1,1,-1,1.33
"20220614","1783","003900310038004b","9100",群益金鼎-東湖,1,0,1,1,1.33
"20220614","1783","0039003800310058","9800",元大-新生,0,1,1,-1,1.33
"20220614","1783","9278","9200",凱基-永康,1,0,1,1,1.33
"20220614","1783","003900380033005a","9800",元大-鳳山,0,1,1,-1,1.33
"20220615","1783","8440","8440",摩根大通,9,0,9,1,14.52
"20220615","1783","8888","8880",國泰-敦南,0,4,4,-1,6.45
"20220615","1783","1440","1440",美林,9,1,8,1,12.90
"20220615","1783","0039003800320041","9800",元大-羅東,0,4,4,-1,6.45
"20220615","1783","0035003300380043","5380",第一金-光復,6,0,6,1,9.68
"20220615","1783","003800340035004a","8450",康和-高雄,0,3,3,-1,4.84
"20220615","1783","0035003900320050","5920",元富-同大,3,0,3,1,4.84
"20220615","1783","9208","9200",凱基-桃園,0,3,3,-1,4.84
"20220615","1783","1650","1650",新加坡商瑞銀,5,3,2,1,3.23
"20220615","1783","6463","6460",大昌-新竹,0,2,2,-1,3.23
"20220615","1783","0039003800390066","9800",元大-東港,2,0,2,1,3.23
"20220615","1783","9215","9200",凱基-高美館,0,2,2,-1,3.23
"20220615","1783","003700300030004b","7000",兆豐-新營,1,0,1,1,1.61
"20220615","1783","9852","9800",元大-永春,0,2,2,-1,3.23
"20220615","1783","0035003900320063","5920",元富-烏日,1,0,1,1,1.61
"20220615","1783","0036003300380044","6380",光和-高雄,0,1,1,-1,1.61
"20220615","1783","003900410039004e","9A00",永豐金-桃盛,1,0,1,1,1.61
"20220615","1783","0035003900320049","5920",元富-嘉義,0,1,1,-1,1.61
"20220615","1783","0039003800300065","9800",元大-清水,0,0,0,1,0.00
"20220615","1783","7003","7000",兆豐-台中,0,1,1,-1,1.61
"20220615","1783","8156","8150",台新-三民,0,0,0,1,0.00
"20220615","1783","1115","1110",台灣企銀-太平,0,1,1,-1,1.61
"20220615","1783","0031003200360058","1260",宏遠-新化,0,0,0,1,0.00
"20220615","1783","1111","1110",台灣企銀-台中,0,1,1,-1,1.61
"20220615","1783","9211","9200",凱基-台南,0,0,0,1,0.00
"20220615","1783","0038003400350046","8450",康和-仁愛,0,1,1,-1,1.61
"20220615","1783","0039004100390037","9A00",永豐金-新竹,0,0,0,1,0.00
"20220615","1783","8560","8560",新光,1,2,1,-1,1.61
"20220516","1783","8847","8840",玉山-台南,6,0,6,1,8.22
"20220516","1783","9268","9200",凱基-台北,5,12,7,-1,9.59
"20220516","1783","1440","1440",美林,5,1,4,1,5.48
"20220516","1783","003600310036004b","6160",中國信託-高雄,0,5,5,-1,6.85
"20220516","1783","0039004100390043","9A00",永豐金-員林,8,4,4,1,5.48
"20220516","1783","0035003800350046","5850",統一-彰化,0,5,5,-1,6.85
"20220516","1783","0039004100390068","9A00",永豐金-台南,4,0,4,1,5.48
"20220516","1783","8843","8840",玉山-高雄,0,4,4,-1,5.48
"20220516","1783","9302","9300",華南永昌-台中,3,0,3,1,4.11
"20220516","1783","0039003100380043","9100",群益金鼎-古亭,0,4,4,-1,5.48
"20220516","1783","9322","9300",華南永昌-公誠,3,0,3,1,4.11
"20220516","1783","0039003800320043","9800",元大-六合,0,4,4,-1,5.48
"20220516","1783","0038003100350041","8150",台新-高雄,2,0,2,1,2.74
"20220516","1783","8888","8880",國泰-敦南,0,2,2,-1,2.74
"20220516","1783","9255","9200",凱基-和平,2,0,2,1,2.74
"20220516","1783","003900380031004c","9800",元大-莒光,0,2,2,-1,2.74
"20220516","1783","9800","9800",元大證券,2,0,2,1,2.74
"20220516","1783","1480","1480",美商高盛,0,1,1,-1,1.37
"20220516","1783","9812","9800",元大-台中,2,0,2,1,2.74
"20220516","1783","1040","1040",臺銀,0,1,1,-1,1.37
"20220516","1783","0039003800310042","9800",元大-竹北,2,0,2,1,2.74
"20220516","1783","0035003900320076","5920",元富-桃園,0,1,1,-1,1.37
"20220516","1783","9897","9800",元大-土城,2,0,2,1,2.74
"20220516","1783","8584","8580",聯邦-雙和,0,1,1,-1,1.37
"20220516","1783","003900380039004e","9800",元大-內湖,2,0,2,1,2.74
"20220516","1783","8585","8580",聯邦-三重,0,1,1,-1,1.37
"20220516","1783","8440","8440",摩根大通,3,2,1,1,1.37
"20220516","1783","0039003600310043","9600",富邦-南京,0,1,1,-1,1.37
"20220517","1783","0031003000330046","1030",土銀-南港,10,0,10,1,10.20
"20220517","1783","003900380033004b","9800",元大-學甲,0,12,12,-1,12.24
"20220517","1783","0039003200300043","9200",凱基-雙和,10,0,10,1,10.20
"20220517","1783","8451","8450",康和-延平,0,5,5,-1,5.10
"20220517","1783","9268","9200",凱基-台北,16,7,9,1,9.18
"20220517","1783","9252","9200",凱基-嘉義,0,3,3,-1,3.06
"20220517","1783","8440","8440",摩根大通,5,0,5,1,5.10
"20220517","1783","0039004100390078","9A00",永豐金-桃園,0,3,3,-1,3.06
"20220517","1783","9302","9300",華南永昌-台中,5,0,5,1,5.10
"20220517","1783","003500330038004e","5380",第一金-豐原,0,2,2,-1,2.04
"20220517","1783","9800","9800",元大證券,3,0,3,1,3.06
"20220517","1783","003500320036004b","5260",美好-富順,0,1,1,-1,1.02
"20220517","1783","9812","9800",元大-台中,3,0,3,1,3.06
"20220517","1783","5266","5260",美好-中壢,0,1,1,-1,1.02
"20220517","1783","1650","1650",新加坡商瑞銀,5,3,2,1,2.04
"20220517","1783","003500380035004a","5850",統一-三重,0,1,1,-1,1.02
"20220517","1783","1470","1470",台灣摩根士丹利,2,0,2,1,2.04
"20220517","1783","0035003900320050","5920",元富-同大,0,1,1,-1,1.02
"20220517","1783","1440","1440",美林,6,4,2,1,2.04
"20220517","1783","0038003100350059","8150",台新-新營,0,1,1,-1,1.02
"20220517","1783","003700370039004a","7790",國票-北高雄,2,0,2,1,2.04
"20220517","1783","8886","8880",國泰-新莊,0,1,1,-1,1.02
"20220517","1783","8560","8560",新光,1,0,1,1,1.02
"20220517","1783","0039003100330059","9100",群益金鼎-館前,0,1,1,-1,1.02
"20220517","1783","8847","8840",玉山-台南,1,0,1,1,1.02
"20220517","1783","003900320030005a","9200",凱基-台東,0,1,1,-1,1.02
"20220517","1783","9623","9600",富邦-台北,1,0,1,1,1.02
"20220517","1783","0039003600310046","9600",富邦-中港,0,1,1,-1,1.02
"20220518","1783","1650","1650",新加坡商瑞銀,12,1,11,1,13.41
"20220518","1783","9833","9800",元大-敦化,0,5,5,-1,6.10
"20220518","1783","9231","9200",凱基-員林,8,0,8,1,9.76
"20220518","1783","003500320036004b","5260",美好-富順,0,4,4,-1,4.88
"20220518","1783","0039003100380073","9100",群益金鼎-丹鳳,5,0,5,1,6.10
"20220518","1783","0035003900320041","5920",元富-緯城,0,4,4,-1,4.88
"20220518","1783","0039003100380045","9100",群益金鼎-南京,4,0,4,1,4.88
"20220518","1783","9255","9200",凱基-和平,0,4,4,-1,4.88
"20220518","1783","0039004100390043","9A00",永豐金-員林,4,0,4,1,4.88
"20220518","1783","9831","9800",元大-四維,0,4,4,-1,4.88
"20220518","1783","1034","1030",土銀-嘉義,3,0,3,1,3.66
"20220518","1783","9647","9600",富邦-新竹,0,3,3,-1,3.66
"20220518","1783","003900380033005a","9800",元大-鳳山,2,0,2,1,2.44
"20220518","1783","0039003800390045","9800",元大-草屯,0,3,3,-1,3.66
"20220518","1783","0039003800380042","9800",元大-桃園,2,0,2,1,2.44
"20220518","1783","0035003900320077","5920",元富-佳里,0,2,2,-1,2.44
"20220518","1783","0039004100390068","9A00",永豐金-台南,2,0,2,1,2.44
"20220518","1783","0035003800350067","5850",統一-平鎮,0,2,2,-1,2.44
"20220518","1783","1480","1480",美商高盛,1,0,1,1,1.22
"20220518","1783","003800340035004a","8450",康和-高雄,0,2,2,-1,2.44
"20220518","1783","1470","1470",台灣摩根士丹利,1,0,1,1,1.22
"20220518","1783","9655","9600",富邦-板橋,0,2,2,-1,2.44
"20220518","1783","1440","1440",美林,4,3,1,1,1.22
"20220518","1783","0039003800310053","9800",元大-崇德,0,2,2,-1,2.44
"20220518","1783","8847","8840",玉山-台南,3,2,1,1,1.22
"20220518","1783","0039004100390037","9A00",永豐金-新竹,0,2,2,-1,2.44
"20220518","1783","0039003100380044","9100",群益金鼎-東門,1,0,1,1,1.22
"20220518","1783","1590","1590",花旗環球,0,1,1,-1,1.22
"20220519","1783","5383","5380",第一金-高雄,5,0,5,1,12.50
"20220519","1783","0035003900320041","5920",元富-緯城,0,5,5,-1,12.50
"20220519","1783","1650","1650",新加坡商瑞銀,6,1,5,1,12.50
"20220519","1783","9268","9200",凱基-台北,2,5,3,-1,7.50
"20220519","1783","6463","6460",大昌-新竹,2,0,2,1,5.00
"20220519","1783","0037003000300061","7000",兆豐-忠孝,0,2,2,-1,5.00
"20220519","1783","8848","8840",玉山-嘉義,2,0,2,1,5.00
"20220519","1783","1440","1440",美林,0,2,2,-1,5.00
"20220519","1783","8888","8880",國泰-敦南,2,0,2,1,5.00
"20220519","1783","8456","8450",康和-新竹,0,2,2,-1,5.00
"20220519","1783","0037003000300069","7000",兆豐-松德,1,0,1,1,2.50
"20220519","1783","003800380038004b","8880",國泰-板橋,0,2,2,-1,5.00
"20220519","1783","9215","9200",凱基-高美館,1,0,1,1,2.50
"20220519","1783","0035003900320042","5920",元富-永和,0,1,1,-1,2.50
"20220519","1783","9252","9200",凱基-嘉義,1,0,1,1,2.50
"20220519","1783","8886","8880",國泰-新莊,0,1,1,-1,2.50
"20220519","1783","003700300030005a","7000",兆豐-高雄,0,0,0,1,0.00
"20220519","1783","0039003100380043","9100",群益金鼎-古亭,0,1,1,-1,2.50
"20220519","1783","9319","9300",華南永昌-鶯歌,0,0,0,1,0.00
"20220519","1783","9305","9300",華南永昌-新莊,0,1,1,-1,2.50
"20220519","1783","9873","9800",元大-西門,0,0,0,1,0.00
"20220519","1783","0039003600320044","9600",富邦-新莊,0,1,1,-1,2.50
"20220519","1783","0039004100390032","9A00",永豐金-萬盛,0,0,0,1,0.00
"20220519","1783","0039003600320045","9600",富邦-樹林,0,1,1,-1,2.50
"20220519","1783","8440","8440",摩根大通,2,2,0,1,0.00
"20220519","1783","0039003800330056","9800",元大-竹南,0,1,1,-1,2.50
"20220519","1783","0039003100380046","9100",群益金鼎-新店,1,1,0,1,0.00
"20220519","1783","0039003800350043","9800",元大-鳳中,0,1,1,-1,2.50
"20220520","1783","9867","9800",元大-北成功,10,2,8,1,8.51
"20220520","1783","1650","1650",新加坡商瑞銀,1,12,11,-1,11.70
"20220520","1783","1440","1440",美林,4,0,4,1,4.26
"20220520","1783","0035003300380041","5380",第一金-新興,0,5,5,-1,5.32
"20220520","1783","0039003800300061","9800",元大-承德,3,0,3,1,3.19
"20220520","1783","9268","9200",凱基-台北,1,5,4,-1,4.26
"20220520","1783","0036003300380041","6380",光和-嘉義,2,0,2,1,2.13
"20220520","1783","8888","8880",國泰-敦南,0,2,2,-1,2.13
"20220520","1783","1034","1030",土銀-嘉義,3,1,2,1,2.13
"20220520","1783","003800380038004b","8880",國泰-板橋,0,2,2,-1,2.13
"20220520","1783","5384","5380",第一金-台南,2,0,2,1,2.13
"20220520","1783","9266","9200",凱基-新豐,0,2,2,-1,2.13
"20220520","1783","8560","8560",新光,2,0,2,1,2.13
"20220520","1783","9303","9300",華南永昌-高雄,0,2,2,-1,2.13
"20220520","1783","9252","9200",凱基-嘉義,4,2,2,1,2.13
"20220520","1783","0039004100390038","9A00",永豐金-大園,0,2,2,-1,2.13
"20220520","1783","9386","9300",華南永昌-東昇,2,0,2,1,2.13
"20220520","1783","5925","5920",元富-台中,0,1,1,-1,1.06
"20220520","1783","0039004100390052","9A00",永豐金-信義,2,0,2,1,2.13
"20220520","1783","0037003000300069","7000",兆豐-松德,0,1,1,-1,1.06
"20220520","1783","5850","5850",統一,1,0,1,1,1.06
"20220520","1783","0039003100330044","9100",群益金鼎-潭子,0,1,1,-1,1.06
"20220520","1783","0035003300380044","5380",第一金-忠孝,1,0,1,1,1.06
"20220520","1783","0039003100330049","9100",群益金鼎-萬華,0,1,1,-1,1.06
"20220520","1783","0035003800350049","5850",統一-員林,5,4,1,1,1.06
"20220520","1783","9285","9200",凱基-中壢,0,1,1,-1,1.06
"20220520","1783","8440","8440",摩根大通,1,0,1,1,1.06
"20220520","1783","9302","9300",華南永昌-台中,0,1,1,-1,1.06
"20220523","1783","9268","9200",凱基-台北,14,2,12,1,7.06
"20220523","1783","8885","8880",國泰-桃園,0,50,50,-1,29.41
"20220523","1783","1650","1650",新加坡商瑞銀,14,4,10,1,5.88
"20220523","1783","0039003100380073","9100",群益金鼎-丹鳳,0,5,5,-1,2.94
"20220523","1783","1470","1470",台灣摩根士丹利,10,0,10,1,5.88
"20220523","1783","0036003300380041","6380",光和-嘉義,0,2,2,-1,1.18
"20220523","1783","0039003100380045","9100",群益金鼎-南京,10,0,10,1,5.88
"20220523","1783","9255","9200",凱基-和平,2,4,2,-1,1.18
"20220523","1783","9665","9600",富邦-桃園,10,0,10,1,5.88
"20220523","1783","003500380035004a","5850",統一-三重,0,1,1,-1,0.59
"20220523","1783","6461","6460",大昌-樹林,8,0,8,1,4.71
"20220523","1783","0035003800350049","5850",統一-員林,2,3,1,-1,0.59
"20220523","1783","8440","8440",摩根大通,5,0,5,1,2.94
"20220523","1783","0035003800350044","5850",統一-新台中,1,2,1,-1,0.59
"20220523","1783","9238","9200",凱基-士林,5,0,5,1,2.94
"20220523","1783","0036003100360041","6160",中國信託-中壢,0,1,1,-1,0.59
"20220523","1783","9366","9300",華南永昌-豐原,5,0,5,1,2.94
"20220523","1783","0039003800310044","9800",元大-南投,0,1,1,-1,0.59
"20220523","1783","8560","8560",新光,5,0,5,1,2.94
"20220523","1783","0039003800310069","9800",元大-西螺,0,1,1,-1,0.59
"20220523","1783","1440","1440",美林,5,1,4,1,2.35
"20220523","1783","0039003800310049","9800",元大-天母,0,1,1,-1,0.59
"20220523","1783","0039003200300056","9200",凱基-新店,3,0,3,1,1.76
"20220523","1783","0039003800310071","9800",元大-萬華,0,1,1,-1,0.59
"20220523","1783","9272","9200",凱基-竹科,3,0,3,1,1.76
"20220523","1783","0039003800340048","9800",元大-景美,0,1,1,-1,0.59
"20220523","1783","0039003600320045","9600",富邦-樹林,3,0,3,1,1.76
"20220523","1783","9854","9800",元大-文心興安,0,1,1,-1,0.59
"20220524","1783","8560","8560",新光,14,0,14,1,19.18
"20220524","1783","9268","9200",凱基-台北,1,10,9,-1,12.33
"20220524","1783","9867","9800",元大-北成功,8,0,8,1,10.96
"20220524","1783","1440","1440",美林,0,4,4,-1,5.48
"20220524","1783","9303","9300",華南永昌-高雄,4,0,4,1,5.48
"20220524","1783","0039003100330044","9100",群益金鼎-潭子,0,4,4,-1,5.48
"20220524","1783","5384","5380",第一金-台南,3,0,3,1,4.11
"20220524","1783","003900380036004b","9800",元大-基隆孝二,0,3,3,-1,4.11
"20220524","1783","0039003800310044","9800",元大-南投,3,0,3,1,4.11
"20220524","1783","1042","1040",臺銀-臺南,0,2,2,-1,2.74
"20220524","1783","1650","1650",新加坡商瑞銀,2,0,2,1,2.74
"20220524","1783","0038003100350041","8150",台新-高雄,0,1,1,-1,1.37
"20220524","1783","1470","1470",台灣摩根士丹利,2,0,2,1,2.74
"20220524","1783","0039003100380044","9100",群益金鼎-東門,0,1,1,-1,1.37
"20220524","1783","9255","9200",凱基-和平,2,0,2,1,2.74
"20220524","1783","9215","9200",凱基-高美館,0,1,1,-1,1.37
"20220524","1783","003900380039004e","9800",元大-內湖,2,0,2,1,2.74
"20220524","1783","9815","9800",元大-大灣,0,1,1,-1,1.37
"20220524","1783","0039003800390050","9800",元大-敦南,2,0,2,1,2.74
"20220524","1783","0039003800390043","9800",元大-板橋,0,1,1,-1,1.37
"20220524","1783","8888","8880",國泰-敦南,1,0,1,1,1.37
"20220524","1783","0039004100390042","9A00",永豐金-中和,0,1,1,-1,1.37
"20220524","1783","0037003000300069","7000",兆豐-松德,1,0,1,1,1.37
"20220524","1783","0039004100390052","9A00",永豐金-信義,1,2,1,-1,1.37
"20220524","1783","0035003800350044","5850",統一-新台中,1,0,1,1,1.37
"20220525","1783","9268","9200",凱基-台北,7,2,5,1,13.51
"20220525","1783","6915","6910",德信-和平,0,5,5,-1,13.51
"20220525","1783","1650","1650",新加坡商瑞銀,4,0,4,1,10.81
"20220525","1783","9693","9600",富邦-新營,0,4,4,-1,10.81
"20220525","1783","8440","8440",摩根大通,3,0,3,1,8.11
"20220525","1783","0039003800310071","9800",元大-萬華,0,3,3,-1,8.11
"20220525","1783","0035003300380043","5380",第一金-光復,3,0,3,1,8.11
"20220525","1783","8847","8840",玉山-台南,0,2,2,-1,5.41
"20220525","1783","9852","9800",元大-永春,3,0,3,1,8.11
"20220525","1783","0039003800330057","9800",元大-大里德芳,0,2,2,-1,5.41
"20220525","1783","0035003900320072","5920",元富-城東,2,0,2,1,5.41
"20220525","1783","0037003000300048","7000",兆豐-東門,0,1,1,-1,2.70
"20220525","1783","003500320036004b","5260",美好-富順,1,0,1,1,2.70
"20220525","1783","1039","1030",土銀-士林,0,1,1,-1,2.70
"20220525","1783","0035003900320071","5920",元富-屏東,1,0,1,1,2.70
"20220525","1783","8458","8450",康和-台南,0,1,1,-1,2.70
"20220525","1783","0039003600320045","9600",富邦-樹林,1,0,1,1,2.70
"20220525","1783","8849","8840",玉山-景美,0,1,1,-1,2.70
"20220525","1783","0039003800300043","9800",元大-斗六,1,0,1,1,2.70
"20220525","1783","9623","9600",富邦-台北,0,1,1,-1,2.70
"20220525","1783","0039004100390043","9A00",永豐金-員林,1,0,1,1,2.70
"20220525","1783","9874","9800",元大-雙和,0,1,1,-1,2.70
"20220525","1783","8840","8840",玉山證券,0,0,0,1,0.00
"20220525","1783","003900380039004e","9800",元大-內湖,0,1,1,-1,2.70
"20220525","1783","003500390032006c","5920",元富-大裕,0,0,0,1,0.00
"20220525","1783","1020","1020",合庫證券,0,0,0,1,0.00
"20220526","1783","9268","9200",凱基-台北,12,2,10,1,14.49
"20220526","1783","0039003800310049","9800",元大-天母,0,9,9,-1,13.04
"20220526","1783","0039003800320042","9800",元大-博愛,10,0,10,1,14.49
"20220526","1783","003900380034004b","9800",元大-館前,0,5,5,-1,7.25
"20220526","1783","0031003100310041","1110",台灣企銀-民雄,5,0,5,1,7.25
"20220526","1783","0035003900320072","5920",元富-城東,0,4,4,-1,5.80
"20220526","1783","003700300030004b","7000",兆豐-新營,5,0,5,1,7.25
"20220526","1783","0035003800350049","5850",統一-員林,0,2,2,-1,2.90
"20220526","1783","0035003900320077","5920",元富-佳里,2,0,2,1,2.90
"20220526","1783","1650","1650",新加坡商瑞銀,0,2,2,-1,2.90
"20220526","1783","0037003700390065","7790",國票-南科,2,0,2,1,2.90
"20220526","1783","9252","9200",凱基-嘉義,0,2,2,-1,2.90
"20220526","1783","003900380039004e","9800",元大-內湖,2,0,2,1,2.90
"20220526","1783","9377","9300",華南永昌-虎尾,0,2,2,-1,2.90
"20220526","1783","1440","1440",美林,2,1,1,1,1.45
"20220526","1783","9852","9800",元大-永春,0,2,2,-1,2.90
"20220526","1783","9692","9600",富邦-嘉義,1,0,1,1,1.45
"20220526","1783","7750","7750",北城證券,0,1,1,-1,1.45
"20220526","1783","0039003800310044","9800",元大-南投,1,0,1,1,1.45
"20220526","1783","0037003000300073","7000",兆豐-岡山,0,1,1,-1,1.45
"20220526","1783","003900380031004e","9800",元大-金門,1,0,1,1,1.45
"20220526","1783","5323","5320",高橋-內壢,0,1,1,-1,1.45
"20220526","1783","9863","9800",元大-和平,0,0,0,1,0.00
"20220526","1783","003500320036004b","5260",美好-富順,0,1,1,-1,1.45
"20220526","1783","0039003800330047","9800",元大-上新莊,0,0,0,1,0.00
"20220526","1783","0035003800350044","5850",統一-新台中,0,1,1,-1,1.45
"20220526","1783","7790","7790",國票證券,0,0,0,1,0.00
"20220526","1783","8458","8450",康和-台南,0,1,1,-1,1.45
"20220527","1783","9268","9200",凱基-台北,12,2,10,1,13.51
"20220527","1783","1470","1470",台灣摩根士丹利,0,7,7,-1,9.46
"20220527","1783","1440","1440",美林,7,2,5,1,6.76
"20220527","1783","8843","8840",玉山-高雄,0,6,6,-1,8.11
"20220527","1783","0038003100350059","8150",台新-新營,4,0,4,1,5.41
"20220527","1783","003900320031004a","9200",凱基-土城,0,5,5,-1,6.76
"20220527","1783","9319","9300",華南永昌-鶯歌,3,0,3,1,4.05
"20220527","1783","9215","9200",凱基-高美館,1,3,2,-1,2.70
"20220527","1783","1650","1650",新加坡商瑞銀,2,0,2,1,2.70
"20220527","1783","5112","5110",富隆-長安(停),0,2,2,-1,2.70
"20220527","1783","0035003800350049","5850",統一-員林,2,0,2,1,2.70
"20220527","1783","9255","9200",凱基-和平,0,2,2,-1,2.70
"20220527","1783","0035003900320072","5920",元富-城東,2,0,2,1,2.70
"20220527","1783","9377","9300",華南永昌-虎尾,0,2,2,-1,2.70
"20220527","1783","9343","9300",華南永昌-頭份,2,0,2,1,2.70
"20220527","1783","003900410039004e","9A00",永豐金-桃盛,0,2,2,-1,2.70
"20220527","1783","9892","9800",元大-屏東,2,0,2,1,2.70
"20220527","1783","0037003000300069","7000",兆豐-松德,0,1,1,-1,1.35
"20220527","1783","0035003900320049","5920",元富-嘉義,1,0,1,1,1.35
"20220527","1783","5858","5850",統一-嘉義,0,1,1,-1,1.35
"20220527","1783","1116","1110",台灣企銀-屏東,1,0,1,1,1.35
"20220527","1783","0038003100350042","8150",台新-台中,0,1,1,-1,1.35
"20220527","1783","003700300030004b","7000",兆豐-新營,1,0,1,1,1.35
"20220527","1783","8842","8840",玉山-新莊,0,1,1,-1,1.35
"20220527","1783","0039003100330049","9100",群益金鼎-萬華,1,0,1,1,1.35
"20220527","1783","8882","8880",國泰-台中,0,1,1,-1,1.35
"20220527","1783","9185","9100",群益金鼎-台南,1,0,1,1,1.35
"20220527","1783","8888","8880",國泰-敦南,0,1,1,-1,1.35
"20220530","1783","9268","9200",凱基-台北,24,2,22,1,18.80
"20220530","1783","6382","6380",光和-田中,0,10,10,-1,8.55
"20220530","1783","8158","8150",台新-松江,20,0,20,1,17.09
"20220530","1783","0039004100390038","9A00",永豐金-大園,0,9,9,-1,7.69
"20220530","1783","1650","1650",新加坡商瑞銀,6,0,6,1,5.13
"20220530","1783","1470","1470",台灣摩根士丹利,0,8,8,-1,6.84
"20220530","1783","0035003900320077","5920",元富-佳里,5,0,5,1,4.27
"20220530","1783","9215","9200",凱基-高美館,0,7,7,-1,5.98
"20220530","1783","0037003000300042","7000",兆豐-板橋,4,0,4,1,3.42
"20220530","1783","0035003900320047","5920",元富-新竹,0,3,3,-1,2.56
"20220530","1783","8440","8440",摩根大通,4,0,4,1,3.42
"20220530","1783","0035003900320076","5920",元富-桃園,0,3,3,-1,2.56
"20220530","1783","0039004100390043","9A00",永豐金-員林,5,1,4,1,3.42
"20220530","1783","003500380035004a","5850",統一-三重,0,3,3,-1,2.56
"20220530","1783","0037003000300043","7000",兆豐-來福,2,0,2,1,1.71
"20220530","1783","7750","7750",北城證券,0,2,2,-1,1.71
"20220530","1783","9303","9300",華南永昌-高雄,2,0,2,1,1.71
"20220530","1783","8849","8840",玉山-景美,0,2,2,-1,1.71
"20220530","1783","9319","9300",華南永昌-鶯歌,2,0,2,1,1.71
"20220530","1783","8888","8880",國泰-敦南,0,2,2,-1,1.71
"20220530","1783","1440","1440",美林,1,0,1,1,0.85
"20220530","1783","5858","5850",統一-嘉義,0,1,1,-1,0.85
"20220530","1783","0035003800350049","5850",統一-員林,2,1,1,1,0.85
"20220530","1783","0035003900320058","5920",元富-草屯,0,1,1,-1,0.85
"20220530","1783","003900360031004d","9600",富邦-木柵,1,0,1,1,0.85
"20220530","1783","8380","8380",安泰,0,1,1,-1,0.85
"20220530","1783","0039003600320044","9600",富邦-新莊,1,0,1,1,0.85
"20220530","1783","8561","8560",新光-台中,0,1,1,-1,0.85
"20220531","1783","0039004100390043","9A00",永豐金-員林,17,2,15,1,7.18
"20220531","1783","6163","6160",中國信託-永康,0,10,10,-1,4.78
"20220531","1783","0037003700390065","7790",國票-南科,12,0,12,1,5.74
"20220531","1783","1470","1470",台灣摩根士丹利,0,10,10,-1,4.78
"20220531","1783","9268","9200",凱基-台北,24,12,12,1,5.74
"20220531","1783","0036003100360041","6160",中國信託-中壢,0,10,10,-1,4.78
"20220531","1783","1650","1650",新加坡商瑞銀,14,3,11,1,5.26
"20220531","1783","9817","9800",元大-東泰,0,10,10,-1,4.78
"20220531","1783","003900380031004b","9800",元大-林園,10,0,10,1,4.78
"20220531","1783","9303","9300",華南永昌-高雄,0,7,7,-1,3.35
"20220531","1783","7080","7080",石橋證券,5,0,5,1,2.39
"20220531","1783","0039004100360031","9A00",永豐金-鳳山,0,5,5,-1,2.39
"20220531","1783","8560","8560",新光,20,15,5,1,2.39
"20220531","1783","1440","1440",美林,5,9,4,-1,1.91
"20220531","1783","0039004100390063","9A00",永豐金-永康,4,2,2,1,0.96
"20220531","1783","9634","9600",富邦-羅東,0,4,4,-1,1.91
"20220531","1783","0039003200320048","9200",凱基-復興,2,1,1,1,0.48
"20220531","1783","1034","1030",土銀-嘉義,0,3,3,-1,1.44
"20220531","1783","5265","5260",美好-苗栗,2,1,1,1,0.48
"20220531","1783","9215","9200",凱基-高美館,3,6,3,-1,1.44
"20220531","1783","0037003000300061","7000",兆豐-忠孝,1,0,1,1,0.48
"20220531","1783","9800","9800",元大證券,0,3,3,-1,1.44
"20220531","1783","9137","9100",群益金鼎-士林,1,0,1,1,0.48
"20220531","1783","0039003800300061","9800",元大-承德,0,3,3,-1,1.44
"20220531","1783","0039003200300056","9200",凱基-新店,1,0,1,1,0.48
"20220531","1783","5858","5850",統一-嘉義,0,2,2,-1,0.96
"20220531","1783","9285","9200",凱基-中壢,1,0,1,1,0.48
"20220531","1783","003700300030004b","7000",兆豐-新營,0,2,2,-1,0.96
"20220503","1783","8583","8580",聯邦-忠孝,10,0,10,1,8.47
"20220503","1783","0039003800390046","9800",元大-高雄,0,10,10,-1,8.47
"20220503","1783","1034","1030",土銀-嘉義,9,0,9,1,7.63
"20220503","1783","1470","1470",台灣摩根士丹利,0,9,9,-1,7.63
"20220503","1783","7001","7000",兆豐-嘉義,5,0,5,1,4.24
"20220503","1783","7750","7750",北城證券,0,5,5,-1,4.24
"20220503","1783","8843","8840",玉山-高雄,3,0,3,1,2.54
"20220503","1783","0039003100380043","9100",群益金鼎-古亭,0,5,5,-1,4.24
"20220503","1783","9238","9200",凱基-士林,3,0,3,1,2.54
"20220503","1783","9322","9300",華南永昌-公誠,4,9,5,-1,4.24
"20220503","1783","0039004100390038","9A00",永豐金-大園,5,2,3,1,2.54
"20220503","1783","9625","9600",富邦-竹東,0,5,5,-1,4.24
"20220503","1783","8888","8880",國泰-敦南,3,0,3,1,2.54
"20220503","1783","0039004100370039","9A00",永豐金-埔里,0,3,3,-1,2.54
"20220503","1783","1480","1480",美商高盛,2,0,2,1,1.69
"20220503","1783","8451","8450",康和-延平,0,2,2,-1,1.69
"20220503","1783","0039003200300044","9200",凱基-市府,2,0,2,1,1.69
"20220503","1783","8711","8710",陽信-石牌,0,2,2,-1,1.69
"20220503","1783","9305","9300",華南永昌-新莊,2,0,2,1,1.69
"20220503","1783","9255","9200",凱基-和平,0,2,2,-1,1.69
"20220503","1783","0039003600310051","9600",富邦-重新,2,0,2,1,1.69
"20220503","1783","9873","9800",元大-西門,0,2,2,-1,1.69
"20220503","1783","9667","9600",富邦-台南,2,0,2,1,1.69
"20220503","1783","0035003900320061","5920",元富-松德,0,2,2,-1,1.69
"20220503","1783","9813","9800",元大-八德,2,0,2,1,1.69
"20220503","1783","9800","9800",元大證券,1,2,1,-1,0.85
"20220503","1783","9893","9800",元大-大天母,3,1,2,1,1.69
"20220503","1783","003700300030004d","7000",兆豐-桃園,0,1,1,-1,0.85
"20220504","1783","0039004100390043","9A00",永豐金-員林,15,0,15,1,8.47
"20220504","1783","1114","1110",台灣企銀-嘉義,0,25,25,-1,14.12
"20220504","1783","9366","9300",華南永昌-豐原,14,0,14,1,7.91
"20220504","1783","8848","8840",玉山-嘉義,0,21,21,-1,11.86
"20220504","1783","8158","8150",台新-松江,10,0,10,1,5.65
"20220504","1783","1470","1470",台灣摩根士丹利,0,8,8,-1,4.52
"20220504","1783","1034","1030",土銀-嘉義,8,0,8,1,4.52
"20220504","1783","003900320031004d","9200",凱基-八德,0,5,5,-1,2.82
"20220504","1783","8560","8560",新光,7,0,7,1,3.95
"20220504","1783","9831","9800",元大-四維,0,5,5,-1,2.82
"20220504","1783","0035003300380043","5380",第一金-光復,6,0,6,1,3.39
"20220504","1783","6163","6160",中國信託-永康,0,4,4,-1,2.26
"20220504","1783","1650","1650",新加坡商瑞銀,5,0,5,1,2.82
"20220504","1783","0039003600320048","9600",富邦-鳳山,0,4,4,-1,2.26
"20220504","1783","7001","7000",兆豐-嘉義,5,0,5,1,2.82
"20220504","1783","0039003600330041","9600",富邦-八德,0,4,4,-1,2.26
"20220504","1783","8440","8440",摩根大通,6,1,5,1,2.82
"20220504","1783","1440","1440",美林,5,8,3,-1,1.69
"20220504","1783","9852","9800",元大-永春,5,0,5,1,2.82
"20220504","1783","0038003800340043","8840",玉山-南京東路,0,3,3,-1,1.69
"20220504","1783","5389","5380",第一金-中山,3,0,3,1,1.69
"20220504","1783","9268","9200",凱基-台北,30,33,3,-1,1.69
"20220504","1783","8886","8880",國泰-新莊,3,0,3,1,1.69
"20220504","1783","5852","5850",統一-敦南,0,2,2,-1,1.13
"20220504","1783","9333","9300",華南永昌-長虹,3,0,3,1,1.69
"20220504","1783","0037003700390050","7790",國票-九鼎,0,2,2,-1,1.13
"20220504","1783","1045","1040",臺銀-新竹,2,0,2,1,1.13
"20220504","1783","9891","9800",元大-永和,0,2,2,-1,1.13
"20220505","1783","7001","7000",兆豐-嘉義,5,0,5,1,5.49
"20220505","1783","1470","1470",台灣摩根士丹利,0,10,10,-1,10.99
"20220505","1783","9233","9200",凱基-長庚,5,0,5,1,5.49
"20220505","1783","1440","1440",美林,3,8,5,-1,5.49
"20220505","1783","9255","9200",凱基-和平,5,0,5,1,5.49
"20220505","1783","0039003100330045","9100",群益金鼎-基隆,0,4,4,-1,4.40
"20220505","1783","9208","9200",凱基-桃園,4,0,4,1,4.40
"20220505","1783","5852","5850",統一-敦南,0,3,3,-1,3.30
"20220505","1783","0039003800310044","9800",元大-南投,4,0,4,1,4.40
"20220505","1783","1650","1650",新加坡商瑞銀,0,3,3,-1,3.30
"20220505","1783","0039004100390043","9A00",永豐金-員林,4,0,4,1,4.40
"20220505","1783","0037003700390050","7790",國票-九鼎,0,3,3,-1,3.30
"20220505","1783","0031003000320046","1020",合庫-西台中,3,0,3,1,3.30
"20220505","1783","9852","9800",元大-永春,0,3,3,-1,3.30
"20220505","1783","1034","1030",土銀-嘉義,3,0,3,1,3.30
"20220505","1783","8458","8450",康和-台南,0,2,2,-1,2.20
"20220505","1783","8888","8880",國泰-敦南,3,0,3,1,3.30
"20220505","1783","9894","9800",元大-桃興,0,2,2,-1,2.20
"20220505","1783","0035003300380059","5380",第一金-中壢,2,0,2,1,2.20
"20220505","1783","003900380039006d","9800",元大-信義,0,2,2,-1,2.20
"20220505","1783","0035003800350067","5850",統一-平鎮,2,0,2,1,2.20
"20220505","1783","1021","1020",合庫-台中,0,1,1,-1,1.10
"20220505","1783","5389","5380",第一金-中山,2,0,2,1,2.20
"20220505","1783","0031003200360055","1260",宏遠-館前,0,1,1,-1,1.10
"20220505","1783","0035003900320058","5920",元富-草屯,2,0,2,1,2.20
"20220505","1783","5263","5260",美好-泰山,0,1,1,-1,1.10
"20220505","1783","0039003600310048","9600",富邦-新板,2,0,2,1,2.20
"20220505","1783","0035003900320044","5920",元富-大昌,0,1,1,-1,1.10
"20220506","1783","9322","9300",華南永昌-公誠,7,0,7,1,5.00
"20220506","1783","1470","1470",台灣摩根士丹利,0,15,15,-1,10.71
"20220506","1783","9215","9200",凱基-高美館,6,0,6,1,4.29
"20220506","1783","9319","9300",華南永昌-鶯歌,0,14,14,-1,10.00
"20220506","1783","0039003800310044","9800",元大-南投,6,0,6,1,4.29
"20220506","1783","1440","1440",美林,0,13,13,-1,9.29
"20220506","1783","9856","9800",元大-花蓮,6,0,6,1,4.29
"20220506","1783","0037003700390056","7790",國票-天祥,0,10,10,-1,7.14
"20220506","1783","7001","7000",兆豐-嘉義,5,0,5,1,3.57
"20220506","1783","6915","6910",德信-和平,0,8,8,-1,5.71
"20220506","1783","003700300030004b","7000",兆豐-新營,5,0,5,1,3.57
"20220506","1783","8440","8440",摩根大通,0,5,5,-1,3.57
"20220506","1783","0039003800310068","9800",元大-屏東民生,5,0,5,1,3.57
"20220506","1783","003900360031004b","9600",富邦-七賢,0,5,5,-1,3.57
"20220506","1783","0039004100390038","9A00",永豐金-大園,5,0,5,1,3.57
"20220506","1783","8846","8840",玉山-板橋,0,3,3,-1,2.14
"20220506","1783","003500380035004a","5850",統一-三重,4,0,4,1,2.86
"20220506","1783","1480","1480",美商高盛,0,2,2,-1,1.43
"20220506","1783","7797","7790",國票-中正,4,0,4,1,2.86
"20220506","1783","003500390032006c","5920",元富-大裕,0,2,2,-1,1.43
"20220506","1783","0031003000320045","1020",合庫-桃園,3,0,3,1,2.14
"20220506","1783","0039003600320042","9600",富邦-二林,0,2,2,-1,1.43
"20220506","1783","9255","9200",凱基-和平,3,0,3,1,2.14
"20220506","1783","5263","5260",美好-泰山,0,1,1,-1,0.71
"20220506","1783","9813","9800",元大-八德,3,0,3,1,2.14
"20220506","1783","2186","2180",亞東-高雄,0,1,1,-1,0.71
"20220506","1783","9852","9800",元大-永春,3,0,3,1,2.14
"20220506","1783","1650","1650",新加坡商瑞銀,0,1,1,-1,0.71
"20220509","1783","7006","7000",兆豐-台南,20,0,20,1,8.20
"20220509","1783","9268","9200",凱基-台北,12,31,19,-1,7.79
"20220509","1783","0037003000300048","7000",兆豐-東門,20,0,20,1,8.20
"20220509","1783","1440","1440",美林,1,13,12,-1,4.92
"20220509","1783","7034","7030",致和-金華,20,0,20,1,8.20
"20220509","1783","9686","9600",富邦-宜蘭,0,11,11,-1,4.51
"20220509","1783","7001","7000",兆豐-嘉義,11,0,11,1,4.51
"20220509","1783","9834","9800",元大-中壢,0,10,10,-1,4.10
"20220509","1783","9255","9200",凱基-和平,7,0,7,1,2.87
"20220509","1783","9208","9200",凱基-桃園,0,9,9,-1,3.69
"20220509","1783","5389","5380",第一金-中山,5,0,5,1,2.05
"20220509","1783","0035003900320041","5920",元富-緯城,0,7,7,-1,2.87
"20220509","1783","5858","5850",統一-嘉義,5,0,5,1,2.05
"20220509","1783","9898","9800",元大-新莊,0,6,6,-1,2.46
"20220509","1783","9215","9200",凱基-高美館,5,0,5,1,2.05
"20220509","1783","003500390032007a","5920",元富-文心,0,5,5,-1,2.05
"20220509","1783","0039003800310044","9800",元大-南投,5,0,5,1,2.05
"20220509","1783","003700300030004b","7000",兆豐-新營,0,5,5,-1,2.05
"20220509","1783","8843","8840",玉山-高雄,4,0,4,1,1.64
"20220509","1783","8440","8440",摩根大通,2,7,5,-1,2.05
"20220509","1783","0039003800320042","9800",元大-博愛,5,1,4,1,1.64
"20220509","1783","003800380038004b","8880",國泰-板橋,0,5,5,-1,2.05
"20220509","1783","0039004100360031","9A00",永豐金-鳳山,4,0,4,1,1.64
"20220509","1783","0039003100380067","9100",群益金鼎-大甲,0,5,5,-1,2.05
"20220509","1783","8560","8560",新光,14,11,3,1,1.23
"20220509","1783","003900320031004d","9200",凱基-八德,0,5,5,-1,2.05
"20220509","1783","9324","9300",華南永昌-岡山,3,0,3,1,1.23
"20220509","1783","9272","9200",凱基-竹科,0,5,5,-1,2.05
"20220510","1783","0039004100390043","9A00",永豐金-員林,11,0,11,1,13.41
"20220510","1783","9235","9200",凱基-永華,0,8,8,-1,9.76
"20220510","1783","1440","1440",美林,7,0,7,1,8.54
"20220510","1783","1470","1470",台灣摩根士丹利,0,4,4,-1,4.88
"20220510","1783","8156","8150",台新-三民,5,0,5,1,6.10
"20220510","1783","0039003200300045","9200",凱基-東門,0,4,4,-1,4.88
"20220510","1783","8440","8440",摩根大通,5,0,5,1,6.10
"20220510","1783","0039004100300030","9A00",永豐金證券,2,6,4,-1,4.88
"20220510","1783","8843","8840",玉山-高雄,5,2,3,1,3.66
"20220510","1783","0035003800350041","5850",統一-基隆,0,3,3,-1,3.66
"20220510","1783","0039003800390043","9800",元大-板橋,3,0,3,1,3.66
"20220510","1783","9211","9200",凱基-台南,0,3,3,-1,3.66
"20220510","1783","7001","7000",兆豐-嘉義,2,0,2,1,2.44
"20220510","1783","6915","6910",德信-和平,0,2,2,-1,2.44
"20220510","1783","1650","1650",新加坡商瑞銀,2,0,2,1,2.44
"20220510","1783","1020","1020",合庫證券,0,2,2,-1,2.44
"20220510","1783","9623","9600",富邦-台北,2,0,2,1,2.44
"20220510","1783","0037003000330042","7030",致和-崇德,0,2,2,-1,2.44
"20220510","1783","0039004100390037","9A00",永豐金-新竹,2,0,2,1,2.44
"20220510","1783","003700370039006a","7790",國票-和平,0,2,2,-1,2.44
"20220510","1783","9800","9800",元大證券,2,0,2,1,2.44
"20220510","1783","8451","8450",康和-延平,0,2,2,-1,2.44
"20220510","1783","8849","8840",玉山-景美,1,0,1,1,1.22
"20220510","1783","9215","9200",凱基-高美館,0,2,2,-1,2.44
"20220510","1783","0038003800380041","8880",國泰-館前,1,0,1,1,1.22
"20220510","1783","0039003800310065","9800",元大-佳里,0,2,2,-1,2.44
"20220510","1783","9302","9300",華南永昌-台中,1,0,1,1,1.22
"20220510","1783","0039003800310051","9800",元大-太平,0,2,2,-1,2.44
"20220511","1783","8158","8150",台新-松江,11,0,11,1,9.02
"20220511","1783","6450","6450",永全證券,0,6,6,-1,4.92
"20220511","1783","003600310036004b","6160",中國信託-高雄,5,0,5,1,4.10
"20220511","1783","9329","9300",華南永昌-朴子,0,5,5,-1,4.10
"20220511","1783","8440","8440",摩根大通,9,6,3,1,2.46
"20220511","1783","9871","9800",元大-忠孝,0,5,5,-1,4.10
"20220511","1783","9862","9800",元大-南京,3,0,3,1,2.46
"20220511","1783","1470","1470",台灣摩根士丹利,0,3,3,-1,2.46
"20220511","1783","1034","1030",土銀-嘉義,2,0,2,1,1.64
"20220511","1783","1650","1650",新加坡商瑞銀,3,5,2,-1,1.64
"20220511","1783","9238","9200",凱基-士林,2,0,2,1,1.64
"20220511","1783","1440","1440",美林,4,6,2,-1,1.64
"20220511","1783","0039003800390050","9800",元大-敦南,2,0,2,1,1.64
"20220511","1783","7797","7790",國票-中正,0,2,2,-1,1.64
"20220511","1783","8560","8560",新光,2,0,2,1,1.64
"20220511","1783","0039003800310061","9800",元大-歸仁,0,2,2,-1,1.64
"20220511","1783","1590","1590",花旗環球,1,0,1,1,0.82
"20220511","1783","9852","9800",元大-永春,2,4,2,-1,1.64
"20220511","1783","0035003800350052","5850",統一-汐止,1,0,1,1,0.82
"20220511","1783","9800","9800",元大證券,1,2,1,-1,0.82
"20220511","1783","0035003800350067","5850",統一-平鎮,1,0,1,1,0.82
"20220511","1783","1113","1110",台灣企銀-九如,0,1,1,-1,0.82
"20220511","1783","0037003000300066","7000",兆豐-鹿港,1,0,1,1,0.82
"20220511","1783","1480","1480",美商高盛,0,1,1,-1,0.82
"20220511","1783","0037003700390065","7790",國票-南科,1,0,1,1,0.82
"20220511","1783","1020","1020",合庫證券,0,1,1,-1,0.82
"20220511","1783","0038003800340048","8840",玉山-新竹,1,0,1,1,0.82
"20220511","1783","6464","6460",大昌-新店,0,1,1,-1,0.82
"20220512","1783","8560","8560",新光,18,0,18,1,8.70
"20220512","1783","9366","9300",華南永昌-豐原,2,14,12,-1,5.80
"20220512","1783","003900380039004e","9800",元大-內湖,11,0,11,1,5.31
"20220512","1783","003800380034004a","8840",玉山-大里,0,10,10,-1,4.83
"20220512","1783","0035003900320057","5920",元富-吉利,10,0,10,1,4.83
"20220512","1783","9812","9800",元大-台中,0,9,9,-1,4.35
"20220512","1783","0039003800310044","9800",元大-南投,10,0,10,1,4.83
"20220512","1783","0039003600310043","9600",富邦-南京,0,8,8,-1,3.86
"20220512","1783","6461","6460",大昌-樹林,9,0,9,1,4.35
"20220512","1783","0039004100390039","9A00",永豐金-中壢,0,8,8,-1,3.86
"20220512","1783","9268","9200",凱基-台北,19,10,9,1,4.35
"20220512","1783","0035003900320062","5920",元富-板橋,0,5,5,-1,2.42
"20220512","1783","9255","9200",凱基-和平,8,0,8,1,3.86
"20220512","1783","9831","9800",元大-四維,0,5,5,-1,2.42
"20220512","1783","1650","1650",新加坡商瑞銀,9,4,5,1,2.42
"20220512","1783","9871","9800",元大-忠孝,0,5,5,-1,2.42
"20220512","1783","8848","8840",玉山-嘉義,4,0,4,1,1.93
"20220512","1783","0039003800390051","9800",元大-汐止,0,5,5,-1,2.42
"20220512","1783","0039003200300045","9200",凱基-東門,4,0,4,1,1.93
"20220512","1783","8440","8440",摩根大通,5,9,4,-1,1.93
"20220512","1783","9324","9300",華南永昌-岡山,3,0,3,1,1.45
"20220512","1783","9658","9600",富邦-建國,1,5,4,-1,1.93
"20220512","1783","8888","8880",國泰-敦南,2,0,2,1,0.97
"20220512","1783","0039003800310069","9800",元大-西螺,0,4,4,-1,1.93
"20220512","1783","7001","7000",兆豐-嘉義,2,0,2,1,0.97
"20220512","1783","5263","5260",美好-泰山,0,3,3,-1,1.45
"20220512","1783","8843","8840",玉山-高雄,2,0,2,1,0.97
"20220512","1783","1470","1470",台灣摩根士丹利,3,6,3,-1,1.45
"20220513","1783","0039004100390043","9A00",永豐金-員林,39,0,39,1,15.35
"20220513","1783","8382","8380",安泰-楠梓,0,20,20,-1,7.87
"20220513","1783","9268","9200",凱基-台北,38,11,27,1,10.63
"20220513","1783","0039003800310044","9800",元大-南投,0,11,11,-1,4.33
"20220513","1783","1650","1650",新加坡商瑞銀,30,7,23,1,9.06
"20220513","1783","0035003900320057","5920",元富-吉利,0,10,10,-1,3.94
"20220513","1783","1470","1470",台灣摩根士丹利,20,0,20,1,7.87
"20220513","1783","9255","9200",凱基-和平,0,10,10,-1,3.94
"20220513","1783","1440","1440",美林,25,7,18,1,7.09
"20220513","1783","8451","8450",康和-延平,0,9,9,-1,3.54
"20220513","1783","9231","9200",凱基-員林,6,0,6,1,2.36
"20220513","1783","9875","9800",元大-土城永寧,0,8,8,-1,3.15
"20220513","1783","0035003900320077","5920",元富-佳里,2,0,2,1,0.79
"20220513","1783","0039003800320043","9800",元大-六合,0,6,6,-1,2.36
"20220513","1783","0039004100390078","9A00",永豐金-桃園,3,1,2,1,0.79
"20220513","1783","0037003000300045","7000",兆豐-斗南(停),0,5,5,-1,1.97
"20220513","1783","003500330038004e","5380",第一金-豐原,1,0,1,1,0.39
"20220513","1783","9319","9300",華南永昌-鶯歌,0,5,5,-1,1.97
"20220513","1783","8585","8580",聯邦-三重,1,0,1,1,0.39
"20220513","1783","9869","9800",元大-新盛,0,5,5,-1,1.97
"20220513","1783","9105","9100",群益金鼎-高盛,1,0,1,1,0.39
"20220513","1783","9324","9300",華南永昌-岡山,0,4,4,-1,1.57
"20220513","1783","0039003600320045","9600",富邦-樹林,1,0,1,1,0.39
"20220513","1783","5263","5260",美好-泰山,0,3,3,-1,1.18
"20220513","1783","003900360032004b","9600",富邦-中和,1,0,1,1,0.39
"20220513","1783","8440","8440",摩根大通,6,9,3,-1,1.18
"20220513","1783","9655","9600",富邦-板橋,1,0,1,1,0.39
"20220513","1783","8843","8840",玉山-高雄,0,3,3,-1,1.18
"20220418","1783","9871","9800",元大-忠孝,39,0,39,1,6.90
"20220418","1783","9231","9200",凱基-員林,0,30,30,-1,5.31
"20220418","1783","8440","8440",摩根大通,42,9,33,1,5.84
"20220418","1783","0035003800350046","5850",統一-彰化,0,26,26,-1,4.60
"20220418","1783","003900380034004b","9800",元大-館前,25,6,19,1,3.36
"20220418","1783","9256","9200",凱基-南崁,0,24,24,-1,4.25
"20220418","1783","1480","1480",美商高盛,20,1,19,1,3.36
"20220418","1783","0039003200320048","9200",凱基-復興,0,15,15,-1,2.65
"20220418","1783","1440","1440",美林,24,9,15,1,2.65
"20220418","1783","9874","9800",元大-雙和,0,9,9,-1,1.59
"20220418","1783","0038003800340041","8840",玉山-士林,11,0,11,1,1.95
"20220418","1783","0039004100390042","9A00",永豐金-中和,0,8,8,-1,1.42
"20220418","1783","0038003800380041","8880",國泰-館前,11,1,10,1,1.77
"20220418","1783","0039003200310045","9200",凱基-三峽,1,9,8,-1,1.42
"20220418","1783","9302","9300",華南永昌-台中,10,0,10,1,1.77
"20220418","1783","9100","9100",群益金鼎,0,7,7,-1,1.24
"20220418","1783","8565","8560",新光-桃園,10,1,9,1,1.59
"20220418","1783","0035003900320072","5920",元富-城東,0,5,5,-1,0.88
"20220418","1783","0039003600320047","9600",富邦-斗六,10,2,8,1,1.42
"20220418","1783","0039003200300047","9200",凱基-彰化,0,5,5,-1,0.88
"20220418","1783","8847","8840",玉山-台南,7,0,7,1,1.24
"20220418","1783","9327","9300",華南永昌-斗六,0,5,5,-1,0.88
"20220418","1783","9884","9800",元大-斗信,12,5,7,1,1.24
"20220418","1783","6452","6450",永全-八德,0,4,4,-1,0.71
"20220418","1783","8560","8560",新光,7,1,6,1,1.06
"20220418","1783","6915","6910",德信-和平,0,4,4,-1,0.71
"20220418","1783","8561","8560",新光-台中,6,0,6,1,1.06
"20220418","1783","9283","9200",凱基-北門,1,5,4,-1,0.71
"20220419","1783","8885","8880",國泰-桃園,70,0,70,1,5.18
"20220419","1783","8440","8440",摩根大通,6,75,69,-1,5.11
"20220419","1783","1022","1020",合庫-台南,50,1,49,1,3.63
"20220419","1783","1650","1650",新加坡商瑞銀,15,80,65,-1,4.81
"20220419","1783","0039003800310049","9800",元大-天母,44,0,44,1,3.26
"20220419","1783","9256","9200",凱基-南崁,0,60,60,-1,4.44
"20220419","1783","0039003200300043","9200",凱基-雙和,40,0,40,1,2.96
"20220419","1783","8560","8560",新光,11,71,60,-1,4.44
"20220419","1783","5660","5660",日進,32,0,32,1,2.37
"20220419","1783","9227","9200",凱基-城中,0,56,56,-1,4.15
"20220419","1783","9283","9200",凱基-北門,30,0,30,1,2.22
"20220419","1783","0039003800390047","9800",元大-大同,1,55,54,-1,4.00
"20220419","1783","003500390032006c","5920",元富-大裕,30,2,28,1,2.07
"20220419","1783","5603","5600",永興-台中,0,53,53,-1,3.92
"20220419","1783","0039003800320041","9800",元大-羅東,18,0,18,1,1.33
"20220419","1783","9268","9200",凱基-台北,29,82,53,-1,3.92
"20220419","1783","0039003100380073","9100",群益金鼎-丹鳳,16,0,16,1,1.18
"20220419","1783","9874","9800",元大-雙和,3,39,36,-1,2.66
"20220419","1783","0039003200310045","9200",凱基-三峽,15,0,15,1,1.11
"20220419","1783","1440","1440",美林,3,36,33,-1,2.44
"20220419","1783","9655","9600",富邦-板橋,15,4,11,1,0.81
"20220419","1783","1470","1470",台灣摩根士丹利,0,31,31,-1,2.29
"20220419","1783","0035003900320058","5920",元富-草屯,11,0,11,1,0.81
"20220419","1783","9871","9800",元大-忠孝,11,39,28,-1,2.07
"20220419","1783","0039003600310050","9600",富邦-和美,11,0,11,1,0.81
"20220419","1783","8882","8880",國泰-台中,3,21,18,-1,1.33
"20220419","1783","0039003800390046","9800",元大-高雄,11,0,11,1,0.81
"20220419","1783","003900380034004b","9800",元大-館前,5,20,15,-1,1.11
"20220420","1783","8159","8150",台新-台南,45,30,15,1,3.93
"20220420","1783","9268","9200",凱基-台北,14,36,22,-1,5.76
"20220420","1783","8885","8880",國泰-桃園,10,0,10,1,2.62
"20220420","1783","1470","1470",台灣摩根士丹利,0,18,18,-1,4.71
"20220420","1783","003900360031004e","9600",富邦-西壢,10,0,10,1,2.62
"20220420","1783","9256","9200",凱基-南崁,0,15,15,-1,3.93
"20220420","1783","0039004100390042","9A00",永豐金-中和,8,0,8,1,2.09
"20220420","1783","8455","8450",康和-台中,0,10,10,-1,2.62
"20220420","1783","0039004100390043","9A00",永豐金-員林,6,0,6,1,1.57
"20220420","1783","0035003900320072","5920",元富-城東,0,5,5,-1,1.31
"20220420","1783","5853","5850",統一-中壢,5,0,5,1,1.31
"20220420","1783","003500390032007a","5920",元富-文心,0,5,5,-1,1.31
"20220420","1783","8451","8450",康和-延平,5,0,5,1,1.31
"20220420","1783","9339","9300",華南永昌-竹北,0,5,5,-1,1.31
"20220420","1783","9319","9300",華南永昌-鶯歌,5,0,5,1,1.31
"20220420","1783","0035003300380041","5380",第一金-新興,0,4,4,-1,1.05
"20220420","1783","0031003200360051","1260",宏遠-高雄,4,0,4,1,1.05
"20220420","1783","8848","8840",玉山-嘉義,0,4,4,-1,1.05
"20220420","1783","0038003100350053","8150",台新-中壢,4,0,4,1,1.05
"20220420","1783","0039003800390047","9800",元大-大同,0,4,4,-1,1.05
"20220420","1783","0038003100350059","8150",台新-新營,4,0,4,1,1.05
"20220420","1783","9212","9200",凱基-東港,0,4,4,-1,1.05
"20220420","1783","9255","9200",凱基-和平,4,0,4,1,1.05
"20220420","1783","1480","1480",美商高盛,0,3,3,-1,0.79
"20220420","1783","9327","9300",華南永昌-斗六,4,0,4,1,1.05
"20220420","1783","7750","7750",北城證券,2,5,3,-1,0.79
"20220420","1783","0039003800320041","9800",元大-羅東,4,0,4,1,1.05
"20220420","1783","0039003100330044","9100",群益金鼎-潭子,0,3,3,-1,0.79
"20220421","1783","8885","8880",國泰-桃園,10,0,10,1,2.60
"20220421","1783","0037003700390076","7790",國票-台中,0,30,30,-1,7.81
"20220421","1783","0038003800380041","8880",國泰-館前,11,1,10,1,2.60
"20220421","1783","003600310036004b","6160",中國信託-高雄,0,20,20,-1,5.21
"20220421","1783","9223","9200",凱基-豐中,10,0,10,1,2.60
"20220421","1783","0039003600320043","9600",富邦-東門,0,8,8,-1,2.08
"20220421","1783","003900360031004e","9600",富邦-西壢,10,0,10,1,2.60
"20220421","1783","1440","1440",美林,3,8,5,-1,1.30
"20220421","1783","0039003800340043","9800",元大-新店中正,10,0,10,1,2.60
"20220421","1783","5323","5320",高橋-內壢,0,5,5,-1,1.30
"20220421","1783","9812","9800",元大-台中,8,0,8,1,2.08
"20220421","1783","003900310038004b","9100",群益金鼎-東湖,0,5,5,-1,1.30
"20220421","1783","0039003600310048","9600",富邦-新板,7,0,7,1,1.82
"20220421","1783","0039003200300056","9200",凱基-新店,0,5,5,-1,1.30
"20220421","1783","9300","9300",華南永昌,8,1,7,1,1.82
"20220421","1783","9268","9200",凱基-台北,12,17,5,-1,1.30
"20220421","1783","5266","5260",美好-中壢,7,0,7,1,1.82
"20220421","1783","9667","9600",富邦-台南,0,5,5,-1,1.30
"20220421","1783","0031003200360051","1260",宏遠-高雄,6,0,6,1,1.56
"20220421","1783","9834","9800",元大-中壢,0,5,5,-1,1.30
"20220421","1783","5853","5850",統一-中壢,6,0,6,1,1.56
"20220421","1783","5262","5260",美好-楊梅,0,3,3,-1,0.78
"20220421","1783","003500390032006c","5920",元富-大裕,6,0,6,1,1.56
"20220421","1783","7750","7750",北城證券,1,4,3,-1,0.78
"20220421","1783","8848","8840",玉山-嘉義,6,0,6,1,1.56
"20220421","1783","8440","8440",摩根大通,2,5,3,-1,0.78
"20220421","1783","9833","9800",元大-敦化,6,0,6,1,1.56
"20220421","1783","003900380031004b","9800",元大-林園,0,3,3,-1,0.78
"20220422","1783","1262","1260",宏遠-桃園,40,0,40,1,2.88
"20220422","1783","0039004100390043","9A00",永豐金-員林,0,68,68,-1,4.90
"20220422","1783","003800380038004b","8880",國泰-板橋,30,0,30,1,2.16
"20220422","1783","9874","9800",元大-雙和,0,20,20,-1,1.44
"20220422","1783","003600310036004b","6160",中國信託-高雄,70,42,28,1,2.02
"20220422","1783","1470","1470",台灣摩根士丹利,8,21,13,-1,0.94
"20220422","1783","9268","9200",凱基-台北,64,37,27,1,1.95
"20220422","1783","9278","9200",凱基-永康,0,9,9,-1,0.65
"20220422","1783","0039003800390065","9800",元大-中和,30,3,27,1,1.95
"20220422","1783","9300","9300",華南永昌,1,10,9,-1,0.65
"20220422","1783","1480","1480",美商高盛,22,1,21,1,1.51
"20220422","1783","0039003800390058","9800",元大-民生,0,9,9,-1,0.65
"20220422","1783","8150","8150",台新證券,16,0,16,1,1.15
"20220422","1783","0039003600320057","9600",富邦-龍潭,0,8,8,-1,0.58
"20220422","1783","0038003100350059","8150",台新-新營,17,1,16,1,1.15
"20220422","1783","0031003000320046","1020",合庫-西台中,0,7,7,-1,0.50
"20220422","1783","8885","8880",國泰-桃園,12,0,12,1,0.86
"20220422","1783","9324","9300",華南永昌-岡山,0,7,7,-1,0.50
"20220422","1783","0035003300380043","5380",第一金-光復,10,0,10,1,0.72
"20220422","1783","003900380031004b","9800",元大-林園,3,10,7,-1,0.50
"20220422","1783","0038003800340044","8840",玉山-左營,10,0,10,1,0.72
"20220422","1783","0039003800390047","9800",元大-大同,3,10,7,-1,0.50
"20220422","1783","003900360031004e","9600",富邦-西壢,10,0,10,1,0.72
"20220422","1783","003500320036004b","5260",美好-富順,1,7,6,-1,0.43
"20220422","1783","0039003600310056","9600",富邦-板橋中山,10,0,10,1,0.72
"20220422","1783","9327","9300",華南永昌-斗六,2,8,6,-1,0.43
"20220422","1783","0039003800310071","9800",元大-萬華,9,0,9,1,0.65
"20220422","1783","1114","1110",台灣企銀-嘉義,0,5,5,-1,0.36
"20220425","1783","0035003900320041","5920",元富-緯城,25,0,25,1,2.61
"20220425","1783","1470","1470",台灣摩根士丹利,0,80,80,-1,8.35
"20220425","1783","9655","9600",富邦-板橋,25,1,24,1,2.51
"20220425","1783","9874","9800",元大-雙和,4,81,77,-1,8.04
"20220425","1783","0039004100390066","9A00",永豐金-中盛,22,0,22,1,2.30
"20220425","1783","1022","1020",合庫-台南,0,50,50,-1,5.22
"20220425","1783","9614","9600",富邦-基隆,20,0,20,1,2.09
"20220425","1783","8440","8440",摩根大通,12,51,39,-1,4.07
"20220425","1783","8848","8840",玉山-嘉義,16,0,16,1,1.67
"20220425","1783","0039003800390065","9800",元大-中和,0,27,27,-1,2.82
"20220425","1783","9831","9800",元大-四維,15,0,15,1,1.57
"20220425","1783","0031003200360051","1260",宏遠-高雄,0,20,20,-1,2.09
"20220425","1783","8560","8560",新光,19,6,13,1,1.36
"20220425","1783","8150","8150",台新證券,1,16,15,-1,1.57
"20220425","1783","9324","9300",華南永昌-岡山,13,0,13,1,1.36
"20220425","1783","003800380038004b","8880",國泰-板橋,1,15,14,-1,1.46
"20220425","1783","003500320036004b","5260",美好-富順,13,1,12,1,1.25
"20220425","1783","9256","9200",凱基-南崁,0,13,13,-1,1.36
"20220425","1783","9873","9800",元大-西門,12,0,12,1,1.25
"20220425","1783","0039003600310056","9600",富邦-板橋中山,0,12,12,-1,1.25
"20220425","1783","1114","1110",台灣企銀-嘉義,10,0,10,1,1.04
"20220425","1783","5050","5050",大展,0,10,10,-1,1.04
"20220425","1783","1043","1040",臺銀-民權,11,1,10,1,1.04
"20220425","1783","0035003300380043","5380",第一金-光復,0,10,10,-1,1.04
"20220425","1783","0035003900320062","5920",元富-板橋,10,0,10,1,1.04
"20220425","1783","0035003800350049","5850",統一-員林,1,11,10,-1,1.04
"20220425","1783","0039003600320056","9600",富邦-復興,10,0,10,1,1.04
"20220425","1783","5920","5920",元富,0,10,10,-1,1.04
"20220426","1783","0039003800390053","9800",元大-鹿港,11,0,11,1,2.08
"20220426","1783","003900360031004e","9600",富邦-西壢,0,30,30,-1,5.67
"20220426","1783","6950","6950",福勝,10,0,10,1,1.89
"20220426","1783","003600310036004b","6160",中國信託-高雄,1,30,29,-1,5.48
"20220426","1783","9223","9200",凱基-豐中,10,0,10,1,1.89
"20220426","1783","0038003400350046","8450",康和-仁愛,0,28,28,-1,5.29
"20220426","1783","8560","8560",新光,11,2,9,1,1.70
"20220426","1783","9268","9200",凱基-台北,45,68,23,-1,4.35
"20220426","1783","9255","9200",凱基-和平,11,2,9,1,1.70
"20220426","1783","1650","1650",新加坡商瑞銀,0,16,16,-1,3.02
"20220426","1783","0039004100390043","9A00",永豐金-員林,9,0,9,1,1.70
"20220426","1783","1470","1470",台灣摩根士丹利,11,25,14,-1,2.65
"20220426","1783","0039003600310048","9600",富邦-新板,12,4,8,1,1.51
"20220426","1783","8440","8440",摩根大通,1,14,13,-1,2.46
"20220426","1783","5384","5380",第一金-台南,8,1,7,1,1.32
"20220426","1783","003700300030004b","7000",兆豐-新營,0,10,10,-1,1.89
"20220426","1783","6160","6160",中國信託,7,0,7,1,1.32
"20220426","1783","0039003100330044","9100",群益金鼎-潭子,0,10,10,-1,1.89
"20220426","1783","0038003100350048","8150",台新-屏東,6,0,6,1,1.13
"20220426","1783","9852","9800",元大-永春,0,10,10,-1,1.89
"20220426","1783","8886","8880",國泰-新莊,6,0,6,1,1.13
"20220426","1783","1440","1440",美林,7,13,6,-1,1.13
"20220426","1783","9208","9200",凱基-桃園,6,0,6,1,1.13
"20220426","1783","0038003100350059","8150",台新-新營,1,7,6,-1,1.13
"20220426","1783","0031003200360069","1260",宏遠-光隆,6,1,5,1,0.95
"20220426","1783","0035003900320063","5920",元富-烏日,0,5,5,-1,0.95
"20220426","1783","1114","1110",台灣企銀-嘉義,5,0,5,1,0.95
"20220426","1783","003900380031004c","9800",元大-莒光,0,5,5,-1,0.95
"20220427","1783","9268","9200",凱基-台北,53,13,40,1,11.49
"20220427","1783","9831","9800",元大-四維,0,40,40,-1,11.49
"20220427","1783","5858","5850",統一-嘉義,18,0,18,1,5.17
"20220427","1783","1470","1470",台灣摩根士丹利,3,21,18,-1,5.17
"20220427","1783","1650","1650",新加坡商瑞銀,18,6,12,1,3.45
"20220427","1783","9238","9200",凱基-士林,0,15,15,-1,4.31
"20220427","1783","0036003100360041","6160",中國信託-中壢,10,0,10,1,2.87
"20220427","1783","6167","6160",中國信託-松江,0,10,10,-1,2.87
"20220427","1783","0035003900320041","5920",元富-緯城,9,3,6,1,1.72
"20220427","1783","0038003800340044","8840",玉山-左營,0,10,10,-1,2.87
"20220427","1783","0035003900320050","5920",元富-同大,5,0,5,1,1.44
"20220427","1783","0038003800380041","8880",國泰-館前,1,10,9,-1,2.59
"20220427","1783","003900380033006a","9800",元大-仁愛,5,0,5,1,1.44
"20220427","1783","003700300030004b","7000",兆豐-新營,0,8,8,-1,2.30
"20220427","1783","6110","6110",台中銀,4,0,4,1,1.15
"20220427","1783","8848","8840",玉山-嘉義,0,7,7,-1,2.01
"20220427","1783","0039003600320056","9600",富邦-復興,4,0,4,1,1.15
"20220427","1783","0039003100380064","9100",群益金鼎-內湖,0,6,6,-1,1.72
"20220427","1783","8843","8840",玉山-高雄,3,0,3,1,0.86
"20220427","1783","9319","9300",華南永昌-鶯歌,0,6,6,-1,1.72
"20220427","1783","1440","1440",美林,15,12,3,1,0.86
"20220427","1783","0039003800320043","9800",元大-六合,0,5,5,-1,1.44
"20220427","1783","8440","8440",摩根大通,10,7,3,1,0.86
"20220427","1783","9898","9800",元大-新莊,0,5,5,-1,1.44
"20220427","1783","9208","9200",凱基-桃園,3,0,3,1,0.86
"20220427","1783","0039003800390041","9800",元大-北投,0,5,5,-1,1.44
"20220427","1783","9209","9200",凱基-岡山,3,0,3,1,0.86
"20220427","1783","9333","9300",華南永昌-長虹,0,4,4,-1,1.15
"20220428","1783","0038003400350046","8450",康和-仁愛,14,0,14,1,6.28
"20220428","1783","8440","8440",摩根大通,2,19,17,-1,7.62
"20220428","1783","9352","9300",華南永昌-桃園,13,0,13,1,5.83
"20220428","1783","1650","1650",新加坡商瑞銀,2,17,15,-1,6.73
"20220428","1783","9255","9200",凱基-和平,10,0,10,1,4.48
"20220428","1783","1043","1040",臺銀-民權,1,11,10,-1,4.48
"20220428","1783","0039004100390078","9A00",永豐金-桃園,10,0,10,1,4.48
"20220428","1783","0038003100350059","8150",台新-新營,0,10,10,-1,4.48
"20220428","1783","5853","5850",統一-中壢,8,0,8,1,3.59
"20220428","1783","1440","1440",美林,6,14,8,-1,3.59
"20220428","1783","003900380039004a","9800",元大-彰化民生,6,0,6,1,2.69
"20220428","1783","0035003900320062","5920",元富-板橋,0,8,8,-1,3.59
"20220428","1783","0035003300380041","5380",第一金-新興,5,0,5,1,2.24
"20220428","1783","003900410039006a","9A00",永豐金-嘉義,1,8,7,-1,3.14
"20220428","1783","003500390032005a","5920",元富-安南,5,0,5,1,2.24
"20220428","1783","0039004100380046","9A00",永豐金-敦南,0,5,5,-1,2.24
"20220428","1783","9831","9800",元大-四維,5,0,5,1,2.24
"20220428","1783","003900410039004d","9A00",永豐金-南投,0,5,5,-1,2.24
"20220428","1783","9852","9800",元大-永春,4,0,4,1,1.79
"20220428","1783","0039003100380063","9100",群益金鼎-鳳山,0,4,4,-1,1.79
"20220428","1783","0031003200360055","1260",宏遠-館前,3,0,3,1,1.35
"20220428","1783","0036003100310041","6110",台中銀-豐原,0,3,3,-1,1.35
"20220428","1783","8841","8840",玉山-雙和,3,0,3,1,1.35
"20220428","1783","0036003300380041","6380",光和-嘉義,0,3,3,-1,1.35
"20220428","1783","1023","1020",合庫-高雄,2,0,2,1,0.90
"20220428","1783","6915","6910",德信-和平,0,3,3,-1,1.35
"20220428","1783","0035003800350048","5850",統一-桃園,2,0,2,1,0.90
"20220428","1783","0039003200310043","9200",凱基-民權,0,3,3,-1,1.35
"20220429","1783","9268","9200",凱基-台北,16,1,15,1,8.43
"20220429","1783","003500380035004a","5850",統一-三重,0,16,16,-1,8.99
"20220429","1783","8158","8150",台新-松江,10,0,10,1,5.62
"20220429","1783","003900410039004d","9A00",永豐金-南投,0,10,10,-1,5.62
"20220429","1783","1440","1440",美林,17,10,7,1,3.93
"20220429","1783","9327","9300",華南永昌-斗六,0,8,8,-1,4.49
"20220429","1783","1650","1650",新加坡商瑞銀,9,2,7,1,3.93
"20220429","1783","9884","9800",元大-斗信,0,8,8,-1,4.49
"20220429","1783","9215","9200",凱基-高美館,6,0,6,1,3.37
"20220429","1783","1470","1470",台灣摩根士丹利,3,10,7,-1,3.93
"20220429","1783","003900380039004a","9800",元大-彰化民生,6,0,6,1,3.37
"20220429","1783","9283","9200",凱基-北門,0,6,6,-1,3.37
"20220429","1783","9697","9600",富邦-虎尾,5,0,5,1,2.81
"20220429","1783","003500390032005a","5920",元富-安南,0,5,5,-1,2.81
"20220429","1783","6110","6110",台中銀,4,0,4,1,2.25
"20220429","1783","5603","5600",永興-台中,0,4,4,-1,2.25
"20220429","1783","7750","7750",北城證券,5,1,4,1,2.25
"20220429","1783","0035003800350045","5850",統一-新營,0,4,4,-1,2.25
"20220429","1783","2187","2180",亞東-台中,3,0,3,1,1.69
"20220429","1783","7008","7000",兆豐-三重,0,4,4,-1,2.25
"20220429","1783","8886","8880",國泰-新莊,3,0,3,1,1.69
"20220429","1783","8440","8440",摩根大通,2,6,4,-1,2.25
"20220429","1783","9105","9100",群益金鼎-高盛,3,0,3,1,1.69
"20220429","1783","0039003800310065","9800",元大-佳里,0,4,4,-1,2.25
"20220429","1783","1022","1020",合庫-台南,2,0,2,1,1.12
"20220429","1783","0036003300380041","6380",光和-嘉義,0,3,3,-1,1.69
"20220429","1783","1042","1040",臺銀-臺南,2,0,2,1,1.12
"20220429","1783","0031003100310041","1110",台灣企銀-民雄,0,2,2,-1,1.12
"20220401","1783","0039004100360031","9A00",永豐金-鳳山,10,0,10,1,9.17
"20220401","1783","8440","8440",摩根大通,0,9,9,-1,8.26
"20220401","1783","5323","5320",高橋-內壢,6,0,6,1,5.50
"20220401","1783","0035003900320062","5920",元富-板橋,0,7,7,-1,6.42
"20220401","1783","5261","5260",美好-蘆洲,5,0,5,1,4.59
"20220401","1783","1650","1650",新加坡商瑞銀,0,7,7,-1,6.42
"20220401","1783","0036003000310064","6010",(牛牛牛)亞-鑫豐,5,0,5,1,4.59
"20220401","1783","1440","1440",美林,0,7,7,-1,6.42
"20220401","1783","8840","8840",玉山證券,5,0,5,1,4.59
"20220401","1783","6161","6160",中國信託-三重,0,5,5,-1,4.59
"20220401","1783","9302","9300",華南永昌-台中,5,0,5,1,4.59
"20220401","1783","0039003100330049","9100",群益金鼎-萬華,0,5,5,-1,4.59
"20220401","1783","0039003800390043","9800",元大-板橋,4,0,4,1,3.67
"20220401","1783","1030","1030",土銀,0,4,4,-1,3.67
"20220401","1783","003500320036004b","5260",美好-富順,3,0,3,1,2.75
"20220401","1783","0039003800310047","9800",元大-彰化,0,4,4,-1,3.67
"20220401","1783","0035003900320049","5920",元富-嘉義,2,0,2,1,1.83
"20220401","1783","003800340035004a","8450",康和-高雄,0,3,3,-1,2.75
"20220401","1783","6380","6380",光和,2,0,2,1,1.83
"20220401","1783","8492","8490",京城-嘉義,0,3,3,-1,2.75
"20220401","1783","9215","9200",凱基-高美館,2,0,2,1,1.83
"20220401","1783","1115","1110",台灣企銀-太平,0,2,2,-1,1.83
"20220401","1783","9255","9200",凱基-和平,2,0,2,1,1.83
"20220401","1783","1590","1590",花旗環球,0,2,2,-1,1.83
"20220401","1783","9655","9600",富邦-板橋,2,0,2,1,1.83
"20220401","1783","9202","9200",凱基-中港,0,2,2,-1,1.83
"20220401","1783","0039003600350055","9600",富邦-彰化,2,0,2,1,1.83
"20220401","1783","1470","1470",台灣摩根士丹利,0,1,1,-1,0.92
"20220406","1783","0039003800300061","9800",元大-承德,9,0,9,1,10.47
"20220406","1783","0039004100390043","9A00",永豐金-員林,2,22,20,-1,23.26
"20220406","1783","9268","9200",凱基-台北,8,0,8,1,9.30
"20220406","1783","003800340035004a","8450",康和-高雄,0,7,7,-1,8.14
"20220406","1783","9852","9800",元大-永春,8,0,8,1,9.30
"20220406","1783","1470","1470",台灣摩根士丹利,0,5,5,-1,5.81
"20220406","1783","8560","8560",新光,5,0,5,1,5.81
"20220406","1783","8840","8840",玉山證券,0,5,5,-1,5.81
"20220406","1783","003700300030004b","7000",兆豐-新營,5,0,5,1,5.81
"20220406","1783","8158","8150",台新-松江,0,4,4,-1,4.65
"20220406","1783","0038003100350059","8150",台新-新營,5,0,5,1,5.81
"20220406","1783","1440","1440",美林,1,3,2,-1,2.33
"20220406","1783","003500390032006c","5920",元富-大裕,2,0,2,1,2.33
"20220406","1783","9202","9200",凱基-中港,0,2,2,-1,2.33
"20220406","1783","1650","1650",新加坡商瑞銀,3,1,2,1,2.33
"20220406","1783","9322","9300",華南永昌-公誠,0,2,2,-1,2.33
"20220406","1783","1261","1260",宏遠-民生,2,0,2,1,2.33
"20220406","1783","0039003600350055","9600",富邦-彰化,0,2,2,-1,2.33
"20220406","1783","8440","8440",摩根大通,2,0,2,1,2.33
"20220406","1783","003800380034004a","8840",玉山-大里,0,1,1,-1,1.16
"20220406","1783","9867","9800",元大-北成功,2,0,2,1,2.33
"20220406","1783","8881","8880",國泰-高雄,0,1,1,-1,1.16
"20220406","1783","9884","9800",元大-斗信,2,0,2,1,2.33
"20220406","1783","003900320030004e","9200",凱基-湖口,0,1,1,-1,1.16
"20220406","1783","0039003800390043","9800",元大-板橋,2,0,2,1,2.33
"20220406","1783","9692","9600",富邦-嘉義,0,1,1,-1,1.16
"20220406","1783","1115","1110",台灣企銀-太平,1,0,1,1,1.16
"20220406","1783","0039004100390047","9A00",永豐金-天母,0,1,1,-1,1.16
"20220407","1783","0039003800310044","9800",元大-南投,10,0,10,1,9.71
"20220407","1783","0039003100330044","9100",群益金鼎-潭子,0,6,6,-1,5.83
"20220407","1783","8560","8560",新光,5,0,5,1,4.85
"20220407","1783","0039003600310052","9600",富邦-南員林,0,5,5,-1,4.85
"20220407","1783","0039003800390043","9800",元大-板橋,5,0,5,1,4.85
"20220407","1783","9692","9600",富邦-嘉義,0,5,5,-1,4.85
"20220407","1783","0039004100390066","9A00",永豐金-中盛,4,0,4,1,3.88
"20220407","1783","0039003800310065","9800",元大-佳里,0,5,5,-1,4.85
"20220407","1783","1650","1650",新加坡商瑞銀,6,2,4,1,3.88
"20220407","1783","9333","9300",華南永昌-長虹,0,3,3,-1,2.91
"20220407","1783","9302","9300",華南永昌-台中,3,0,3,1,2.91
"20220407","1783","0039003800310069","9800",元大-西螺,0,3,3,-1,2.91
"20220407","1783","7750","7750",北城證券,3,0,3,1,2.91
"20220407","1783","0037003000300058","7000",兆豐-永和,0,2,2,-1,1.94
"20220407","1783","0039003800390045","9800",元大-草屯,2,0,2,1,1.94
"20220407","1783","9867","9800",元大-北成功,0,2,2,-1,1.94
"20220407","1783","0035003300380043","5380",第一金-光復,2,0,2,1,1.94
"20220407","1783","1520","1520",瑞士信貸,0,1,1,-1,0.97
"20220407","1783","0035003900320049","5920",元富-嘉義,2,0,2,1,1.94
"20220407","1783","0031003200360069","1260",宏遠-光隆,0,1,1,-1,0.97
"20220407","1783","003800380034004a","8840",玉山-大里,2,0,2,1,1.94
"20220407","1783","003500330038006a","5380",第一金-安和,2,3,1,-1,0.97
"20220407","1783","003900310038004d","9100",群益金鼎-嘉義,2,0,2,1,1.94
"20220407","1783","0036003300380044","6380",光和-高雄,0,1,1,-1,0.97
"20220407","1783","9655","9600",富邦-板橋,2,0,2,1,1.94
"20220407","1783","9131","9100",群益金鼎-民權,0,1,1,-1,0.97
"20220407","1783","0039003600350055","9600",富邦-彰化,2,0,2,1,1.94
"20220407","1783","9252","9200",凱基-嘉義,0,1,1,-1,0.97
"20220408","1783","1650","1650",新加坡商瑞銀,4,1,3,1,6.00
"20220408","1783","003700300030005a","7000",兆豐-高雄,0,7,7,-1,14.00
"20220408","1783","9268","9200",凱基-台北,3,0,3,1,6.00
"20220408","1783","8157","8150",台新-左楠,0,6,6,-1,12.00
"20220408","1783","0039003800390043","9800",元大-板橋,3,0,3,1,6.00
"20220408","1783","003900320031004d","9200",凱基-八德,0,3,3,-1,6.00
"20220408","1783","0039003800310065","9800",元大-佳里,2,0,2,1,4.00
"20220408","1783","1590","1590",花旗環球,0,2,2,-1,4.00
"20220408","1783","8888","8880",國泰-敦南,1,0,1,1,2.00
"20220408","1783","8840","8840",玉山證券,0,2,2,-1,4.00
"20220408","1783","1440","1440",美林,1,0,1,1,2.00
"20220408","1783","0039003600310059","9600",富邦-屏東,0,2,2,-1,4.00
"20220408","1783","1118","1110",台灣企銀-豐原,1,0,1,1,2.00
"20220408","1783","003800380038004b","8880",國泰-板橋,0,2,2,-1,4.00
"20220408","1783","0035003900320047","5920",元富-新竹,1,0,1,1,2.00
"20220408","1783","0035003900320055","5920",元富-宜蘭,0,1,1,-1,2.00
"20220408","1783","0038003100350048","8150",台新-屏東,1,0,1,1,2.00
"20220408","1783","5050","5050",大展,0,1,1,-1,2.00
"20220408","1783","8490","8490",京城,1,0,1,1,2.00
"20220408","1783","0035003900320041","5920",元富-緯城,0,1,1,-1,2.00
"20220408","1783","003900310038004d","9100",群益金鼎-嘉義,1,0,1,1,2.00
"20220408","1783","7008","7000",兆豐-三重,0,1,1,-1,2.00
"20220408","1783","9215","9200",凱基-高美館,1,0,1,1,2.00
"20220408","1783","8842","8840",玉山-新莊,0,1,1,-1,2.00
"20220408","1783","9801","9800",元大-城東,1,0,1,1,2.00
"20220408","1783","9137","9100",群益金鼎-士林,0,1,1,-1,2.00
"20220408","1783","0039003800310044","9800",元大-南投,1,0,1,1,2.00
"20220408","1783","003900320030005a","9200",凱基-台東,0,1,1,-1,2.00
"20220411","1783","9278","9200",凱基-永康,6,0,6,1,9.84
"20220411","1783","5323","5320",高橋-內壢,0,5,5,-1,8.20
"20220411","1783","0031003200360069","1260",宏遠-光隆,5,0,5,1,8.20
"20220411","1783","9697","9600",富邦-虎尾,0,5,5,-1,8.20
"20220411","1783","0039004100390043","9A00",永豐金-員林,5,0,5,1,8.20
"20220411","1783","1470","1470",台灣摩根士丹利,0,3,3,-1,4.92
"20220411","1783","1650","1650",新加坡商瑞銀,4,0,4,1,6.56
"20220411","1783","003700300030005a","7000",兆豐-高雄,1,4,3,-1,4.92
"20220411","1783","0039003800390043","9800",元大-板橋,3,0,3,1,4.92
"20220411","1783","9204","9200",凱基-台中,0,3,3,-1,4.92
"20220411","1783","8560","8560",新光,2,0,2,1,3.28
"20220411","1783","003900320030004e","9200",凱基-湖口,0,2,2,-1,3.28
"20220411","1783","9300","9300",華南永昌,2,0,2,1,3.28
"20220411","1783","9308","9300",華南永昌-麻豆,0,2,2,-1,3.28
"20220411","1783","9814","9800",元大-大益,2,0,2,1,3.28
"20220411","1783","0039003600320050","9600",富邦-頭份,0,2,2,-1,3.28
"20220411","1783","9834","9800",元大-中壢,1,0,1,1,1.64
"20220411","1783","2185","2180",亞東-台南,0,1,1,-1,1.64
"20220411","1783","003900380030004b","9800",元大-竹科,1,0,1,1,1.64
"20220411","1783","1590","1590",花旗環球,0,1,1,-1,1.64
"20220411","1783","1020","1020",合庫證券,1,0,1,1,1.64
"20220411","1783","1480","1480",美商高盛,0,1,1,-1,1.64
"20220411","1783","003500320036004b","5260",美好-富順,1,0,1,1,1.64
"20220411","1783","1118","1110",台灣企銀-豐原,0,1,1,-1,1.64
"20220411","1783","0035003300380043","5380",第一金-光復,1,0,1,1,1.64
"20220411","1783","1440","1440",美林,1,2,1,-1,1.64
"20220411","1783","0038003100350059","8150",台新-新營,1,0,1,1,1.64
"20220411","1783","5602","5600",永興-水湳,0,1,1,-1,1.64
"20220412","1783","8440","8440",摩根大通,8,0,8,1,9.20
"20220412","1783","1470","1470",台灣摩根士丹利,0,9,9,-1,10.34
"20220412","1783","9327","9300",華南永昌-斗六,8,0,8,1,9.20
"20220412","1783","003600310036004b","6160",中國信託-高雄,0,8,8,-1,9.20
"20220412","1783","0039004100390043","9A00",永豐金-員林,5,0,5,1,5.75
"20220412","1783","0035003900320049","5920",元富-嘉義,0,5,5,-1,5.75
"20220412","1783","1650","1650",新加坡商瑞銀,7,3,4,1,4.60
"20220412","1783","6164","6160",中國信託-文心,0,5,5,-1,5.75
"20220412","1783","0038003100350059","8150",台新-新營,4,0,4,1,4.60
"20220412","1783","9852","9800",元大-永春,0,5,5,-1,5.75
"20220412","1783","1440","1440",美林,6,3,3,1,3.45
"20220412","1783","9874","9800",元大-雙和,0,5,5,-1,5.75
"20220412","1783","0039003600310048","9600",富邦-新板,3,0,3,1,3.45
"20220412","1783","8157","8150",台新-左楠,0,4,4,-1,4.60
"20220412","1783","9302","9300",華南永昌-台中,2,0,2,1,2.30
"20220412","1783","003900320031004a","9200",凱基-土城,0,3,3,-1,3.45
"20220412","1783","0031003000320046","1020",合庫-西台中,2,0,2,1,2.30
"20220412","1783","0035003900320055","5920",元富-宜蘭,0,2,2,-1,2.30
"20220412","1783","8883","8880",國泰-松江,2,0,2,1,2.30
"20220412","1783","003800380034004a","8840",玉山-大里,0,2,2,-1,2.30
"20220412","1783","9215","9200",凱基-高美館,4,2,2,1,2.30
"20220412","1783","8842","8840",玉山-新莊,0,2,2,-1,2.30
"20220412","1783","9623","9600",富邦-台北,2,1,1,1,1.15
"20220412","1783","003500320036004b","5260",美好-富順,0,1,1,-1,1.15
"20220412","1783","5851","5850",統一-高雄,2,1,1,1,1.15
"20220412","1783","0038003800340046","8840",玉山-桃園,0,1,1,-1,1.15
"20220412","1783","5855","5850",統一-台南,1,0,1,1,1.15
"20220412","1783","003900310038004d","9100",群益金鼎-嘉義,0,1,1,-1,1.15
"20220413","1783","9614","9600",富邦-基隆,20,0,20,1,15.04
"20220413","1783","1470","1470",台灣摩根士丹利,0,11,11,-1,8.27
"20220413","1783","9655","9600",富邦-板橋,17,0,17,1,12.78
"20220413","1783","0039003800390047","9800",元大-大同,0,10,10,-1,7.52
"20220413","1783","1650","1650",新加坡商瑞銀,12,1,11,1,8.27
"20220413","1783","003900410039004c","9A00",永豐金-台中,0,10,10,-1,7.52
"20220413","1783","0037003700390065","7790",國票-南科,6,0,6,1,4.51
"20220413","1783","1480","1480",美商高盛,0,9,9,-1,6.77
"20220413","1783","9333","9300",華南永昌-長虹,5,0,5,1,3.76
"20220413","1783","8458","8450",康和-台南,0,5,5,-1,3.76
"20220413","1783","9255","9200",凱基-和平,4,0,4,1,3.01
"20220413","1783","8888","8880",國泰-敦南,0,5,5,-1,3.76
"20220413","1783","9800","9800",元大證券,5,1,4,1,3.01
"20220413","1783","0039003800330056","9800",元大-竹南,0,4,4,-1,3.01
"20220413","1783","1034","1030",土銀-嘉義,3,0,3,1,2.26
"20220413","1783","9686","9600",富邦-宜蘭,0,3,3,-1,2.26
"20220413","1783","1590","1590",花旗環球,2,0,2,1,1.50
"20220413","1783","0039003200300041","9200",凱基-板橋,0,2,2,-1,1.50
"20220413","1783","6210","6210",新百王,2,0,2,1,1.50
"20220413","1783","0039003200310045","9200",凱基-三峽,0,2,2,-1,1.50
"20220413","1783","8440","8440",摩根大通,2,0,2,1,1.50
"20220413","1783","9898","9800",元大-新莊,0,2,2,-1,1.50
"20220413","1783","9327","9300",華南永昌-斗六,2,0,2,1,1.50
"20220413","1783","0039003100380067","9100",群益金鼎-大甲,0,1,1,-1,0.75
"20220413","1783","0039003600320045","9600",富邦-樹林,2,0,2,1,1.50
"20220413","1783","1440","1440",美林,0,1,1,-1,0.75
"20220413","1783","003900380031004b","9800",元大-林園,2,0,2,1,1.50
"20220413","1783","1025","1020",合庫-基隆,0,1,1,-1,0.75
"20220414","1783","1650","1650",新加坡商瑞銀,32,7,25,1,5.04
"20220414","1783","5603","5600",永興-台中,0,37,37,-1,7.46
"20220414","1783","0039004100390043","9A00",永豐金-員林,25,0,25,1,5.04
"20220414","1783","0039004100390066","9A00",永豐金-中盛,0,12,12,-1,2.42
"20220414","1783","1480","1480",美商高盛,24,0,24,1,4.84
"20220414","1783","003800380034004a","8840",玉山-大里,0,11,11,-1,2.22
"20220414","1783","1440","1440",美林,33,10,23,1,4.64
"20220414","1783","5381","5380",第一金-員林,0,10,10,-1,2.02
"20220414","1783","5850","5850",統一,20,0,20,1,4.03
"20220414","1783","6915","6910",德信-和平,0,10,10,-1,2.02
"20220414","1783","003600310036004b","6160",中國信託-高雄,21,1,20,1,4.03
"20220414","1783","9255","9200",凱基-和平,2,12,10,-1,2.02
"20220414","1783","9800","9800",元大證券,17,3,14,1,2.82
"20220414","1783","8846","8840",玉山-板橋,0,9,9,-1,1.81
"20220414","1783","8440","8440",摩根大通,16,4,12,1,2.42
"20220414","1783","8560","8560",新光,10,18,8,-1,1.61
"20220414","1783","8847","8840",玉山-台南,9,0,9,1,1.81
"20220414","1783","9655","9600",富邦-板橋,0,8,8,-1,1.61
"20220414","1783","0035003800350049","5850",統一-員林,8,0,8,1,1.61
"20220414","1783","0031003200360069","1260",宏遠-光隆,0,7,7,-1,1.41
"20220414","1783","9268","9200",凱基-台北,38,31,7,1,1.41
"20220414","1783","9324","9300",華南永昌-岡山,0,7,7,-1,1.41
"20220414","1783","0039003800300044","9800",元大-北府,6,0,6,1,1.21
"20220414","1783","0039003200320048","9200",凱基-復興,0,7,7,-1,1.41
"20220414","1783","5050","5050",大展,5,0,5,1,1.01
"20220414","1783","0039003800300061","9800",元大-承德,0,6,6,-1,1.21
"20220414","1783","5854","5850",統一-城中,5,0,5,1,1.01
"20220414","1783","1032","1030",土銀-台南,0,5,5,-1,1.01
"20220415","1783","0037003700390076","7790",國票-台中,30,0,30,1,9.49
"20220415","1783","0039003800390047","9800",元大-大同,1,28,27,-1,8.54
"20220415","1783","0039003600320043","9600",富邦-東門,10,0,10,1,3.16
"20220415","1783","6110","6110",台中銀,0,10,10,-1,3.16
"20220415","1783","0039004100390042","9A00",永豐金-中和,10,0,10,1,3.16
"20220415","1783","1440","1440",美林,10,19,9,-1,2.85
"20220415","1783","0035003900320072","5920",元富-城東,5,0,5,1,1.58
"20220415","1783","9874","9800",元大-雙和,3,11,8,-1,2.53
"20220415","1783","0037003700390065","7790",國票-南科,7,2,5,1,1.58
"20220415","1783","8440","8440",摩根大通,2,9,7,-1,2.22
"20220415","1783","0038003100350059","8150",台新-新營,5,0,5,1,1.58
"20220415","1783","8847","8840",玉山-台南,1,8,7,-1,2.22
"20220415","1783","0039003200300047","9200",凱基-彰化,5,0,5,1,1.58
"20220415","1783","9266","9200",凱基-新豐,0,6,6,-1,1.90
"20220415","1783","0035003900320076","5920",元富-桃園,4,0,4,1,1.27
"20220415","1783","0039003800390044","9800",元大-左營,0,4,4,-1,1.27
"20220415","1783","6452","6450",永全-八德,4,0,4,1,1.27
"20220415","1783","9834","9800",元大-中壢,0,4,4,-1,1.27
"20220415","1783","1650","1650",新加坡商瑞銀,11,8,3,1,0.95
"20220415","1783","1480","1480",美商高盛,0,3,3,-1,0.95
"20220415","1783","0038003400350046","8450",康和-仁愛,3,0,3,1,0.95
"20220415","1783","5382","5380",第一金-台中,0,3,3,-1,0.95
"20220415","1783","0039003600310043","9600",富邦-南京,3,0,3,1,0.95
"20220415","1783","0037003000300068","7000",兆豐-三民,0,3,3,-1,0.95
"20220415","1783","8888","8880",國泰-敦南,2,0,2,1,0.63
"20220415","1783","0039003100330044","9100",群益金鼎-潭子,0,3,3,-1,0.95
"20220415","1783","0039003100330059","9100",群益金鼎-館前,2,0,2,1,0.63
"20220415","1783","0039003200300057","9200",凱基-大里,0,3,3,-1,0.95
"20220316","1783","8156","8150",台新-三民,10,0,10,1,8.77
"20220316","1783","5854","5850",統一-城中,0,15,15,-1,13.16
"20220316","1783","8886","8880",國泰-新莊,10,0,10,1,8.77
"20220316","1783","6380","6380",光和,0,10,10,-1,8.77
"20220316","1783","9206","9200",凱基-高雄,10,0,10,1,8.77
"20220316","1783","003900360032004b","9600",富邦-中和,0,6,6,-1,5.26
"20220316","1783","9268","9200",凱基-台北,15,8,7,1,6.14
"20220316","1783","0037003700390065","7790",國票-南科,0,5,5,-1,4.39
"20220316","1783","1114","1110",台灣企銀-嘉義,5,0,5,1,4.39
"20220316","1783","0039003800320041","9800",元大-羅東,0,5,5,-1,4.39
"20220316","1783","8380","8380",安泰,4,0,4,1,3.51
"20220316","1783","0039004100390042","9A00",永豐金-中和,0,4,4,-1,3.51
"20220316","1783","9227","9200",凱基-城中,4,0,4,1,3.51
"20220316","1783","9692","9600",富邦-嘉義,0,4,4,-1,3.51
"20220316","1783","2180","2180",亞東,8,5,3,1,2.63
"20220316","1783","8885","8880",國泰-桃園,0,3,3,-1,2.63
"20220316","1783","9255","9200",凱基-和平,4,1,3,1,2.63
"20220316","1783","9661","9600",富邦-新店,0,2,2,-1,1.75
"20220316","1783","9278","9200",凱基-永康,2,0,2,1,1.75
"20220316","1783","9898","9800",元大-新莊,0,2,2,-1,1.75
"20220316","1783","0039004100390037","9A00",永豐金-新竹,2,0,2,1,1.75
"20220316","1783","003900380030004b","9800",元大-竹科,0,2,2,-1,1.75
"20220316","1783","8560","8560",新光,2,1,1,1,0.88
"20220316","1783","1560","1560",港商野村,0,1,1,-1,0.88
"20220316","1783","1650","1650",新加坡商瑞銀,1,0,1,1,0.88
"20220316","1783","1520","1520",瑞士信貸,0,1,1,-1,0.88
"20220316","1783","0031003000340041","1040",臺銀-臺中,1,0,1,1,0.88
"20220316","1783","1043","1040",臺銀-民權,0,1,1,-1,0.88
"20220317","1783","8581","8580",聯邦-高雄,30,0,30,1,15.08
"20220317","1783","1470","1470",台灣摩根士丹利,0,19,19,-1,9.55
"20220317","1783","9231","9200",凱基-員林,30,0,30,1,15.08
"20220317","1783","9274","9200",凱基-鳳山,0,18,18,-1,9.05
"20220317","1783","0039004100390043","9A00",永豐金-員林,26,0,26,1,13.07
"20220317","1783","5854","5850",統一-城中,0,13,13,-1,6.53
"20220317","1783","0036003100360041","6160",中國信託-中壢,15,0,15,1,7.54
"20220317","1783","9834","9800",元大-中壢,0,12,12,-1,6.03
"20220317","1783","7790","7790",國票證券,5,0,5,1,2.51
"20220317","1783","9329","9300",華南永昌-朴子,0,10,10,-1,5.03
"20220317","1783","1590","1590",花旗環球,4,0,4,1,2.01
"20220317","1783","0039003800320041","9800",元大-羅東,0,10,10,-1,5.03
"20220317","1783","1440","1440",美林,3,0,3,1,1.51
"20220317","1783","9223","9200",凱基-豐中,1,10,9,-1,4.52
"20220317","1783","0039003100330049","9100",群益金鼎-萬華,3,0,3,1,1.51
"20220317","1783","9686","9600",富邦-宜蘭,0,8,8,-1,4.02
"20220317","1783","1520","1520",瑞士信貸,2,0,2,1,1.01
"20220317","1783","9255","9200",凱基-和平,1,5,4,-1,2.01
"20220317","1783","003900380039004e","9800",元大-內湖,2,0,2,1,1.01
"20220317","1783","0035003900320048","5920",元富-信義,0,3,3,-1,1.51
"20220317","1783","1560","1560",港商野村,1,0,1,1,0.50
"20220317","1783","0038003400350041","8450",康和-內湖,0,3,3,-1,1.51
"20220317","1783","5265","5260",美好-苗栗,1,0,1,1,0.50
"20220317","1783","003900310038004a","9100",群益金鼎-永和,0,3,3,-1,1.51
"20220317","1783","2180","2180",亞東,1,0,1,1,0.50
"20220317","1783","0039003200300044","9200",凱基-市府,0,2,2,-1,1.01
"20220317","1783","003500390032004c","5920",元富-中壢,1,0,1,1,0.50
"20220317","1783","9647","9600",富邦-新竹,0,2,2,-1,1.01
"20220318","1783","0039004100390043","9A00",永豐金-員林,9,0,9,1,7.76
"20220318","1783","1470","1470",台灣摩根士丹利,0,19,19,-1,16.38
"20220318","1783","9892","9800",元大-屏東,6,0,6,1,5.17
"20220318","1783","5854","5850",統一-城中,0,5,5,-1,4.31
"20220318","1783","5850","5850",統一,10,5,5,1,4.31
"20220318","1783","8440","8440",摩根大通,4,7,3,-1,2.59
"20220318","1783","8157","8150",台新-左楠,5,0,5,1,4.31
"20220318","1783","8562","8560",新光-高雄,0,3,3,-1,2.59
"20220318","1783","003500390032004c","5920",元富-中壢,3,0,3,1,2.59
"20220318","1783","1520","1520",瑞士信貸,0,2,2,-1,1.72
"20220318","1783","003700300030005a","7000",兆豐-高雄,3,0,3,1,2.59
"20220318","1783","2181","2180",亞東-板橋,0,2,2,-1,1.72
"20220318","1783","9237","9200",凱基-敦北,3,0,3,1,2.59
"20220318","1783","0037003000300045","7000",兆豐-斗南(停),0,2,2,-1,1.72
"20220318","1783","1440","1440",美林,3,1,2,1,1.72
"20220318","1783","2180","2180",亞東,0,1,1,-1,0.86
"20220318","1783","9268","9200",凱基-台北,15,13,2,1,1.72
"20220318","1783","5265","5260",美好-苗栗,0,1,1,-1,0.86
"20220318","1783","9837","9800",元大-北港,2,0,2,1,1.72
"20220318","1783","0035003300380050","5380",第一金-路竹,0,1,1,-1,0.86
"20220318","1783","0039004100390050","9A00",永豐金-竹北,2,0,2,1,1.72
"20220318","1783","6165","6160",中國信託-新竹,0,1,1,-1,0.86
"20220318","1783","8884","8880",國泰-台南,1,0,1,1,0.86
"20220318","1783","003600310036004b","6160",中國信託-高雄,1,2,1,-1,0.86
"20220318","1783","5323","5320",高橋-內壢,1,0,1,1,0.86
"20220318","1783","0037003000300048","7000",兆豐-東門,0,1,1,-1,0.86
"20220318","1783","1480","1480",美商高盛,1,0,1,1,0.86
"20220318","1783","8150","8150",台新證券,0,1,1,-1,0.86
"20220321","1783","9268","9200",凱基-台北,35,9,26,1,11.40
"20220321","1783","1470","1470",台灣摩根士丹利,0,21,21,-1,9.21
"20220321","1783","0037003000300048","7000",兆豐-東門,26,2,24,1,10.53
"20220321","1783","0039003800320043","9800",元大-六合,0,18,18,-1,7.89
"20220321","1783","1560","1560",港商野村,9,0,9,1,3.95
"20220321","1783","5854","5850",統一-城中,0,10,10,-1,4.39
"20220321","1783","0039003200300044","9200",凱基-市府,7,0,7,1,3.07
"20220321","1783","9255","9200",凱基-和平,0,8,8,-1,3.51
"20220321","1783","0039004100390032","9A00",永豐金-萬盛,7,0,7,1,3.07
"20220321","1783","0039003800390065","9800",元大-中和,0,8,8,-1,3.51
"20220321","1783","8440","8440",摩根大通,12,6,6,1,2.63
"20220321","1783","0039004100390037","9A00",永豐金-新竹,0,7,7,-1,3.07
"20220321","1783","5600","5600",永興,5,0,5,1,2.19
"20220321","1783","9813","9800",元大-八德,0,5,5,-1,2.19
"20220321","1783","003800340035004a","8450",康和-高雄,5,0,5,1,2.19
"20220321","1783","5263","5260",美好-泰山,0,3,3,-1,1.32
"20220321","1783","8560","8560",新光,8,3,5,1,2.19
"20220321","1783","5265","5260",美好-苗栗,1,4,3,-1,1.32
"20220321","1783","0039003600310052","9600",富邦-南員林,5,0,5,1,2.19
"20220321","1783","9215","9200",凱基-高美館,0,3,3,-1,1.32
"20220321","1783","2180","2180",亞東,3,0,3,1,1.32
"20220321","1783","9237","9200",凱基-敦北,0,3,3,-1,1.32
"20220321","1783","1650","1650",新加坡商瑞銀,4,1,3,1,1.32
"20220321","1783","9324","9300",華南永昌-岡山,0,3,3,-1,1.32
"20220321","1783","0035003900320049","5920",元富-嘉義,3,0,3,1,1.32
"20220321","1783","0039003800320042","9800",元大-博愛,0,3,3,-1,1.32
"20220321","1783","1480","1480",美商高盛,2,0,2,1,0.88
"20220321","1783","0039003800390051","9800",元大-汐止,0,3,3,-1,1.32
"20220322","1783","6915","6910",德信-和平,39,0,39,1,5.20
"20220322","1783","9268","9200",凱基-台北,21,68,47,-1,6.27
"20220322","1783","0037003000300048","7000",兆豐-東門,35,2,33,1,4.40
"20220322","1783","8440","8440",摩根大通,11,38,27,-1,3.60
"20220322","1783","9276","9200",凱基-苗栗,31,0,31,1,4.13
"20220322","1783","1470","1470",台灣摩根士丹利,0,26,26,-1,3.47
"20220322","1783","9896","9800",元大-台南,20,0,20,1,2.67
"20220322","1783","5850","5850",統一,1,27,26,-1,3.47
"20220322","1783","0039003100330067","9100",群益金鼎-三重,18,0,18,1,2.40
"20220322","1783","1043","1040",臺銀-民權,0,20,20,-1,2.67
"20220322","1783","8840","8840",玉山證券,16,0,16,1,2.13
"20220322","1783","0039004100390037","9A00",永豐金-新竹,0,20,20,-1,2.67
"20220322","1783","003700370039006e","7790",國票-南京,10,0,10,1,1.33
"20220322","1783","5854","5850",統一-城中,0,18,18,-1,2.40
"20220322","1783","9676","9600",富邦-仁愛,8,0,8,1,1.07
"20220322","1783","0039003800390047","9800",元大-大同,1,19,18,-1,2.40
"20220322","1783","0039003600310044","9600",富邦-忠孝,7,0,7,1,0.93
"20220322","1783","1650","1650",新加坡商瑞銀,4,16,12,-1,1.60
"20220322","1783","9858","9800",元大-龍潭,7,1,6,1,0.80
"20220322","1783","8580","8580",聯邦商銀,1,13,12,-1,1.60
"20220322","1783","8847","8840",玉山-台南,7,1,6,1,0.80
"20220322","1783","9800","9800",元大證券,2,10,8,-1,1.07
"20220322","1783","0039003100330044","9100",群益金鼎-潭子,6,0,6,1,0.80
"20220322","1783","0039003200300044","9200",凱基-市府,0,7,7,-1,0.93
"20220322","1783","0039003800310055","9800",元大-華山,6,0,6,1,0.80
"20220322","1783","003500320036004b","5260",美好-富順,1,7,6,-1,0.80
"20220322","1783","0039003800350043","9800",元大-鳳中,6,0,6,1,0.80
"20220322","1783","9255","9200",凱基-和平,0,6,6,-1,0.80
"20220323","1783","0037003000300048","7000",兆豐-東門,39,0,39,1,6.70
"20220323","1783","8440","8440",摩根大通,17,64,47,-1,8.08
"20220323","1783","0031003000330046","1030",土銀-南港,35,0,35,1,6.01
"20220323","1783","9276","9200",凱基-苗栗,1,31,30,-1,5.15
"20220323","1783","9319","9300",華南永昌-鶯歌,33,0,33,1,5.67
"20220323","1783","9268","9200",凱基-台北,11,31,20,-1,3.44
"20220323","1783","0039004100390043","9A00",永豐金-員林,46,13,33,1,5.67
"20220323","1783","0039003100330067","9100",群益金鼎-三重,4,22,18,-1,3.09
"20220323","1783","003800340035004a","8450",康和-高雄,20,0,20,1,3.44
"20220323","1783","003600310036004b","6160",中國信託-高雄,0,17,17,-1,2.92
"20220323","1783","0039003800320041","9800",元大-羅東,11,0,11,1,1.89
"20220323","1783","003700370039006e","7790",國票-南京,0,10,10,-1,1.72
"20220323","1783","0039003800390056","9800",元大-北三重,10,0,10,1,1.72
"20220323","1783","0039004100390039","9A00",永豐金-中壢,0,10,10,-1,1.72
"20220323","1783","6915","6910",德信-和平,10,0,10,1,1.72
"20220323","1783","8158","8150",台新-松江,0,7,7,-1,1.20
"20220323","1783","9238","9200",凱基-士林,10,0,10,1,1.72
"20220323","1783","9686","9600",富邦-宜蘭,0,7,7,-1,1.20
"20220323","1783","003900320031004d","9200",凱基-八德,9,1,8,1,1.37
"20220323","1783","8847","8840",玉山-台南,0,6,6,-1,1.03
"20220323","1783","9831","9800",元大-四維,7,0,7,1,1.20
"20220323","1783","9858","9800",元大-龍潭,2,8,6,-1,1.03
"20220323","1783","0039003200300057","9200",凱基-大里,6,0,6,1,1.03
"20220323","1783","9303","9300",華南永昌-高雄,0,5,5,-1,0.86
"20220323","1783","1035","1030",土銀-新竹,5,0,5,1,0.86
"20220323","1783","9329","9300",華南永昌-朴子,0,5,5,-1,0.86
"20220323","1783","9283","9200",凱基-北門,5,0,5,1,0.86
"20220323","1783","003900380039004c","9800",元大-成功,0,5,5,-1,0.86
"20220324","1783","0038003400350046","8450",康和-仁愛,25,0,25,1,10.73
"20220324","1783","1470","1470",台灣摩根士丹利,0,17,17,-1,7.30
"20220324","1783","6380","6380",光和,20,0,20,1,8.58
"20220324","1783","8440","8440",摩根大通,2,18,16,-1,6.87
"20220324","1783","0031003000330046","1030",土銀-南港,20,10,10,1,4.29
"20220324","1783","9892","9800",元大-屏東,0,9,9,-1,3.86
"20220324","1783","003600310036004b","6160",中國信託-高雄,7,0,7,1,3.00
"20220324","1783","1560","1560",港商野村,0,7,7,-1,3.00
"20220324","1783","9100","9100",群益金鼎,6,0,6,1,2.58
"20220324","1783","1440","1440",美林,0,6,6,-1,2.58
"20220324","1783","1020","1020",合庫證券,5,0,5,1,2.15
"20220324","1783","5850","5850",統一,0,6,6,-1,2.58
"20220324","1783","0039003100380075","9100",群益金鼎-瑞豐,5,0,5,1,2.15
"20220324","1783","9854","9800",元大-文心興安,0,5,5,-1,2.15
"20220324","1783","0039003800320041","9800",元大-羅東,4,0,4,1,1.72
"20220324","1783","6160","6160",中國信託,1,4,3,-1,1.29
"20220324","1783","0039003800390044","9800",元大-左營,4,0,4,1,1.72
"20220324","1783","003800380034004d","8840",玉山-數位,0,3,3,-1,1.29
"20220324","1783","2180","2180",亞東,3,0,3,1,1.29
"20220324","1783","0035003300380050","5380",第一金-路竹,0,2,2,-1,0.86
"20220324","1783","9206","9200",凱基-高雄,3,0,3,1,1.29
"20220324","1783","1590","1590",花旗環球,0,2,2,-1,0.86
"20220324","1783","9266","9200",凱基-新豐,3,0,3,1,1.29
"20220324","1783","5920","5920",元富,0,2,2,-1,0.86
"20220324","1783","0039004100390038","9A00",永豐金-大園,3,0,3,1,1.29
"20220324","1783","0035003900320049","5920",元富-嘉義,0,2,2,-1,0.86
"20220324","1783","0031003000320047","1020",合庫-三重,2,0,2,1,0.86
"20220324","1783","8887","8880",國泰-忠孝,0,2,2,-1,0.86
"20220325","1783","0037003000300048","7000",兆豐-東門,17,2,15,1,8.24
"20220325","1783","1470","1470",台灣摩根士丹利,0,19,19,-1,10.44
"20220325","1783","003500380035004a","5850",統一-三重,12,0,12,1,6.59
"20220325","1783","0039003200320048","9200",凱基-復興,0,18,18,-1,9.89
"20220325","1783","5381","5380",第一金-員林,8,0,8,1,4.40
"20220325","1783","8440","8440",摩根大通,3,19,16,-1,8.79
"20220325","1783","0039004100360031","9A00",永豐金-鳳山,8,0,8,1,4.40
"20220325","1783","1440","1440",美林,0,8,8,-1,4.40
"20220325","1783","0039004100390066","9A00",永豐金-中盛,6,0,6,1,3.30
"20220325","1783","0037003700390057","7790",國票-彰化,0,5,5,-1,2.75
"20220325","1783","003700300030006b","7000",兆豐-員林,5,0,5,1,2.75
"20220325","1783","0037003000300073","7000",兆豐-岡山,0,3,3,-1,1.65
"20220325","1783","9661","9600",富邦-新店,5,0,5,1,2.75
"20220325","1783","8840","8840",玉山證券,0,3,3,-1,1.65
"20220325","1783","6164","6160",中國信託-文心,4,0,4,1,2.20
"20220325","1783","9206","9200",凱基-高雄,0,3,3,-1,1.65
"20220325","1783","7008","7000",兆豐-三重,4,0,4,1,2.20
"20220325","1783","0039003800320042","9800",元大-博愛,0,3,3,-1,1.65
"20220325","1783","8157","8150",台新-左楠,3,0,3,1,1.65
"20220325","1783","0039003800350043","9800",元大-鳳中,0,3,3,-1,1.65
"20220325","1783","6160","6160",中國信託,2,0,2,1,1.10
"20220325","1783","2180","2180",亞東,7,9,2,-1,1.10
"20220325","1783","0038003800340046","8840",玉山-桃園,2,0,2,1,1.10
"20220325","1783","5920","5920",元富,0,2,2,-1,1.10
"20220325","1783","9255","9200",凱基-和平,5,3,2,1,1.10
"20220325","1783","8158","8150",台新-松江,0,2,2,-1,1.10
"20220325","1783","003900360032004b","9600",富邦-中和,2,0,2,1,1.10
"20220325","1783","8565","8560",新光-桃園,0,2,2,-1,1.10
"20220328","1783","003700300030004b","7000",兆豐-新營,15,0,15,1,5.66
"20220328","1783","003500390032007a","5920",元富-文心,0,16,16,-1,6.04
"20220328","1783","9268","9200",凱基-台北,20,9,11,1,4.15
"20220328","1783","003800340035004a","8450",康和-高雄,0,15,15,-1,5.66
"20220328","1783","9676","9600",富邦-仁愛,10,0,10,1,3.77
"20220328","1783","8158","8150",台新-松江,0,14,14,-1,5.28
"20220328","1783","8560","8560",新光,9,0,9,1,3.40
"20220328","1783","5850","5850",統一,0,13,13,-1,4.91
"20220328","1783","9278","9200",凱基-永康,10,1,9,1,3.40
"20220328","1783","1470","1470",台灣摩根士丹利,0,11,11,-1,4.15
"20220328","1783","0039003800320041","9800",元大-羅東,7,0,7,1,2.64
"20220328","1783","1440","1440",美林,0,11,11,-1,4.15
"20220328","1783","0035003900320062","5920",元富-板橋,5,0,5,1,1.89
"20220328","1783","0039004100360039","9A00",永豐金-屏東,0,10,10,-1,3.77
"20220328","1783","0035003900320057","5920",元富-吉利,5,0,5,1,1.89
"20220328","1783","0039003600310044","9600",富邦-忠孝,0,7,7,-1,2.64
"20220328","1783","8157","8150",台新-左楠,5,0,5,1,1.89
"20220328","1783","5600","5600",永興,0,5,5,-1,1.89
"20220328","1783","9100","9100",群益金鼎,5,0,5,1,1.89
"20220328","1783","0038003100350059","8150",台新-新營,0,5,5,-1,1.89
"20220328","1783","0039003200300041","9200",凱基-板橋,5,0,5,1,1.89
"20220328","1783","8156","8150",台新-三民,0,3,3,-1,1.13
"20220328","1783","0039003800310065","9800",元大-佳里,5,0,5,1,1.89
"20220328","1783","9604","9600",富邦-陽明,0,3,3,-1,1.13
"20220328","1783","0039004100390067","9A00",永豐金-內湖,5,0,5,1,1.89
"20220328","1783","0039003800310067","9800",元大-大里,0,3,3,-1,1.13
"20220328","1783","0031003000330046","1030",土銀-南港,4,0,4,1,1.51
"20220328","1783","1590","1590",花旗環球,0,2,2,-1,0.75
"20220329","1783","0039004100390043","9A00",永豐金-員林,25,0,25,1,17.61
"20220329","1783","6160","6160",中國信託,0,12,12,-1,8.45
"20220329","1783","6380","6380",光和,12,0,12,1,8.45
"20220329","1783","1440","1440",美林,3,11,8,-1,5.63
"20220329","1783","1030","1030",土銀,7,0,7,1,4.93
"20220329","1783","2180","2180",亞東,0,6,6,-1,4.23
"20220329","1783","8848","8840",玉山-嘉義,5,0,5,1,3.52
"20220329","1783","9661","9600",富邦-新店,0,5,5,-1,3.52
"20220329","1783","0039003800300064","9800",元大-沙鹿,5,0,5,1,3.52
"20220329","1783","0039004100390067","9A00",永豐金-內湖,0,5,5,-1,3.52
"20220329","1783","1650","1650",新加坡商瑞銀,4,0,4,1,2.82
"20220329","1783","0035003900320041","5920",元富-緯城,0,5,5,-1,3.52
"20220329","1783","0038003400350046","8450",康和-仁愛,4,0,4,1,2.82
"20220329","1783","0035003800350044","5850",統一-新台中,0,4,4,-1,2.82
"20220329","1783","9319","9300",華南永昌-鶯歌,4,0,4,1,2.82
"20220329","1783","1480","1480",美商高盛,0,4,4,-1,2.82
"20220329","1783","0039003800390043","9800",元大-板橋,3,0,3,1,2.11
"20220329","1783","1470","1470",台灣摩根士丹利,0,4,4,-1,2.82
"20220329","1783","5603","5600",永興-台中,2,0,2,1,1.41
"20220329","1783","1022","1020",合庫-台南,0,3,3,-1,2.11
"20220329","1783","8492","8490",京城-嘉義,2,0,2,1,1.41
"20220329","1783","0035003300380057","5380",第一金-華江,0,2,2,-1,1.41
"20220329","1783","0039003200300048","9200",凱基-基隆,2,0,2,1,1.41
"20220329","1783","8440","8440",摩根大通,5,7,2,-1,1.41
"20220329","1783","0039003800390046","9800",元大-高雄,2,0,2,1,1.41
"20220329","1783","9255","9200",凱基-和平,0,2,2,-1,1.41
"20220329","1783","1116","1110",台灣企銀-屏東,1,0,1,1,0.70
"20220329","1783","9623","9600",富邦-台北,0,2,2,-1,1.41
"20220330","1783","1650","1650",新加坡商瑞銀,23,0,23,1,9.06
"20220330","1783","0036003100360041","6160",中國信託-中壢,0,20,20,-1,7.87
"20220330","1783","5850","5850",統一,20,0,20,1,7.87
"20220330","1783","0036003000310064","6010",(牛牛牛)亞-鑫豐,2,16,14,-1,5.51
"20220330","1783","0031003000330046","1030",土銀-南港,20,10,10,1,3.94
"20220330","1783","1470","1470",台灣摩根士丹利,0,12,12,-1,4.72
"20220330","1783","0038003400350046","8450",康和-仁愛,10,0,10,1,3.94
"20220330","1783","8560","8560",新光,0,12,12,-1,4.72
"20220330","1783","0039004100390043","9A00",永豐金-員林,25,15,10,1,3.94
"20220330","1783","003800380034004a","8840",玉山-大里,0,10,10,-1,3.94
"20220330","1783","9800","9800",元大證券,6,0,6,1,2.36
"20220330","1783","8840","8840",玉山證券,0,9,9,-1,3.54
"20220330","1783","6161","6160",中國信託-三重,5,0,5,1,1.97
"20220330","1783","0035003900320062","5920",元富-板橋,0,7,7,-1,2.76
"20220330","1783","6164","6160",中國信託-文心,5,0,5,1,1.97
"20220330","1783","0037003000300048","7000",兆豐-東門,1,8,7,-1,2.76
"20220330","1783","8440","8440",摩根大通,7,2,5,1,1.97
"20220330","1783","1035","1030",土銀-新竹,0,5,5,-1,1.97
"20220330","1783","8848","8840",玉山-嘉義,5,0,5,1,1.97
"20220330","1783","1020","1020",合庫證券,0,5,5,-1,1.97
"20220330","1783","0039003200300056","9200",凱基-新店,5,0,5,1,1.97
"20220330","1783","8158","8150",台新-松江,0,4,4,-1,1.57
"20220330","1783","9278","9200",凱基-永康,5,0,5,1,1.97
"20220330","1783","0039003200300057","9200",凱基-大里,0,4,4,-1,1.57
"20220330","1783","2180","2180",亞東,3,0,3,1,1.18
"20220330","1783","0039003200320048","9200",凱基-復興,0,4,4,-1,1.57
"20220330","1783","0039003100330049","9100",群益金鼎-萬華,3,0,3,1,1.18
"20220330","1783","003900380031006a","9800",元大-士林,0,4,4,-1,1.57
"20220331","1783","9278","9200",凱基-永康,10,0,10,1,14.08
"20220331","1783","1440","1440",美林,1,6,5,-1,7.04
"20220331","1783","0039003800390043","9800",元大-板橋,4,0,4,1,5.63
"20220331","1783","8440","8440",摩根大通,2,7,5,-1,7.04
"20220331","1783","1030","1030",土銀,3,1,2,1,2.82
"20220331","1783","003800340035004a","8450",康和-高雄,0,5,5,-1,7.04
"20220331","1783","9655","9600",富邦-板橋,2,0,2,1,2.82
"20220331","1783","9268","9200",凱基-台北,0,4,4,-1,5.63
"20220331","1783","9667","9600",富邦-台南,2,0,2,1,2.82
"20220331","1783","003600310036004b","6160",中國信託-高雄,0,4,4,-1,5.63
"20220331","1783","0039004100390047","9A00",永豐金-天母,2,0,2,1,2.82
"20220331","1783","1650","1650",新加坡商瑞銀,1,4,3,-1,4.23
"20220331","1783","5929","5920",元富-台南,1,0,1,1,1.41
"20220331","1783","6160","6160",中國信託,1,3,2,-1,2.82
"20220331","1783","0035003800350044","5850",統一-新台中,1,0,1,1,1.41
"20220331","1783","6950","6950",福勝,0,2,2,-1,2.82
"20220331","1783","5850","5850",統一,1,0,1,1,1.41
"20220331","1783","1590","1590",花旗環球,0,1,1,-1,1.41
"20220331","1783","003500320036004b","5260",美好-富順,2,1,1,1,1.41
"20220331","1783","1029","1020",合庫-鳳山,0,1,1,-1,1.41
"20220331","1783","0037003000300043","7000",兆豐-來福,1,0,1,1,1.41
"20220331","1783","0036003000310064","6010",(牛牛牛)亞-鑫豐,0,1,1,-1,1.41
"20220331","1783","8150","8150",台新證券,1,0,1,1,1.41
"20220331","1783","003700300030004d","7000",兆豐-桃園,0,1,1,-1,1.41
"20220331","1783","8900","8900",法銀巴黎,1,0,1,1,1.41
"20220331","1783","0038003800340046","8840",玉山-桃園,0,1,1,-1,1.41
"20220331","1783","9137","9100",群益金鼎-士林,1,0,1,1,1.41
"20220331","1783","9206","9200",凱基-高雄,0,1,1,-1,1.41
"20220301","1783","1440","1440",美林,15,0,15,1,10.79
"20220301","1783","1470","1470",台灣摩根士丹利,0,11,11,-1,7.91
"20220301","1783","1650","1650",新加坡商瑞銀,16,1,15,1,10.79
"20220301","1783","8565","8560",新光-桃園,0,8,8,-1,5.76
"20220301","1783","0037003700390075","7790",國票-長城,10,0,10,1,7.19
"20220301","1783","003900380039004a","9800",元大-彰化民生,0,6,6,-1,4.32
"20220301","1783","1590","1590",花旗環球,6,0,6,1,4.32
"20220301","1783","6162","6160",中國信託-忠孝,1,6,5,-1,3.60
"20220301","1783","003500380035005a","5850",統一-松江,4,0,4,1,2.88
"20220301","1783","8847","8840",玉山-台南,0,5,5,-1,3.60
"20220301","1783","9257","9200",凱基-林口,3,0,3,1,2.16
"20220301","1783","9208","9200",凱基-桃園,1,5,4,-1,2.88
"20220301","1783","9268","9200",凱基-台北,12,9,3,1,2.16
"20220301","1783","0039003800320041","9800",元大-羅東,0,4,4,-1,2.88
"20220301","1783","5925","5920",元富-台中,2,0,2,1,1.44
"20220301","1783","1480","1480",美商高盛,0,3,3,-1,2.16
"20220301","1783","0037003700390044","7790",國票-台南,2,0,2,1,1.44
"20220301","1783","9227","9200",凱基-城中,0,3,3,-1,2.16
"20220301","1783","9329","9300",華南永昌-朴子,2,0,2,1,1.44
"20220301","1783","0039003800310068","9800",元大-屏東民生,0,3,3,-1,2.16
"20220301","1783","9604","9600",富邦-陽明,2,0,2,1,1.44
"20220301","1783","0039003800310051","9800",元大-太平,0,3,3,-1,2.16
"20220301","1783","0039003800390047","9800",元大-大同,2,0,2,1,1.44
"20220301","1783","0035003800350044","5850",統一-新台中,1,3,2,-1,1.44
"20220301","1783","0038003400350044","8450",康和-板橋,1,0,1,1,0.72
"20220301","1783","8157","8150",台新-左楠,0,2,2,-1,1.44
"20220301","1783","0039003800320043","9800",元大-六合,1,0,1,1,0.72
"20220301","1783","0039003200300044","9200",凱基-市府,0,2,2,-1,1.44
"20220302","1783","8440","8440",摩根大通,9,1,8,1,11.43
"20220302","1783","0039004100390032","9A00",永豐金-萬盛,0,10,10,-1,14.29
"20220302","1783","9208","9200",凱基-桃園,6,0,6,1,8.57
"20220302","1783","9608","9600",富邦-台東,0,5,5,-1,7.14
"20220302","1783","1650","1650",新加坡商瑞銀,5,0,5,1,7.14
"20220302","1783","0039003800300065","9800",元大-清水,0,5,5,-1,7.14
"20220302","1783","9800","9800",元大證券,8,3,5,1,7.14
"20220302","1783","0039003200300044","9200",凱基-市府,0,4,4,-1,5.71
"20220302","1783","9268","9200",凱基-台北,5,1,4,1,5.71
"20220302","1783","0039003800390047","9800",元大-大同,0,4,4,-1,5.71
"20220302","1783","003600310036004b","6160",中國信託-高雄,2,0,2,1,2.86
"20220302","1783","1041","1040",臺銀-鳳山,0,3,3,-1,4.29
"20220302","1783","2180","2180",亞東,2,0,2,1,2.86
"20220302","1783","0037003700390044","7790",國票-台南,0,2,2,-1,2.86
"20220302","1783","6381","6380",光和-溪湖,1,0,1,1,1.43
"20220302","1783","8842","8840",玉山-新莊,0,2,2,-1,2.86
"20220302","1783","003700300030005a","7000",兆豐-高雄,1,0,1,1,1.43
"20220302","1783","003900380031005a","9800",元大-潮州,0,2,2,-1,2.86
"20220302","1783","0035003900320071","5920",元富-屏東,1,0,1,1,1.43
"20220302","1783","1480","1480",美商高盛,2,3,1,-1,1.43
"20220302","1783","0035003800350044","5850",統一-新台中,1,0,1,1,1.43
"20220302","1783","1440","1440",美林,0,1,1,-1,1.43
"20220302","1783","5602","5600",永興-水湳,1,0,1,1,1.43
"20220302","1783","0031003200360069","1260",宏遠-光隆,0,1,1,-1,1.43
"20220302","1783","0037003700390056","7790",國票-天祥,1,0,1,1,1.43
"20220302","1783","0037003000300073","7000",兆豐-岡山,0,1,1,-1,1.43
"20220302","1783","003900320030005a","9200",凱基-台東,1,0,1,1,1.43
"20220302","1783","0039003600310043","9600",富邦-南京,0,1,1,-1,1.43
"20220303","1783","1650","1650",新加坡商瑞銀,11,0,11,1,6.29
"20220303","1783","9322","9300",華南永昌-公誠,0,14,14,-1,8.00
"20220303","1783","003600310036004b","6160",中國信託-高雄,20,10,10,1,5.71
"20220303","1783","1470","1470",台灣摩根士丹利,0,12,12,-1,6.86
"20220303","1783","0039004100390032","9A00",永豐金-萬盛,10,0,10,1,5.71
"20220303","1783","1115","1110",台灣企銀-太平,0,10,10,-1,5.71
"20220303","1783","9268","9200",凱基-台北,16,7,9,1,5.14
"20220303","1783","0039003800390047","9800",元大-大同,0,8,8,-1,4.57
"20220303","1783","1440","1440",美林,13,6,7,1,4.00
"20220303","1783","9862","9800",元大-南京,0,5,5,-1,2.86
"20220303","1783","1110","1110",台灣企銀,4,0,4,1,2.29
"20220303","1783","0031003200360058","1260",宏遠-新化,0,5,5,-1,2.86
"20220303","1783","003500320036004b","5260",美好-富順,6,2,4,1,2.29
"20220303","1783","0037003700390057","7790",國票-彰化,0,5,5,-1,2.86
"20220303","1783","5603","5600",永興-台中,4,0,4,1,2.29
"20220303","1783","8150","8150",台新證券,0,4,4,-1,2.29
"20220303","1783","9856","9800",元大-花蓮,5,1,4,1,2.29
"20220303","1783","0037003700390076","7790",國票-台中,0,3,3,-1,1.71
"20220303","1783","0039004100390042","9A00",永豐金-中和,3,0,3,1,1.71
"20220303","1783","9676","9600",富邦-仁愛,0,3,3,-1,1.71
"20220303","1783","0038003400350044","8450",康和-板橋,3,0,3,1,1.71
"20220303","1783","1480","1480",美商高盛,1,3,2,-1,1.14
"20220303","1783","2180","2180",亞東,2,0,2,1,1.14
"20220303","1783","8560","8560",新光,3,5,2,-1,1.14
"20220303","1783","5381","5380",第一金-員林,2,0,2,1,1.14
"20220303","1783","9255","9200",凱基-和平,2,4,2,-1,1.14
"20220303","1783","5856","5850",統一-台中,2,0,2,1,1.14
"20220303","1783","0039003600320047","9600",富邦-斗六,0,2,2,-1,1.14
"20220304","1783","9813","9800",元大-八德,10,0,10,1,10.20
"20220304","1783","0039004100390032","9A00",永豐金-萬盛,0,10,10,-1,10.20
"20220304","1783","0039004100300030","9A00",永豐金證券,6,0,6,1,6.12
"20220304","1783","1650","1650",新加坡商瑞銀,0,9,9,-1,9.18
"20220304","1783","003500320036004b","5260",美好-富順,3,0,3,1,3.06
"20220304","1783","9268","9200",凱基-台北,0,7,7,-1,7.14
"20220304","1783","003500380035004a","5850",統一-三重,3,0,3,1,3.06
"20220304","1783","0038003800380041","8880",國泰-館前,0,6,6,-1,6.12
"20220304","1783","003600310036004b","6160",中國信託-高雄,3,0,3,1,3.06
"20220304","1783","0038003400350044","8450",康和-板橋,0,5,5,-1,5.10
"20220304","1783","0037003700390065","7790",國票-南科,3,0,3,1,3.06
"20220304","1783","5265","5260",美好-苗栗,0,4,4,-1,4.08
"20220304","1783","9134","9100",群益金鼎-開元,3,0,3,1,3.06
"20220304","1783","1480","1480",美商高盛,0,3,3,-1,3.06
"20220304","1783","9319","9300",華南永昌-鶯歌,3,0,3,1,3.06
"20220304","1783","1041","1040",臺銀-鳳山,0,3,3,-1,3.06
"20220304","1783","0039003800310049","9800",元大-天母,3,0,3,1,3.06
"20220304","1783","8440","8440",摩根大通,0,3,3,-1,3.06
"20220304","1783","9898","9800",元大-新莊,3,0,3,1,3.06
"20220304","1783","9816","9800",元大-新竹,0,3,3,-1,3.06
"20220304","1783","0035003900320047","5920",元富-新竹,2,0,2,1,2.04
"20220304","1783","9835","9800",元大-員林中山,0,3,3,-1,3.06
"20220304","1783","6160","6160",中國信託,2,0,2,1,2.04
"20220304","1783","1440","1440",美林,0,2,2,-1,2.04
"20220304","1783","0037003000330042","7030",致和-崇德,2,0,2,1,2.04
"20220304","1783","003900380031006e","9800",元大-旗山,0,2,2,-1,2.04
"20220304","1783","8846","8840",玉山-板橋,2,0,2,1,2.04
"20220304","1783","0039003800340043","9800",元大-新店中正,0,2,2,-1,2.04
"20220307","1783","8560","8560",新光,14,1,13,1,5.96
"20220307","1783","8440","8440",摩根大通,4,20,16,-1,7.34
"20220307","1783","5850","5850",統一,8,0,8,1,3.67
"20220307","1783","9268","9200",凱基-台北,16,30,14,-1,6.42
"20220307","1783","9255","9200",凱基-和平,6,0,6,1,2.75
"20220307","1783","1440","1440",美林,1,13,12,-1,5.50
"20220307","1783","0035003900320077","5920",元富-佳里,5,0,5,1,2.29
"20220307","1783","2180","2180",亞東,3,12,9,-1,4.13
"20220307","1783","9204","9200",凱基-台中,5,0,5,1,2.29
"20220307","1783","003900380031004b","9800",元大-林園,0,7,7,-1,3.21
"20220307","1783","0039003200300044","9200",凱基-市府,5,0,5,1,2.29
"20220307","1783","0039004100390037","9A00",永豐金-新竹,8,15,7,-1,3.21
"20220307","1783","9215","9200",凱基-高美館,5,0,5,1,2.29
"20220307","1783","0038003100350041","8150",台新-高雄,0,6,6,-1,2.75
"20220307","1783","9328","9300",華南永昌-潮州,5,0,5,1,2.29
"20220307","1783","9187","9100",群益金鼎-彰化,0,5,5,-1,2.29
"20220307","1783","1116","1110",台灣企銀-屏東,4,0,4,1,1.83
"20220307","1783","8840","8840",玉山證券,0,5,5,-1,2.29
"20220307","1783","9227","9200",凱基-城中,4,0,4,1,1.83
"20220307","1783","1590","1590",花旗環球,0,4,4,-1,1.83
"20220307","1783","0039004100300030","9A00",永豐金證券,3,0,3,1,1.38
"20220307","1783","003500380035005a","5850",統一-松江,0,4,4,-1,1.83
"20220307","1783","0031003000340041","1040",臺銀-臺中,3,0,3,1,1.38
"20220307","1783","8847","8840",玉山-台南,0,4,4,-1,1.83
"20220307","1783","1023","1020",合庫-高雄,3,0,3,1,1.38
"20220307","1783","1520","1520",瑞士信貸,0,3,3,-1,1.38
"20220307","1783","8848","8840",玉山-嘉義,3,0,3,1,1.38
"20220307","1783","0031003000340043","1040",臺銀-高雄,0,2,2,-1,0.92
"20220308","1783","0038003800340041","8840",玉山-士林,19,0,19,1,8.88
"20220308","1783","0039003800390047","9800",元大-大同,1,20,19,-1,8.88
"20220308","1783","0039003200320048","9200",凱基-復興,17,0,17,1,7.94
"20220308","1783","0039004100390042","9A00",永豐金-中和,2,16,14,-1,6.54
"20220308","1783","0039004100390032","9A00",永豐金-萬盛,10,0,10,1,4.67
"20220308","1783","1440","1440",美林,0,13,13,-1,6.07
"20220308","1783","9227","9200",凱基-城中,8,0,8,1,3.74
"20220308","1783","8440","8440",摩根大通,7,17,10,-1,4.67
"20220308","1783","0039004100390043","9A00",永豐金-員林,8,0,8,1,3.74
"20220308","1783","8846","8840",玉山-板橋,0,9,9,-1,4.21
"20220308","1783","8560","8560",新光,9,2,7,1,3.27
"20220308","1783","9208","9200",凱基-桃園,0,5,5,-1,2.34
"20220308","1783","9268","9200",凱基-台北,27,20,7,1,3.27
"20220308","1783","9856","9800",元大-花蓮,0,4,4,-1,1.87
"20220308","1783","5850","5850",統一,5,0,5,1,2.34
"20220308","1783","9867","9800",元大-北成功,0,4,4,-1,1.87
"20220308","1783","0031003000330046","1030",土銀-南港,5,0,5,1,2.34
"20220308","1783","9862","9800",元大-南京,0,3,3,-1,1.40
"20220308","1783","0035003900320077","5920",元富-佳里,5,0,5,1,2.34
"20220308","1783","1650","1650",新加坡商瑞銀,0,3,3,-1,1.40
"20220308","1783","0039003200300044","9200",凱基-市府,5,0,5,1,2.34
"20220308","1783","1480","1480",美商高盛,0,3,3,-1,1.40
"20220308","1783","9255","9200",凱基-和平,4,0,4,1,1.87
"20220308","1783","0035003900320041","5920",元富-緯城,0,3,3,-1,1.40
"20220308","1783","1520","1520",瑞士信貸,4,1,3,1,1.40
"20220308","1783","0037003700390044","7790",國票-台南,0,3,3,-1,1.40
"20220308","1783","2180","2180",亞東,10,7,3,1,1.40
"20220308","1783","0039003800300064","9800",元大-沙鹿,0,3,3,-1,1.40
"20220309","1783","0037003000300048","7000",兆豐-東門,20,3,17,1,18.89
"20220309","1783","9105","9100",群益金鼎-高盛,0,10,10,-1,11.11
"20220309","1783","2187","2180",亞東-台中,5,0,5,1,5.56
"20220309","1783","9255","9200",凱基-和平,0,4,4,-1,4.44
"20220309","1783","8440","8440",摩根大通,8,4,4,1,4.44
"20220309","1783","1440","1440",美林,5,8,3,-1,3.33
"20220309","1783","5265","5260",美好-苗栗,2,0,2,1,2.22
"20220309","1783","0035003300380042","5380",第一金-新竹,0,2,2,-1,2.22
"20220309","1783","1650","1650",新加坡商瑞銀,2,0,2,1,2.22
"20220309","1783","9215","9200",凱基-高美館,0,2,2,-1,2.22
"20220309","1783","1560","1560",港商野村,2,0,2,1,2.22
"20220309","1783","9257","9200",凱基-林口,0,2,2,-1,2.22
"20220309","1783","0039003600310043","9600",富邦-南京,2,0,2,1,2.22
"20220309","1783","9834","9800",元大-中壢,0,2,2,-1,2.22
"20220309","1783","1520","1520",瑞士信貸,1,0,1,1,1.11
"20220309","1783","1590","1590",花旗環球,0,1,1,-1,1.11
"20220309","1783","0031003200360069","1260",宏遠-光隆,1,0,1,1,1.11
"20220309","1783","1480","1480",美商高盛,1,2,1,-1,1.11
"20220309","1783","003500390032006c","5920",元富-大裕,1,0,1,1,1.11
"20220309","1783","1260","1260",宏遠證券,0,1,1,-1,1.11
"20220309","1783","8458","8450",康和-台南,1,0,1,1,1.11
"20220309","1783","1040","1040",臺銀,0,1,1,-1,1.11
"20220309","1783","8564","8560",新光-台南,1,0,1,1,1.11
"20220309","1783","5602","5600",永興-水湳,0,1,1,-1,1.11
"20220309","1783","9655","9600",富邦-板橋,1,0,1,1,1.11
"20220309","1783","5851","5850",統一-高雄,0,1,1,-1,1.11
"20220309","1783","5321","5320",高橋-龍潭,0,0,0,1,0.00
"20220309","1783","0035003900320067","5920",元富-中原,0,1,1,-1,1.11
"20220310","1783","8440","8440",摩根大通,9,0,9,1,9.38
"20220310","1783","1440","1440",美林,2,9,7,-1,7.29
"20220310","1783","0038003800380041","8880",國泰-館前,6,0,6,1,6.25
"20220310","1783","1036","1030",土銀-玉里,0,7,7,-1,7.29
"20220310","1783","0039004100390043","9A00",永豐金-員林,6,0,6,1,6.25
"20220310","1783","0039003600320056","9600",富邦-復興,1,8,7,-1,7.29
"20220310","1783","8380","8380",安泰,5,0,5,1,5.21
"20220310","1783","9328","9300",華南永昌-潮州,0,5,5,-1,5.21
"20220310","1783","2180","2180",亞東,4,0,4,1,4.17
"20220310","1783","9255","9200",凱基-和平,0,4,4,-1,4.17
"20220310","1783","9300","9300",華南永昌,4,0,4,1,4.17
"20220310","1783","9324","9300",華南永昌-岡山,0,4,4,-1,4.17
"20220310","1783","003900380039006a","9800",元大-樹林,4,0,4,1,4.17
"20220310","1783","0035003900320077","5920",元富-佳里,0,3,3,-1,3.13
"20220310","1783","6160","6160",中國信託,3,0,3,1,3.13
"20220310","1783","8885","8880",國泰-桃園,0,3,3,-1,3.13
"20220310","1783","6381","6380",光和-溪湖,3,0,3,1,3.13
"20220310","1783","0039003100300044","9100",群益金鼎-市府,0,3,3,-1,3.13
"20220310","1783","0037003000300048","7000",兆豐-東門,6,3,3,1,3.13
"20220310","1783","9215","9200",凱基-高美館,0,3,3,-1,3.13
"20220310","1783","0038003400350041","8450",康和-內湖,3,0,3,1,3.13
"20220310","1783","0038003100350041","8150",台新-高雄,0,2,2,-1,2.08
"20220310","1783","1520","1520",瑞士信貸,3,1,2,1,2.08
"20220310","1783","003900380033004b","9800",元大-學甲,0,2,2,-1,2.08
"20220310","1783","0037003000300066","7000",兆豐-鹿港,2,0,2,1,2.08
"20220310","1783","0039004100390078","9A00",永豐金-桃園,0,2,2,-1,2.08
"20220310","1783","0039003600320051","9600",富邦-北高雄,2,0,2,1,2.08
"20220310","1783","8560","8560",新光,0,2,2,-1,2.08
"20220311","1783","0039004100390032","9A00",永豐金-萬盛,10,0,10,1,11.76
"20220311","1783","9268","9200",凱基-台北,5,17,12,-1,14.12
"20220311","1783","6160","6160",中國信託,6,0,6,1,7.06
"20220311","1783","1470","1470",台灣摩根士丹利,0,9,9,-1,10.59
"20220311","1783","9215","9200",凱基-高美館,5,0,5,1,5.88
"20220311","1783","2180","2180",亞東,1,9,8,-1,9.41
"20220311","1783","9813","9800",元大-八德,5,0,5,1,5.88
"20220311","1783","8440","8440",摩根大通,0,5,5,-1,5.88
"20220311","1783","1030","1030",土銀,4,0,4,1,4.71
"20220311","1783","1440","1440",美林,0,5,5,-1,5.88
"20220311","1783","0038003800380041","8880",國泰-館前,4,0,4,1,4.71
"20220311","1783","0039003800320041","9800",元大-羅東,0,4,4,-1,4.71
"20220311","1783","0038003800340041","8840",玉山-士林,2,0,2,1,2.35
"20220311","1783","1520","1520",瑞士信貸,0,3,3,-1,3.53
"20220311","1783","9255","9200",凱基-和平,2,0,2,1,2.35
"20220311","1783","8848","8840",玉山-嘉義,0,2,2,-1,2.35
"20220311","1783","9324","9300",華南永昌-岡山,2,0,2,1,2.35
"20220311","1783","9604","9600",富邦-陽明,0,2,2,-1,2.35
"20220311","1783","1260","1260",宏遠證券,1,0,1,1,1.18
"20220311","1783","003500330038004e","5380",第一金-豐原,0,1,1,-1,1.18
"20220311","1783","1040","1040",臺銀,1,0,1,1,1.18
"20220311","1783","003500320036004b","5260",美好-富順,0,1,1,-1,1.18
"20220311","1783","0035003800350044","5850",統一-新台中,2,1,1,1,1.18
"20220311","1783","6381","6380",光和-溪湖,0,1,1,-1,1.18
"20220311","1783","5851","5850",統一-高雄,1,0,1,1,1.18
"20220311","1783","8888","8880",國泰-敦南,0,1,1,-1,1.18
"20220311","1783","9131","9100",群益金鼎-民權,1,0,1,1,1.18
"20220311","1783","9105","9100",群益金鼎-高盛,0,1,1,-1,1.18
"20220314","1783","9667","9600",富邦-台南,8,0,8,1,6.56
"20220314","1783","1470","1470",台灣摩根士丹利,0,18,18,-1,14.75
"20220314","1783","6160","6160",中國信託,6,0,6,1,4.92
"20220314","1783","8440","8440",摩根大通,0,9,9,-1,7.38
"20220314","1783","0039004100390037","9A00",永豐金-新竹,6,0,6,1,4.92
"20220314","1783","0038003800380041","8880",國泰-館前,0,9,9,-1,7.38
"20220314","1783","0031003000330046","1030",土銀-南港,5,0,5,1,4.10
"20220314","1783","0035003800350042","5850",統一-永和,0,5,5,-1,4.10
"20220314","1783","8560","8560",新光,5,0,5,1,4.10
"20220314","1783","0037003000300048","7000",兆豐-東門,0,4,4,-1,3.28
"20220314","1783","9268","9200",凱基-台北,11,6,5,1,4.10
"20220314","1783","9386","9300",華南永昌-東昇,0,4,4,-1,3.28
"20220314","1783","9319","9300",華南永昌-鶯歌,5,0,5,1,4.10
"20220314","1783","1440","1440",美林,1,4,3,-1,2.46
"20220314","1783","003900380039006a","9800",元大-樹林,5,0,5,1,4.10
"20220314","1783","0038003800340048","8840",玉山-新竹,0,3,3,-1,2.46
"20220314","1783","0039003800390043","9800",元大-板橋,4,0,4,1,3.28
"20220314","1783","2180","2180",亞東,0,2,2,-1,1.64
"20220314","1783","8882","8880",國泰-台中,3,0,3,1,2.46
"20220314","1783","1650","1650",新加坡商瑞銀,0,2,2,-1,1.64
"20220314","1783","9676","9600",富邦-仁愛,3,0,3,1,2.46
"20220314","1783","0035003800350057","5850",統一-金門,0,2,2,-1,1.64
"20220314","1783","9813","9800",元大-八德,3,0,3,1,2.46
"20220314","1783","6381","6380",光和-溪湖,0,2,2,-1,1.64
"20220314","1783","0039003800310046","9800",元大-福營,3,0,3,1,2.46
"20220314","1783","0039003600320051","9600",富邦-北高雄,0,2,2,-1,1.64
"20220314","1783","8888","8880",國泰-敦南,2,0,2,1,1.64
"20220314","1783","0031003200360069","1260",宏遠-光隆,0,1,1,-1,0.82
"20220315","1783","0039003800320043","9800",元大-六合,19,0,19,1,11.05
"20220315","1783","1470","1470",台灣摩根士丹利,0,19,19,-1,11.05
"20220315","1783","003800380034004a","8840",玉山-大里,11,0,11,1,6.40
"20220315","1783","9268","9200",凱基-台北,5,20,15,-1,8.72
"20220315","1783","7006","7000",兆豐-台南,10,0,10,1,5.81
"20220315","1783","0039003800320041","9800",元大-羅東,0,12,12,-1,6.98
"20220315","1783","9306","9300",華南永昌-台南,10,0,10,1,5.81
"20220315","1783","6380","6380",光和,0,10,10,-1,5.81
"20220315","1783","9227","9200",凱基-城中,8,0,8,1,4.65
"20220315","1783","003700300030005a","7000",兆豐-高雄,0,10,10,-1,5.81
"20220315","1783","9255","9200",凱基-和平,7,0,7,1,4.07
"20220315","1783","0037003000300048","7000",兆豐-東門,0,6,6,-1,3.49
"20220315","1783","8560","8560",新光,10,4,6,1,3.49
"20220315","1783","9654","9600",富邦-永和,0,5,5,-1,2.91
"20220315","1783","0039003200320048","9200",凱基-復興,3,0,3,1,1.74
"20220315","1783","6165","6160",中國信託-新竹,1,5,4,-1,2.33
"20220315","1783","0039004100390037","9A00",永豐金-新竹,3,0,3,1,1.74
"20220315","1783","8440","8440",摩根大通,0,4,4,-1,2.33
"20220315","1783","0039004100390066","9A00",永豐金-中盛,3,0,3,1,1.74
"20220315","1783","9238","9200",凱基-士林,0,4,4,-1,2.33
"20220315","1783","6160","6160",中國信託,2,0,2,1,1.16
"20220315","1783","1440","1440",美林,1,4,3,-1,1.74
"20220315","1783","5603","5600",永興-台中,2,0,2,1,1.16
"20220315","1783","1650","1650",新加坡商瑞銀,0,3,3,-1,1.74
"20220315","1783","0037003700390065","7790",國票-南科,2,0,2,1,1.16
"20220315","1783","9647","9600",富邦-新竹,0,3,3,-1,1.74
"20220315","1783","8458","8450",康和-台南,2,0,2,1,1.16
"20220315","1783","9676","9600",富邦-仁愛,0,3,3,-1,1.74
"20220214","1783","0037003000300066","7000",兆豐-鹿港,30,0,30,1,14.56
"20220214","1783","1470","1470",台灣摩根士丹利,0,15,15,-1,7.28
"20220214","1783","6110","6110",台中銀,10,0,10,1,4.85
"20220214","1783","9268","9200",凱基-台北,9,24,15,-1,7.28
"20220214","1783","5922","5920",元富-新店,5,0,5,1,2.43
"20220214","1783","8440","8440",摩根大通,0,13,13,-1,6.31
"20220214","1783","0038003800340041","8840",玉山-士林,5,0,5,1,2.43
"20220214","1783","0039004100390061","9A00",永豐金-苓雅,1,12,11,-1,5.34
"20220214","1783","9105","9100",群益金鼎-高盛,5,0,5,1,2.43
"20220214","1783","0035003900320050","5920",元富-同大,0,8,8,-1,3.88
"20220214","1783","9255","9200",凱基-和平,5,0,5,1,2.43
"20220214","1783","9686","9600",富邦-宜蘭,0,8,8,-1,3.88
"20220214","1783","9322","9300",華南永昌-公誠,5,0,5,1,2.43
"20220214","1783","0037003700390065","7790",國票-南科,0,6,6,-1,2.91
"20220214","1783","9215","9200",凱基-高美館,4,0,4,1,1.94
"20220214","1783","9229","9200",凱基-中山,0,6,6,-1,2.91
"20220214","1783","0035003900320062","5920",元富-板橋,3,0,3,1,1.46
"20220214","1783","1480","1480",美商高盛,0,5,5,-1,2.43
"20220214","1783","7750","7750",北城證券,3,0,3,1,1.46
"20220214","1783","8847","8840",玉山-台南,0,5,5,-1,2.43
"20220214","1783","0039003800310069","9800",元大-西螺,3,0,3,1,1.46
"20220214","1783","0039003800320041","9800",元大-羅東,0,5,5,-1,2.43
"20220214","1783","0039003800390043","9800",元大-板橋,3,0,3,1,1.46
"20220214","1783","9868","9800",元大-文心,0,5,5,-1,2.43
"20220214","1783","0035003800350044","5850",統一-新台中,3,1,2,1,0.97
"20220214","1783","9331","9300",華南永昌-鳳山,0,4,4,-1,1.94
"20220214","1783","0031003000340041","1040",臺銀-臺中,2,0,2,1,0.97
"20220214","1783","003500330038004e","5380",第一金-豐原,0,2,2,-1,0.97
"20220215","1783","9268","9200",凱基-台北,35,5,30,1,14.85
"20220215","1783","1470","1470",台灣摩根士丹利,0,16,16,-1,7.92
"20220215","1783","0035003300380043","5380",第一金-光復,15,0,15,1,7.43
"20220215","1783","9813","9800",元大-八德,0,16,16,-1,7.92
"20220215","1783","1440","1440",美林,10,0,10,1,4.95
"20220215","1783","9862","9800",元大-南京,0,13,13,-1,6.44
"20220215","1783","6915","6910",德信-和平,10,0,10,1,4.95
"20220215","1783","8848","8840",玉山-嘉義,0,10,10,-1,4.95
"20220215","1783","0039003800320041","9800",元大-羅東,8,0,8,1,3.96
"20220215","1783","003900380039004a","9800",元大-彰化民生,0,10,10,-1,4.95
"20220215","1783","8440","8440",摩根大通,8,1,7,1,3.47
"20220215","1783","0031003000340043","1040",臺銀-高雄,0,8,8,-1,3.96
"20220215","1783","003900380031004b","9800",元大-林園,7,0,7,1,3.47
"20220215","1783","0035003300380050","5380",第一金-路竹,0,5,5,-1,2.48
"20220215","1783","8888","8880",國泰-敦南,5,0,5,1,2.48
"20220215","1783","7750","7750",北城證券,0,3,3,-1,1.49
"20220215","1783","9255","9200",凱基-和平,6,2,4,1,1.98
"20220215","1783","9134","9100",群益金鼎-開元,0,3,3,-1,1.49
"20220215","1783","8882","8880",國泰-台中,3,0,3,1,1.49
"20220215","1783","0039003800310056","9800",元大-民雄,0,3,3,-1,1.49
"20220215","1783","0039003200320048","9200",凱基-復興,3,0,3,1,1.49
"20220215","1783","0039003800390051","9800",元大-汐止,0,3,3,-1,1.49
"20220215","1783","0039003800390043","9800",元大-板橋,3,0,3,1,1.49
"20220215","1783","1520","1520",瑞士信貸,0,2,2,-1,0.99
"20220215","1783","9303","9300",華南永昌-高雄,2,0,2,1,0.99
"20220215","1783","0035003800350044","5850",統一-新台中,0,2,2,-1,0.99
"20220215","1783","9347","9300",華南永昌-敦南,2,0,2,1,0.99
"20220215","1783","2180","2180",亞東,0,2,2,-1,0.99
"20220216","1783","0039003800390045","9800",元大-草屯,20,1,19,1,9.60
"20220216","1783","1470","1470",台灣摩根士丹利,2,18,16,-1,8.08
"20220216","1783","9268","9200",凱基-台北,19,3,16,1,8.08
"20220216","1783","0035003900320041","5920",元富-緯城,0,15,15,-1,7.58
"20220216","1783","9302","9300",華南永昌-台中,10,0,10,1,5.05
"20220216","1783","9227","9200",凱基-城中,0,10,10,-1,5.05
"20220216","1783","1440","1440",美林,11,2,9,1,4.55
"20220216","1783","003900380039004a","9800",元大-彰化民生,0,8,8,-1,4.04
"20220216","1783","5858","5850",統一-嘉義,6,0,6,1,3.03
"20220216","1783","0039003600320043","9600",富邦-東門,0,4,4,-1,2.02
"20220216","1783","1520","1520",瑞士信貸,4,0,4,1,2.02
"20220216","1783","0039003200300044","9200",凱基-市府,0,3,3,-1,1.52
"20220216","1783","0039004100390057","9A00",永豐金-市政,7,3,4,1,2.02
"20220216","1783","0031003000340043","1040",臺銀-高雄,0,2,2,-1,1.01
"20220216","1783","0039004100390058","9A00",永豐金-竹科,3,0,3,1,1.52
"20220216","1783","6452","6450",永全-八德,0,2,2,-1,1.01
"20220216","1783","5850","5850",統一,2,0,2,1,1.01
"20220216","1783","003900380039006a","9800",元大-樹林,0,2,2,-1,1.01
"20220216","1783","8711","8710",陽信-石牌,2,0,2,1,1.01
"20220216","1783","0035003900320062","5920",元富-板橋,1,2,1,-1,0.51
"20220216","1783","8847","8840",玉山-台南,2,0,2,1,1.01
"20220216","1783","5058","5050",大展-台南,0,1,1,-1,0.51
"20220216","1783","9255","9200",凱基-和平,2,0,2,1,1.01
"20220216","1783","1650","1650",新加坡商瑞銀,0,1,1,-1,0.51
"20220216","1783","003900380030004b","9800",元大-竹科,2,0,2,1,1.01
"20220216","1783","6161","6160",中國信託-三重,0,1,1,-1,0.51
"20220216","1783","9873","9800",元大-西門,2,0,2,1,1.01
"20220216","1783","7006","7000",兆豐-台南,0,1,1,-1,0.51
"20220217","1783","003900380033004b","9800",元大-學甲,9,0,9,1,8.91
"20220217","1783","8847","8840",玉山-台南,0,7,7,-1,6.93
"20220217","1783","0036003000310064","6010",(牛牛牛)亞-鑫豐,6,0,6,1,5.94
"20220217","1783","1470","1470",台灣摩根士丹利,0,6,6,-1,5.94
"20220217","1783","1023","1020",合庫-高雄,5,0,5,1,4.95
"20220217","1783","1560","1560",港商野村,0,5,5,-1,4.95
"20220217","1783","8440","8440",摩根大通,11,6,5,1,4.95
"20220217","1783","9227","9200",凱基-城中,0,5,5,-1,4.95
"20220217","1783","9898","9800",元大-新莊,3,0,3,1,2.97
"20220217","1783","1650","1650",新加坡商瑞銀,0,4,4,-1,3.96
"20220217","1783","8560","8560",新光,2,0,2,1,1.98
"20220217","1783","9856","9800",元大-花蓮,0,4,4,-1,3.96
"20220217","1783","8888","8880",國泰-敦南,2,0,2,1,1.98
"20220217","1783","0039004100390057","9A00",永豐金-市政,0,4,4,-1,3.96
"20220217","1783","6381","6380",光和-溪湖,2,0,2,1,1.98
"20220217","1783","0039003200300044","9200",凱基-市府,0,2,2,-1,1.98
"20220217","1783","0031003100310045","1110",台灣企銀-桃園,2,0,2,1,1.98
"20220217","1783","9636","9600",富邦-中壢,0,2,2,-1,1.98
"20220217","1783","8565","8560",新光-桃園,2,0,2,1,1.98
"20220217","1783","9892","9800",元大-屏東,0,2,2,-1,1.98
"20220217","1783","9255","9200",凱基-和平,2,0,2,1,1.98
"20220217","1783","0039003800390067","9800",元大-嘉義,0,2,2,-1,1.98
"20220217","1783","0039003800390043","9800",元大-板橋,2,0,2,1,1.98
"20220217","1783","0039004100390052","9A00",永豐金-信義,0,2,2,-1,1.98
"20220217","1783","0039004100390042","9A00",永豐金-中和,2,0,2,1,1.98
"20220217","1783","5602","5600",永興-水湳,0,1,1,-1,0.99
"20220217","1783","003700370039006a","7790",國票-和平,1,0,1,1,0.99
"20220217","1783","0035003900320067","5920",元富-中原,0,1,1,-1,0.99
"20220218","1783","9268","9200",凱基-台北,10,2,8,1,11.11
"20220218","1783","003900380039004a","9800",元大-彰化民生,0,10,10,-1,13.89
"20220218","1783","8440","8440",摩根大通,9,2,7,1,9.72
"20220218","1783","1470","1470",台灣摩根士丹利,0,9,9,-1,12.50
"20220218","1783","9105","9100",群益金鼎-高盛,5,0,5,1,6.94
"20220218","1783","9692","9600",富邦-嘉義,0,6,6,-1,8.33
"20220218","1783","0039003800390043","9800",元大-板橋,5,0,5,1,6.94
"20220218","1783","9816","9800",元大-新竹,0,6,6,-1,8.33
"20220218","1783","8888","8880",國泰-敦南,3,0,3,1,4.17
"20220218","1783","9672","9600",富邦-員林,0,5,5,-1,6.94
"20220218","1783","0035003800350046","5850",統一-彰化,3,0,3,1,4.17
"20220218","1783","1440","1440",美林,0,4,4,-1,5.56
"20220218","1783","5858","5850",統一-嘉義,3,0,3,1,4.17
"20220218","1783","8157","8150",台新-左楠,0,4,4,-1,5.56
"20220218","1783","9303","9300",華南永昌-高雄,3,0,3,1,4.17
"20220218","1783","9237","9200",凱基-敦北,0,3,3,-1,4.17
"20220218","1783","9856","9800",元大-花蓮,3,0,3,1,4.17
"20220218","1783","8884","8880",國泰-台南,0,2,2,-1,2.78
"20220218","1783","1480","1480",美商高盛,2,0,2,1,2.78
"20220218","1783","0035003800350048","5850",統一-桃園,0,1,1,-1,1.39
"20220218","1783","9343","9300",華南永昌-頭份,2,0,2,1,2.78
"20220218","1783","1560","1560",港商野村,0,1,1,-1,1.39
"20220218","1783","0039003800390064","9800",元大-北屯,2,0,2,1,2.78
"20220218","1783","8883","8880",國泰-松江,0,1,1,-1,1.39
"20220218","1783","0035003300380050","5380",第一金-路竹,1,0,1,1,1.39
"20220218","1783","0039003100380078","9100",群益金鼎-延平,0,1,1,-1,1.39
"20220218","1783","0035003300380042","5380",第一金-新竹,1,0,1,1,1.39
"20220218","1783","0039003800320041","9800",元大-羅東,0,1,1,-1,1.39
"20220221","1783","0039004100390032","9A00",永豐金-萬盛,20,0,20,1,11.90
"20220221","1783","0039004100390043","9A00",永豐金-員林,0,30,30,-1,17.86
"20220221","1783","9867","9800",元大-北成功,15,0,15,1,8.93
"20220221","1783","1470","1470",台灣摩根士丹利,0,23,23,-1,13.69
"20220221","1783","1560","1560",港商野村,12,0,12,1,7.14
"20220221","1783","9857","9800",元大-東蘆,0,10,10,-1,5.95
"20220221","1783","1520","1520",瑞士信貸,11,0,11,1,6.55
"20220221","1783","0039004100390050","9A00",永豐金-竹北,0,8,8,-1,4.76
"20220221","1783","9268","9200",凱基-台北,16,7,9,1,5.36
"20220221","1783","9134","9100",群益金鼎-開元,0,5,5,-1,2.98
"20220221","1783","8847","8840",玉山-台南,7,0,7,1,4.17
"20220221","1783","0035003800350046","5850",統一-彰化,0,3,3,-1,1.79
"20220221","1783","9302","9300",華南永昌-台中,5,0,5,1,2.98
"20220221","1783","0035003900320062","5920",元富-板橋,0,3,3,-1,1.79
"20220221","1783","9204","9200",凱基-台中,5,0,5,1,2.98
"20220221","1783","6165","6160",中國信託-新竹,2,5,3,-1,1.79
"20220221","1783","9266","9200",凱基-新豐,5,0,5,1,2.98
"20220221","1783","003900310038004d","9100",群益金鼎-嘉義,0,3,3,-1,1.79
"20220221","1783","003900360031005a","9600",富邦-永康,5,0,5,1,2.98
"20220221","1783","9816","9800",元大-新竹,0,3,3,-1,1.79
"20220221","1783","5381","5380",第一金-員林,4,0,4,1,2.38
"20220221","1783","0039003800390059","9800",元大-基隆,0,3,3,-1,1.79
"20220221","1783","1480","1480",美商高盛,3,0,3,1,1.79
"20220221","1783","5850","5850",統一,0,2,2,-1,1.19
"20220221","1783","1043","1040",臺銀-民權,3,0,3,1,1.79
"20220221","1783","0038003800340045","8840",玉山-城中,0,2,2,-1,1.19
"20220221","1783","9862","9800",元大-南京,3,0,3,1,1.79
"20220221","1783","003900310038004b","9100",群益金鼎-東湖,0,2,2,-1,1.19
"20220222","1783","9867","9800",元大-北成功,20,0,20,1,6.15
"20220222","1783","9268","9200",凱基-台北,13,58,45,-1,13.85
"20220222","1783","5850","5850",統一,14,0,14,1,4.31
"20220222","1783","1470","1470",台灣摩根士丹利,0,33,33,-1,10.15
"20220222","1783","9255","9200",凱基-和平,11,0,11,1,3.38
"20220222","1783","8440","8440",摩根大通,10,31,21,-1,6.46
"20220222","1783","1043","1040",臺銀-民權,10,0,10,1,3.08
"20220222","1783","1520","1520",瑞士信貸,0,15,15,-1,4.62
"20220222","1783","0039004100390032","9A00",永豐金-萬盛,20,10,10,1,3.08
"20220222","1783","1440","1440",美林,0,13,13,-1,4.00
"20220222","1783","0039003600320056","9600",富邦-復興,7,0,7,1,2.15
"20220222","1783","1040","1040",臺銀,0,12,12,-1,3.69
"20220222","1783","1021","1020",合庫-台中,5,0,5,1,1.54
"20220222","1783","0039004100380046","9A00",永豐金-敦南,0,11,11,-1,3.38
"20220222","1783","5858","5850",統一-嘉義,5,0,5,1,1.54
"20220222","1783","1560","1560",港商野村,0,10,10,-1,3.08
"20220222","1783","0037003000300066","7000",兆豐-鹿港,5,0,5,1,1.54
"20220222","1783","003900360031005a","9600",富邦-永康,0,5,5,-1,1.54
"20220222","1783","9862","9800",元大-南京,10,5,5,1,1.54
"20220222","1783","0036003300380044","6380",光和-高雄,0,4,4,-1,1.23
"20220222","1783","1023","1020",合庫-高雄,4,0,4,1,1.23
"20220222","1783","9873","9800",元大-西門,0,4,4,-1,1.23
"20220222","1783","7750","7750",北城證券,4,0,4,1,1.23
"20220222","1783","9667","9600",富邦-台南,0,4,4,-1,1.23
"20220222","1783","9676","9600",富邦-仁愛,4,0,4,1,1.23
"20220222","1783","1480","1480",美商高盛,0,3,3,-1,0.92
"20220222","1783","5389","5380",第一金-中山,3,0,3,1,0.92
"20220222","1783","0031003000320041","1020",合庫-新竹,0,3,3,-1,0.92
"20220223","1783","9209","9200",凱基-岡山,11,0,11,1,7.91
"20220223","1783","003900380039004a","9800",元大-彰化民生,0,9,9,-1,6.47
"20220223","1783","1043","1040",臺銀-民權,7,0,7,1,5.04
"20220223","1783","9268","9200",凱基-台北,3,9,6,-1,4.32
"20220223","1783","0038003800380041","8880",國泰-館前,5,0,5,1,3.60
"20220223","1783","0039004100360039","9A00",永豐金-屏東,0,4,4,-1,2.88
"20220223","1783","1030","1030",土銀,4,0,4,1,2.88
"20220223","1783","003700300030004b","7000",兆豐-新營,0,3,3,-1,2.16
"20220223","1783","0039003600310053","9600",富邦-景美,4,0,4,1,2.88
"20220223","1783","1560","1560",港商野村,0,2,2,-1,1.44
"20220223","1783","2180","2180",亞東,4,1,3,1,2.16
"20220223","1783","6465","6460",大昌-桃園,0,2,2,-1,1.44
"20220223","1783","7005","7000",兆豐-台中港,3,0,3,1,2.16
"20220223","1783","0039003600320043","9600",富邦-東門,0,2,2,-1,1.44
"20220223","1783","8150","8150",台新證券,3,0,3,1,2.16
"20220223","1783","0039004100390051","9A00",永豐金-豐原,0,2,2,-1,1.44
"20220223","1783","8882","8880",國泰-台中,3,0,3,1,2.16
"20220223","1783","8885","8880",國泰-桃園,0,2,2,-1,1.44
"20220223","1783","5384","5380",第一金-台南,2,0,2,1,1.44
"20220223","1783","1021","1020",合庫-台中,0,1,1,-1,0.72
"20220223","1783","6381","6380",光和-溪湖,2,0,2,1,1.44
"20220223","1783","5602","5600",永興-水湳,0,1,1,-1,0.72
"20220223","1783","7034","7030",致和-金華,2,0,2,1,1.44
"20220223","1783","0035003300380050","5380",第一金-路竹,0,1,1,-1,0.72
"20220223","1783","9255","9200",凱基-和平,2,0,2,1,1.44
"20220223","1783","1590","1590",花旗環球,0,1,1,-1,0.72
"20220223","1783","0039003600310048","9600",富邦-新板,2,0,2,1,1.44
"20220223","1783","1022","1020",合庫-台南,0,1,1,-1,0.72
"20220224","1783","8881","8880",國泰-高雄,20,0,20,1,8.13
"20220224","1783","9268","9200",凱基-台北,4,27,23,-1,9.35
"20220224","1783","5850","5850",統一,12,0,12,1,4.88
"20220224","1783","0035003300380050","5380",第一金-路竹,0,12,12,-1,4.88
"20220224","1783","5858","5850",統一-嘉義,10,0,10,1,4.07
"20220224","1783","003900380039004a","9800",元大-彰化民生,0,12,12,-1,4.88
"20220224","1783","9227","9200",凱基-城中,8,0,8,1,3.25
"20220224","1783","0039004100360039","9A00",永豐金-屏東,0,11,11,-1,4.47
"20220224","1783","9204","9200",凱基-台中,6,0,6,1,2.44
"20220224","1783","5058","5050",大展-台南,0,10,10,-1,4.07
"20220224","1783","9352","9300",華南永昌-桃園,6,0,6,1,2.44
"20220224","1783","003700300030004b","7000",兆豐-新營,0,10,10,-1,4.07
"20220224","1783","9302","9300",華南永昌-台中,5,0,5,1,2.03
"20220224","1783","1470","1470",台灣摩根士丹利,2,10,8,-1,3.25
"20220224","1783","9300","9300",華南永昌,4,0,4,1,1.63
"20220224","1783","0038003800380041","8880",國泰-館前,0,7,7,-1,2.85
"20220224","1783","0039003200320048","9200",凱基-復興,4,0,4,1,1.63
"20220224","1783","1440","1440",美林,2,8,6,-1,2.44
"20220224","1783","9255","9200",凱基-和平,4,0,4,1,1.63
"20220224","1783","9896","9800",元大-台南,0,6,6,-1,2.44
"20220224","1783","8560","8560",新光,6,2,4,1,1.63
"20220224","1783","0039003800300044","9800",元大-北府,0,5,5,-1,2.03
"20220224","1783","8888","8880",國泰-敦南,4,1,3,1,1.22
"20220224","1783","0039003800320042","9800",元大-博愛,0,5,5,-1,2.03
"20220224","1783","1023","1020",合庫-高雄,3,0,3,1,1.22
"20220224","1783","9331","9300",華南永昌-鳳山,0,4,4,-1,1.63
"20220224","1783","0035003300380059","5380",第一金-中壢,3,0,3,1,1.22
"20220224","1783","2180","2180",亞東,0,3,3,-1,1.22
"20220225","1783","9268","9200",凱基-台北,17,8,9,1,7.56
"20220225","1783","1470","1470",台灣摩根士丹利,0,7,7,-1,5.88
"20220225","1783","0038003800380041","8880",國泰-館前,4,0,4,1,3.36
"20220225","1783","0039003800390047","9800",元大-大同,0,6,6,-1,5.04
"20220225","1783","2180","2180",亞東,9,6,3,1,2.52
"20220225","1783","9227","9200",凱基-城中,0,5,5,-1,4.20
"20220225","1783","8440","8440",摩根大通,18,15,3,1,2.52
"20220225","1783","1480","1480",美商高盛,0,3,3,-1,2.52
"20220225","1783","0035003900320050","5920",元富-同大,2,0,2,1,1.68
"20220225","1783","1440","1440",美林,1,4,3,-1,2.52
"20220225","1783","6165","6160",中國信託-新竹,2,0,2,1,1.68
"20220225","1783","9697","9600",富邦-虎尾,0,3,3,-1,2.52
"20220225","1783","1560","1560",港商野村,1,0,1,1,0.84
"20220225","1783","0039003800310046","9800",元大-福營,0,3,3,-1,2.52
"20220225","1783","0035003800350048","5850",統一-桃園,1,0,1,1,0.84
"20220225","1783","9835","9800",元大-員林中山,0,3,3,-1,2.52
"20220225","1783","0037003000300073","7000",兆豐-岡山,1,0,1,1,0.84
"20220225","1783","0039004100390058","9A00",永豐金-竹科,0,3,3,-1,2.52
"20220225","1783","8150","8150",台新證券,4,3,1,1,0.84
"20220225","1783","6381","6380",光和-溪湖,0,2,2,-1,1.68
"20220225","1783","0038003100350042","8150",台新-台中,1,0,1,1,0.84
"20220225","1783","6460","6460",大昌,0,2,2,-1,1.68
"20220225","1783","8560","8560",新光,2,1,1,1,0.84
"20220225","1783","8152","8150",台新-新莊,0,2,2,-1,1.68
"20220225","1783","8847","8840",玉山-台南,1,0,1,1,0.84
"20220225","1783","9255","9200",凱基-和平,0,2,2,-1,1.68
"20220225","1783","8848","8840",玉山-嘉義,1,0,1,1,0.84
"20220225","1783","9623","9600",富邦-台北,0,2,2,-1,1.68
"20220207","1783","0039004100390043","9A00",永豐金-員林,25,0,25,1,9.51
"20220207","1783","1440","1440",美林,5,38,33,-1,12.55
"20220207","1783","0035003300380043","5380",第一金-光復,23,0,23,1,8.75
"20220207","1783","0035003800350055","5850",統一-南京,0,29,29,-1,11.03
"20220207","1783","9255","9200",凱基-和平,16,2,14,1,5.32
"20220207","1783","1470","1470",台灣摩根士丹利,2,17,15,-1,5.70
"20220207","1783","8882","8880",國泰-台中,13,1,12,1,4.56
"20220207","1783","0039004100390032","9A00",永豐金-萬盛,6,19,13,-1,4.94
"20220207","1783","0039003100380069","9100",群益金鼎-竹南,11,0,11,1,4.18
"20220207","1783","8440","8440",摩根大通,8,17,9,-1,3.42
"20220207","1783","0031003000340041","1040",臺銀-臺中,10,0,10,1,3.80
"20220207","1783","9363","9300",華南永昌-彰化,0,9,9,-1,3.42
"20220207","1783","5858","5850",統一-嘉義,9,0,9,1,3.42
"20220207","1783","1480","1480",美商高盛,0,7,7,-1,2.66
"20220207","1783","9302","9300",華南永昌-台中,8,0,8,1,3.04
"20220207","1783","6165","6160",中國信託-新竹,0,6,6,-1,2.28
"20220207","1783","0038003800340041","8840",玉山-士林,5,0,5,1,1.90
"20220207","1783","1560","1560",港商野村,0,5,5,-1,1.90
"20220207","1783","0039003800390043","9800",元大-板橋,5,0,5,1,1.90
"20220207","1783","9208","9200",凱基-桃園,0,5,5,-1,1.90
"20220207","1783","9322","9300",華南永昌-公誠,3,0,3,1,1.14
"20220207","1783","9859","9800",元大-新竹經國,0,5,5,-1,1.90
"20220207","1783","9303","9300",華南永昌-高雄,2,0,2,1,0.76
"20220207","1783","1520","1520",瑞士信貸,1,5,4,-1,1.52
"20220207","1783","003800380034004a","8840",玉山-大里,2,0,2,1,0.76
"20220207","1783","0039003600320055","9600",富邦-縣政,0,4,4,-1,1.52
"20220207","1783","0039003600310043","9600",富邦-南京,2,0,2,1,0.76
"20220207","1783","9834","9800",元大-中壢,0,4,4,-1,1.52
"20220208","1783","003700370039006d","7790",國票-中港,30,0,30,1,7.98
"20220208","1783","0035003800350055","5850",統一-南京,0,52,52,-1,13.83
"20220208","1783","9812","9800",元大-台中,30,0,30,1,7.98
"20220208","1783","1470","1470",台灣摩根士丹利,0,22,22,-1,5.85
"20220208","1783","5850","5850",統一,22,0,22,1,5.85
"20220208","1783","1440","1440",美林,1,13,12,-1,3.19
"20220208","1783","0035003300380043","5380",第一金-光復,19,0,19,1,5.05
"20220208","1783","1520","1520",瑞士信貸,0,11,11,-1,2.93
"20220208","1783","9268","9200",凱基-台北,43,25,18,1,4.79
"20220208","1783","9686","9600",富邦-宜蘭,0,10,10,-1,2.66
"20220208","1783","8440","8440",摩根大通,21,9,12,1,3.19
"20220208","1783","0035003900320076","5920",元富-桃園,0,6,6,-1,1.60
"20220208","1783","9204","9200",凱基-台中,12,0,12,1,3.19
"20220208","1783","9206","9200",凱基-高雄,0,5,5,-1,1.33
"20220208","1783","8847","8840",玉山-台南,11,0,11,1,2.93
"20220208","1783","9322","9300",華南永昌-公誠,0,5,5,-1,1.33
"20220208","1783","1560","1560",港商野村,9,0,9,1,2.39
"20220208","1783","9255","9200",凱基-和平,4,8,4,-1,1.06
"20220208","1783","0039004100390043","9A00",永豐金-員林,17,9,8,1,2.13
"20220208","1783","0039003200300044","9200",凱基-市府,0,3,3,-1,0.80
"20220208","1783","0039003800390043","9800",元大-板橋,7,0,7,1,1.86
"20220208","1783","0039003800310051","9800",元大-太平,0,3,3,-1,0.80
"20220208","1783","8711","8710",陽信-石牌,6,0,6,1,1.60
"20220208","1783","0039003800310046","9800",元大-福營,0,2,2,-1,0.53
"20220208","1783","7006","7000",兆豐-台南,4,0,4,1,1.06
"20220208","1783","0039003800390047","9800",元大-大同,1,3,2,-1,0.53
"20220208","1783","0039003800320041","9800",元大-羅東,4,0,4,1,1.06
"20220208","1783","0039003800390051","9800",元大-汐止,0,2,2,-1,0.53
"20220209","1783","9268","9200",凱基-台北,29,10,19,1,8.60
"20220209","1783","1470","1470",台灣摩根士丹利,0,32,32,-1,14.48
"20220209","1783","0031003000330046","1030",土銀-南港,10,0,10,1,4.52
"20220209","1783","0039004100390032","9A00",永豐金-萬盛,2,16,14,-1,6.33
"20220209","1783","003700300030004b","7000",兆豐-新營,10,0,10,1,4.52
"20220209","1783","9215","9200",凱基-高美館,0,8,8,-1,3.62
"20220209","1783","9831","9800",元大-四維,10,0,10,1,4.52
"20220209","1783","1440","1440",美林,5,12,7,-1,3.17
"20220209","1783","0039004100390050","9A00",永豐金-竹北,8,0,8,1,3.62
"20220209","1783","0039003600320055","9600",富邦-縣政,0,6,6,-1,2.71
"20220209","1783","0035003900320044","5920",元富-大昌,7,0,7,1,3.17
"20220209","1783","5323","5320",高橋-內壢,0,5,5,-1,2.26
"20220209","1783","0037003000300044","7000",兆豐-西螺,5,0,5,1,2.26
"20220209","1783","0035003800350059","5850",統一-土城,0,5,5,-1,2.26
"20220209","1783","8459","8450",康和-嘉義,5,0,5,1,2.26
"20220209","1783","003900310038004d","9100",群益金鼎-嘉義,1,6,5,-1,2.26
"20220209","1783","9868","9800",元大-文心,5,0,5,1,2.26
"20220209","1783","9208","9200",凱基-桃園,0,5,5,-1,2.26
"20220209","1783","1480","1480",美商高盛,5,1,4,1,1.81
"20220209","1783","9862","9800",元大-南京,0,5,5,-1,2.26
"20220209","1783","8440","8440",摩根大通,12,8,4,1,1.81
"20220209","1783","0039003600320043","9600",富邦-東門,2,5,3,-1,1.36
"20220209","1783","0039003100380069","9100",群益金鼎-竹南,4,0,4,1,1.81
"20220209","1783","0039003800390051","9800",元大-汐止,0,3,3,-1,1.36
"20220209","1783","9275","9200",凱基-三多,4,0,4,1,1.81
"20220209","1783","0039003100380063","9100",群益金鼎-鳳山,0,2,2,-1,0.90
"20220209","1783","0039004100390039","9A00",永豐金-中壢,4,0,4,1,1.81
"20220209","1783","1520","1520",瑞士信貸,0,2,2,-1,0.90
"20220210","1783","0031003000330046","1030",土銀-南港,10,0,10,1,6.94
"20220210","1783","9268","9200",凱基-台北,2,20,18,-1,12.50
"20220210","1783","6165","6160",中國信託-新竹,15,5,10,1,6.94
"20220210","1783","1470","1470",台灣摩根士丹利,0,13,13,-1,9.03
"20220210","1783","9302","9300",華南永昌-台中,10,0,10,1,6.94
"20220210","1783","8440","8440",摩根大通,2,15,13,-1,9.03
"20220210","1783","8848","8840",玉山-嘉義,6,0,6,1,4.17
"20220210","1783","8888","8880",國泰-敦南,0,12,12,-1,8.33
"20220210","1783","003500320036004b","5260",美好-富順,5,0,5,1,3.47
"20220210","1783","0035003800350055","5850",統一-南京,0,10,10,-1,6.94
"20220210","1783","9105","9100",群益金鼎-高盛,5,0,5,1,3.47
"20220210","1783","0039004100300030","9A00",永豐金證券,0,6,6,-1,4.17
"20220210","1783","0039003800390043","9800",元大-板橋,5,0,5,1,3.47
"20220210","1783","8157","8150",台新-左楠,0,4,4,-1,2.78
"20220210","1783","1650","1650",新加坡商瑞銀,5,1,4,1,2.78
"20220210","1783","0037003000300069","7000",兆豐-松德,0,3,3,-1,2.08
"20220210","1783","9255","9200",凱基-和平,6,2,4,1,2.78
"20220210","1783","9686","9600",富邦-宜蘭,0,3,3,-1,2.08
"20220210","1783","0039003800310051","9800",元大-太平,4,0,4,1,2.78
"20220210","1783","9863","9800",元大-和平,0,3,3,-1,2.08
"20220210","1783","9647","9600",富邦-新竹,3,0,3,1,2.08
"20220210","1783","8885","8880",國泰-桃園,1,3,2,-1,1.39
"20220210","1783","0035003300380057","5380",第一金-華江,2,0,2,1,1.39
"20220210","1783","8846","8840",玉山-板橋,0,1,1,-1,0.69
"20220210","1783","8847","8840",玉山-台南,2,0,2,1,1.39
"20220210","1783","0035003900320076","5920",元富-桃園,0,1,1,-1,0.69
"20220210","1783","9215","9200",凱基-高美館,2,0,2,1,1.39
"20220210","1783","003700300030004a","7000",兆豐-公益,0,1,1,-1,0.69
"20220211","1783","5320","5320",高橋,10,0,10,1,4.46
"20220211","1783","1470","1470",台灣摩根士丹利,0,12,12,-1,5.36
"20220211","1783","1040","1040",臺銀,10,0,10,1,4.46
"20220211","1783","9268","9200",凱基-台北,22,33,11,-1,4.91
"20220211","1783","1650","1650",新加坡商瑞銀,12,6,6,1,2.68
"20220211","1783","5854","5850",統一-城中,0,10,10,-1,4.46
"20220211","1783","9235","9200",凱基-永華,6,0,6,1,2.68
"20220211","1783","0037003700390076","7790",國票-台中,0,10,10,-1,4.46
"20220211","1783","003700300030004b","7000",兆豐-新營,5,0,5,1,2.23
"20220211","1783","0039003800390047","9800",元大-大同,0,10,10,-1,4.46
"20220211","1783","9322","9300",華南永昌-公誠,5,0,5,1,2.23
"20220211","1783","0035003800350055","5850",統一-南京,0,9,9,-1,4.02
"20220211","1783","9692","9600",富邦-嘉義,5,0,5,1,2.23
"20220211","1783","003900380039004a","9800",元大-彰化民生,0,8,8,-1,3.57
"20220211","1783","6160","6160",中國信託,4,0,4,1,1.79
"20220211","1783","8459","8450",康和-嘉義,0,5,5,-1,2.23
"20220211","1783","9386","9300",華南永昌-東昇,4,0,4,1,1.79
"20220211","1783","003500320036004b","5260",美好-富順,2,5,3,-1,1.34
"20220211","1783","0039004100380039","9A00",永豐金-敦北,4,0,4,1,1.79
"20220211","1783","8440","8440",摩根大通,3,6,3,-1,1.34
"20220211","1783","9329","9300",華南永昌-朴子,3,0,3,1,1.34
"20220211","1783","0039003200320048","9200",凱基-復興,0,3,3,-1,1.34
"20220211","1783","0039003800300051","9800",元大-南崁,3,0,3,1,1.34
"20220211","1783","0039003600320047","9600",富邦-斗六,0,3,3,-1,1.34
"20220211","1783","9831","9800",元大-四維,3,0,3,1,1.34
"20220211","1783","0039004100300030","9A00",永豐金證券,0,3,3,-1,1.34
"20220211","1783","0031003000340043","1040",臺銀-高雄,2,0,2,1,0.89
"20220211","1783","8888","8880",國泰-敦南,0,2,2,-1,0.89
"20220117","1783","1650","1650",新加坡商瑞銀,56,10,46,1,11.11
"20220117","1783","0039003200300041","9200",凱基-板橋,0,61,61,-1,14.73
"20220117","1783","9268","9200",凱基-台北,52,13,39,1,9.42
"20220117","1783","0031003000330046","1030",土銀-南港,0,47,47,-1,11.35
"20220117","1783","1480","1480",美商高盛,27,0,27,1,6.52
"20220117","1783","9275","9200",凱基-三多,0,24,24,-1,5.80
"20220117","1783","1440","1440",美林,24,0,24,1,5.80
"20220117","1783","5854","5850",統一-城中,0,21,21,-1,5.07
"20220117","1783","1560","1560",港商野村,15,0,15,1,3.62
"20220117","1783","0035003300380057","5380",第一金-華江,0,19,19,-1,4.59
"20220117","1783","5858","5850",統一-嘉義,11,0,11,1,2.66
"20220117","1783","0039003800390047","9800",元大-大同,0,10,10,-1,2.42
"20220117","1783","1030","1030",土銀,8,0,8,1,1.93
"20220117","1783","0039003200320048","9200",凱基-復興,2,8,6,-1,1.45
"20220117","1783","0031003200360055","1260",宏遠-館前,7,0,7,1,1.69
"20220117","1783","6165","6160",中國信託-新竹,0,5,5,-1,1.21
"20220117","1783","003900320031004d","9200",凱基-八德,5,0,5,1,1.21
"20220117","1783","0039004100390032","9A00",永豐金-萬盛,10,15,5,-1,1.21
"20220117","1783","9302","9300",華南永昌-台中,5,0,5,1,1.21
"20220117","1783","9697","9600",富邦-虎尾,0,4,4,-1,0.97
"20220117","1783","0039003800390051","9800",元大-汐止,5,0,5,1,1.21
"20220117","1783","9834","9800",元大-中壢,0,4,4,-1,0.97
"20220117","1783","9278","9200",凱基-永康,4,0,4,1,0.97
"20220117","1783","1470","1470",台灣摩根士丹利,10,13,3,-1,0.72
"20220117","1783","0035003900320055","5920",元富-宜蘭,3,0,3,1,0.72
"20220117","1783","9315","9300",華南永昌-苑裡,0,3,3,-1,0.72
"20220117","1783","9266","9200",凱基-新豐,3,0,3,1,0.72
"20220117","1783","9604","9600",富邦-陽明,2,5,3,-1,0.72
"20220118","1783","0039004100390032","9A00",永豐金-萬盛,11,0,11,1,4.98
"20220118","1783","9268","9200",凱基-台北,11,33,22,-1,9.95
"20220118","1783","1114","1110",台灣企銀-嘉義,5,0,5,1,2.26
"20220118","1783","9873","9800",元大-西門,0,10,10,-1,4.52
"20220118","1783","9302","9300",華南永昌-台中,5,0,5,1,2.26
"20220118","1783","0039003800390047","9800",元大-大同,0,10,10,-1,4.52
"20220118","1783","9665","9600",富邦-桃園,5,0,5,1,2.26
"20220118","1783","1470","1470",台灣摩根士丹利,2,9,7,-1,3.17
"20220118","1783","9692","9600",富邦-嘉義,5,0,5,1,2.26
"20220118","1783","1650","1650",新加坡商瑞銀,10,15,5,-1,2.26
"20220118","1783","1440","1440",美林,14,10,4,1,1.81
"20220118","1783","9697","9600",富邦-虎尾,0,4,4,-1,1.81
"20220118","1783","9208","9200",凱基-桃園,4,0,4,1,1.81
"20220118","1783","5320","5320",高橋,0,3,3,-1,1.36
"20220118","1783","6160","6160",中國信託,3,0,3,1,1.36
"20220118","1783","0039004100370039","9A00",永豐金-埔里,0,3,3,-1,1.36
"20220118","1783","0036003300380044","6380",光和-高雄,3,0,3,1,1.36
"20220118","1783","8561","8560",新光-台中,0,2,2,-1,0.90
"20220118","1783","0039003800310055","9800",元大-華山,3,0,3,1,1.36
"20220118","1783","9623","9600",富邦-台北,0,2,2,-1,0.90
"20220118","1783","9859","9800",元大-新竹經國,3,0,3,1,1.36
"20220118","1783","9657","9600",富邦-苗栗,0,2,2,-1,0.90
"20220118","1783","8888","8880",國泰-敦南,2,0,2,1,0.90
"20220118","1783","0037003000300066","7000",兆豐-鹿港,5,6,1,-1,0.45
"20220118","1783","003500320036004b","5260",美好-富順,2,0,2,1,0.90
"20220118","1783","7797","7790",國票-中正,0,1,1,-1,0.45
"20220118","1783","1110","1110",台灣企銀,2,0,2,1,0.90
"20220118","1783","0037003700390058","7790",國票-中和,0,1,1,-1,0.45
"20220119","1783","0039004100390032","9A00",永豐金-萬盛,25,0,25,1,9.77
"20220119","1783","9268","9200",凱基-台北,1,31,30,-1,11.72
"20220119","1783","5603","5600",永興-台中,21,0,21,1,8.20
"20220119","1783","1440","1440",美林,0,21,21,-1,8.20
"20220119","1783","8888","8880",國泰-敦南,11,0,11,1,4.30
"20220119","1783","1470","1470",台灣摩根士丹利,3,21,18,-1,7.03
"20220119","1783","0035003800350044","5850",統一-新台中,11,1,10,1,3.91
"20220119","1783","0039003600320055","9600",富邦-縣政,0,12,12,-1,4.69
"20220119","1783","003500320036004b","5260",美好-富順,7,0,7,1,2.73
"20220119","1783","9859","9800",元大-新竹經國,0,12,12,-1,4.69
"20220119","1783","003500380035004a","5850",統一-三重,6,0,6,1,2.34
"20220119","1783","1650","1650",新加坡商瑞銀,0,10,10,-1,3.91
"20220119","1783","9302","9300",華南永昌-台中,6,0,6,1,2.34
"20220119","1783","0039004100390043","9A00",永豐金-員林,1,11,10,-1,3.91
"20220119","1783","5850","5850",統一,5,0,5,1,1.95
"20220119","1783","8440","8440",摩根大通,8,16,8,-1,3.13
"20220119","1783","8560","8560",新光,5,0,5,1,1.95
"20220119","1783","0035003900320062","5920",元富-板橋,0,5,5,-1,1.95
"20220119","1783","6160","6160",中國信託,5,0,5,1,1.95
"20220119","1783","9255","9200",凱基-和平,2,7,5,-1,1.95
"20220119","1783","7007","7000",兆豐-竹北,5,0,5,1,1.95
"20220119","1783","1480","1480",美商高盛,0,4,4,-1,1.56
"20220119","1783","8843","8840",玉山-高雄,5,0,5,1,1.95
"20220119","1783","0039003800310044","9800",元大-南投,0,4,4,-1,1.56
"20220119","1783","9266","9200",凱基-新豐,5,0,5,1,1.95
"20220119","1783","8152","8150",台新-新莊,0,3,3,-1,1.17
"20220119","1783","0039003800320042","9800",元大-博愛,5,0,5,1,1.95
"20220119","1783","9343","9300",華南永昌-頭份,0,3,3,-1,1.17
"20220120","1783","9268","9200",凱基-台北,15,6,9,1,6.98
"20220120","1783","0036003100360041","6160",中國信託-中壢,0,10,10,-1,7.75
"20220120","1783","0039004100390043","9A00",永豐金-員林,6,0,6,1,4.65
"20220120","1783","0039003800390047","9800",元大-大同,0,10,10,-1,7.75
"20220120","1783","6160","6160",中國信託,5,0,5,1,3.88
"20220120","1783","0035003800350055","5850",統一-南京,0,8,8,-1,6.20
"20220120","1783","0039003800300065","9800",元大-清水,5,0,5,1,3.88
"20220120","1783","1440","1440",美林,1,9,8,-1,6.20
"20220120","1783","8884","8880",國泰-台南,4,0,4,1,3.10
"20220120","1783","0039003600320055","9600",富邦-縣政,0,7,7,-1,5.43
"20220120","1783","9255","9200",凱基-和平,4,0,4,1,3.10
"20220120","1783","9331","9300",華南永昌-鳳山,0,6,6,-1,4.65
"20220120","1783","0035003800350044","5850",統一-新台中,4,1,3,1,2.33
"20220120","1783","9859","9800",元大-新竹經國,0,6,6,-1,4.65
"20220120","1783","8440","8440",摩根大通,7,4,3,1,2.33
"20220120","1783","1650","1650",新加坡商瑞銀,7,10,3,-1,2.33
"20220120","1783","8888","8880",國泰-敦南,3,0,3,1,2.33
"20220120","1783","2185","2180",亞東-台南,0,2,2,-1,1.55
"20220120","1783","0035003300380057","5380",第一金-華江,2,0,2,1,1.55
"20220120","1783","003700300030004b","7000",兆豐-新營,0,2,2,-1,1.55
"20220120","1783","8841","8840",玉山-雙和,2,0,2,1,1.55
"20220120","1783","9604","9600",富邦-陽明,0,2,2,-1,1.55
"20220120","1783","0039003100330044","9100",群益金鼎-潭子,2,0,2,1,1.55
"20220120","1783","0039003800390045","9800",元大-草屯,0,2,2,-1,1.55
"20220120","1783","9647","9600",富邦-新竹,2,0,2,1,1.55
"20220120","1783","1041","1040",臺銀-鳳山,0,1,1,-1,0.78
"20220120","1783","003900380033004b","9800",元大-學甲,2,0,2,1,1.55
"20220120","1783","1038","1030",土銀-和平,0,1,1,-1,0.78
"20220121","1783","9800","9800",元大證券,30,0,30,1,11.76
"20220121","1783","0037003700390057","7790",國票-彰化,0,15,15,-1,5.88
"20220121","1783","8440","8440",摩根大通,25,4,21,1,8.24
"20220121","1783","9268","9200",凱基-台北,25,36,11,-1,4.31
"20220121","1783","0039004100390032","9A00",永豐金-萬盛,16,0,16,1,6.27
"20220121","1783","0039003200300041","9200",凱基-板橋,0,10,10,-1,3.92
"20220121","1783","003800380038004b","8880",國泰-板橋,8,0,8,1,3.14
"20220121","1783","0039003800310044","9800",元大-南投,0,10,10,-1,3.92
"20220121","1783","7006","7000",兆豐-台南,6,0,6,1,2.35
"20220121","1783","0039003800390047","9800",元大-大同,0,10,10,-1,3.92
"20220121","1783","9255","9200",凱基-和平,4,0,4,1,1.57
"20220121","1783","003900410039004c","9A00",永豐金-台中,0,10,10,-1,3.92
"20220121","1783","5850","5850",統一,3,0,3,1,1.18
"20220121","1783","1470","1470",台灣摩根士丹利,4,12,8,-1,3.14
"20220121","1783","1650","1650",新加坡商瑞銀,12,9,3,1,1.18
"20220121","1783","0039003100330044","9100",群益金鼎-潭子,3,0,3,1,1.18
"20220121","1783","6480","6480",福邦證券,0,6,6,-1,2.35
"20220121","1783","0039003800320043","9800",元大-六合,3,0,3,1,1.18
"20220121","1783","0037003700390048","7790",國票-嘉義,0,6,6,-1,2.35
"20220121","1783","2181","2180",亞東-板橋,2,0,2,1,0.78
"20220121","1783","5265","5260",美好-苗栗,0,5,5,-1,1.96
"20220121","1783","003500390032006c","5920",元富-大裕,2,0,2,1,0.78
"20220121","1783","1440","1440",美林,4,8,4,-1,1.57
"20220121","1783","003700300030004a","7000",兆豐-公益,2,0,2,1,0.78
"20220121","1783","0035003300380057","5380",第一金-華江,0,4,4,-1,1.57
"20220121","1783","8848","8840",玉山-嘉義,2,0,2,1,0.78
"20220121","1783","6168","6160",中國信託-嘉義,0,4,4,-1,1.57
"20220124","1783","1650","1650",新加坡商瑞銀,46,3,43,1,11.26
"20220124","1783","0039003200300041","9200",凱基-板橋,0,36,36,-1,9.42
"20220124","1783","9268","9200",凱基-台北,58,28,30,1,7.85
"20220124","1783","0039004100390038","9A00",永豐金-大園,0,19,19,-1,4.97
"20220124","1783","0039004100390032","9A00",永豐金-萬盛,30,1,29,1,7.59
"20220124","1783","0039003800390051","9800",元大-汐止,3,21,18,-1,4.71
"20220124","1783","8440","8440",摩根大通,30,3,27,1,7.07
"20220124","1783","5850","5850",統一,0,17,17,-1,4.45
"20220124","1783","1520","1520",瑞士信貸,14,0,14,1,3.66
"20220124","1783","9647","9600",富邦-新竹,0,14,14,-1,3.66
"20220124","1783","0035003800350044","5850",統一-新台中,10,0,10,1,2.62
"20220124","1783","0039003200310047","9200",凱基-五股,0,12,12,-1,3.14
"20220124","1783","5603","5600",永興-台中,6,0,6,1,1.57
"20220124","1783","9833","9800",元大-敦化,0,11,11,-1,2.88
"20220124","1783","7006","7000",兆豐-台南,6,0,6,1,1.57
"20220124","1783","9859","9800",元大-新竹經國,0,11,11,-1,2.88
"20220124","1783","9278","9200",凱基-永康,6,0,6,1,1.57
"20220124","1783","0037003000300073","7000",兆豐-岡山,0,10,10,-1,2.62
"20220124","1783","6160","6160",中國信託,5,1,4,1,1.05
"20220124","1783","9604","9600",富邦-陽明,0,6,6,-1,1.57
"20220124","1783","9255","9200",凱基-和平,8,4,4,1,1.05
"20220124","1783","6165","6160",中國信託-新竹,0,5,5,-1,1.31
"20220124","1783","9134","9100",群益金鼎-開元,3,0,3,1,0.79
"20220124","1783","5857","5850",統一-新竹,0,4,4,-1,1.05
"20220124","1783","9667","9600",富邦-台南,2,0,2,1,0.52
"20220124","1783","9309","9300",華南永昌-古亭,0,4,4,-1,1.05
"20220124","1783","1570","1570",港商法國興業,2,0,2,1,0.52
"20220124","1783","0039003600320055","9600",富邦-縣政,0,4,4,-1,1.05
"20220125","1783","7006","7000",兆豐-台南,10,0,10,1,4.55
"20220125","1783","0039003800310044","9800",元大-南投,0,20,20,-1,9.09
"20220125","1783","8886","8880",國泰-新莊,10,0,10,1,4.55
"20220125","1783","9859","9800",元大-新竹經國,0,12,12,-1,5.45
"20220125","1783","0039004100390032","9A00",永豐金-萬盛,10,0,10,1,4.55
"20220125","1783","7795","7790",國票-南港,0,10,10,-1,4.55
"20220125","1783","9227","9200",凱基-城中,8,0,8,1,3.64
"20220125","1783","0039003600320055","9600",富邦-縣政,0,10,10,-1,4.55
"20220125","1783","7750","7750",北城證券,7,1,6,1,2.73
"20220125","1783","003900380033004d","9800",元大-木柵,0,9,9,-1,4.09
"20220125","1783","0035003300380043","5380",第一金-光復,5,0,5,1,2.27
"20220125","1783","9131","9100",群益金鼎-民權,2,8,6,-1,2.73
"20220125","1783","5603","5600",永興-台中,5,0,5,1,2.27
"20220125","1783","0035003300380045","5380",第一金-自由,0,5,5,-1,2.27
"20220125","1783","6160","6160",中國信託,5,0,5,1,2.27
"20220125","1783","8157","8150",台新-左楠,0,5,5,-1,2.27
"20220125","1783","003900380031004e","9800",元大-金門,5,0,5,1,2.27
"20220125","1783","9347","9300",華南永昌-敦南,0,5,5,-1,2.27
"20220125","1783","9255","9200",凱基-和平,4,0,4,1,1.82
"20220125","1783","0035003900320055","5920",元富-宜蘭,0,4,4,-1,1.82
"20220125","1783","0031003000320041","1020",合庫-新竹,3,0,3,1,1.36
"20220125","1783","003900310038004b","9100",群益金鼎-東湖,0,4,4,-1,1.82
"20220125","1783","1520","1520",瑞士信貸,4,1,3,1,1.36
"20220125","1783","1650","1650",新加坡商瑞銀,15,18,3,-1,1.36
"20220125","1783","6114","6110",台中銀-員林,3,0,3,1,1.36
"20220125","1783","1590","1590",花旗環球,0,3,3,-1,1.36
"20220125","1783","0039003800380056","9800",元大-長庚,3,0,3,1,1.36
"20220125","1783","8840","8840",玉山證券,0,3,3,-1,1.36
"20220126","1783","9268","9200",凱基-台北,52,24,28,1,8.86
"20220126","1783","0035003800350044","5850",統一-新台中,0,21,21,-1,6.65
"20220126","1783","5603","5600",永興-台中,20,0,20,1,6.33
"20220126","1783","1650","1650",新加坡商瑞銀,0,16,16,-1,5.06
"20220126","1783","5850","5850",統一,15,0,15,1,4.75
"20220126","1783","1031","1030",土銀-台中,0,15,15,-1,4.75
"20220126","1783","8440","8440",摩根大通,19,5,14,1,4.43
"20220126","1783","0031003000340043","1040",臺銀-高雄,0,10,10,-1,3.16
"20220126","1783","0035003300380043","5380",第一金-光復,13,0,13,1,4.11
"20220126","1783","8848","8840",玉山-嘉義,4,14,10,-1,3.16
"20220126","1783","1480","1480",美商高盛,11,0,11,1,3.48
"20220126","1783","7750","7750",北城證券,0,9,9,-1,2.85
"20220126","1783","9872","9800",元大-復北,8,0,8,1,2.53
"20220126","1783","9255","9200",凱基-和平,0,8,8,-1,2.53
"20220126","1783","0039004100390039","9A00",永豐金-中壢,8,0,8,1,2.53
"20220126","1783","0035003300380057","5380",第一金-華江,0,7,7,-1,2.22
"20220126","1783","1440","1440",美林,9,3,6,1,1.90
"20220126","1783","5265","5260",美好-苗栗,0,7,7,-1,2.22
"20220126","1783","1520","1520",瑞士信貸,6,0,6,1,1.90
"20220126","1783","003800380034004a","8840",玉山-大里,0,6,6,-1,1.90
"20220126","1783","0035003900320076","5920",元富-桃園,6,0,6,1,1.90
"20220126","1783","0039003100380063","9100",群益金鼎-鳳山,0,6,6,-1,1.90
"20220126","1783","1560","1560",港商野村,5,0,5,1,1.58
"20220126","1783","9215","9200",凱基-高美館,0,6,6,-1,1.90
"20220126","1783","0039004100390063","9A00",永豐金-永康,5,0,5,1,1.58
"20220126","1783","0039003800390041","9800",元大-北投,0,6,6,-1,1.90
"20220126","1783","0035003900320044","5920",元富-大昌,4,0,4,1,1.27
"20220126","1783","0035003800350059","5850",統一-土城,0,5,5,-1,1.58
"20220103","1783","9692","9600",富邦-嘉義,12,0,12,1,5.45
"20220103","1783","1470","1470",台灣摩根士丹利,7,33,26,-1,11.82
"20220103","1783","0036003000310064","6010",(牛牛牛)亞-鑫豐,11,0,11,1,5.00
"20220103","1783","8440","8440",摩根大通,0,12,12,-1,5.45
"20220103","1783","5603","5600",永興-台中,10,0,10,1,4.55
"20220103","1783","0037003000300048","7000",兆豐-東門,0,10,10,-1,4.55
"20220103","1783","0039003100380045","9100",群益金鼎-南京,10,0,10,1,4.55
"20220103","1783","9268","9200",凱基-台北,24,34,10,-1,4.55
"20220103","1783","0039003800310053","9800",元大-崇德,8,0,8,1,3.64
"20220103","1783","1520","1520",瑞士信貸,0,6,6,-1,2.73
"20220103","1783","0039003200310045","9200",凱基-三峽,6,0,6,1,2.73
"20220103","1783","8846","8840",玉山-板橋,0,6,6,-1,2.73
"20220103","1783","1028","1020",合庫-彰化,5,0,5,1,2.27
"20220103","1783","1650","1650",新加坡商瑞銀,1,6,5,-1,2.27
"20220103","1783","9302","9300",華南永昌-台中,5,0,5,1,2.27
"20220103","1783","0035003900320044","5920",元富-大昌,0,5,5,-1,2.27
"20220103","1783","6160","6160",中國信託,4,0,4,1,1.82
"20220103","1783","9835","9800",元大-員林中山,0,4,4,-1,1.82
"20220103","1783","0039003600320044","9600",富邦-新莊,4,0,4,1,1.82
"20220103","1783","0039003800390044","9800",元大-左營,0,4,4,-1,1.82
"20220103","1783","9813","9800",元大-八德,4,0,4,1,1.82
"20220103","1783","1440","1440",美林,2,5,3,-1,1.36
"20220103","1783","5389","5380",第一金-中山,3,0,3,1,1.36
"20220103","1783","6912","6910",德信-中正,0,3,3,-1,1.36
"20220103","1783","0039003800320041","9800",元大-羅東,3,0,3,1,1.36
"20220103","1783","5267","5260",美好-基隆,0,2,2,-1,0.91
"20220103","1783","0037003700390057","7790",國票-彰化,2,0,2,1,0.91
"20220103","1783","0036003300380044","6380",光和-高雄,0,2,2,-1,0.91
"20220104","1783","5850","5850",統一,15,0,15,1,6.00
"20220104","1783","0039003600310044","9600",富邦-忠孝,0,30,30,-1,12.00
"20220104","1783","003900380033006a","9800",元大-仁愛,13,0,13,1,5.20
"20220104","1783","1470","1470",台灣摩根士丹利,3,18,15,-1,6.00
"20220104","1783","8848","8840",玉山-嘉義,11,0,11,1,4.40
"20220104","1783","1041","1040",臺銀-鳳山,0,10,10,-1,4.00
"20220104","1783","9692","9600",富邦-嘉義,11,0,11,1,4.40
"20220104","1783","5854","5850",統一-城中,0,9,9,-1,3.60
"20220104","1783","6161","6160",中國信託-三重,10,0,10,1,4.00
"20220104","1783","8440","8440",摩根大通,0,9,9,-1,3.60
"20220104","1783","0039004100390043","9A00",永豐金-員林,11,1,10,1,4.00
"20220104","1783","8882","8880",國泰-台中,0,9,9,-1,3.60
"20220104","1783","1650","1650",新加坡商瑞銀,9,0,9,1,3.60
"20220104","1783","6480","6480",福邦證券,0,5,5,-1,2.00
"20220104","1783","003500320036004b","5260",美好-富順,9,2,7,1,2.80
"20220104","1783","0039003200300046","9200",凱基-站前,0,5,5,-1,2.00
"20220104","1783","1480","1480",美商高盛,8,2,6,1,2.40
"20220104","1783","0039003800390044","9800",元大-左營,0,5,5,-1,2.00
"20220104","1783","0038003100350042","8150",台新-台中,6,0,6,1,2.40
"20220104","1783","0039003100330044","9100",群益金鼎-潭子,0,4,4,-1,1.60
"20220104","1783","9676","9600",富邦-仁愛,5,0,5,1,2.00
"20220104","1783","0038003800340045","8840",玉山-城中,0,3,3,-1,1.20
"20220104","1783","9816","9800",元大-新竹,4,0,4,1,1.60
"20220104","1783","9268","9200",凱基-台北,16,19,3,-1,1.20
"20220104","1783","0035003900320062","5920",元富-板橋,3,0,3,1,1.20
"20220104","1783","1560","1560",港商野村,1,3,2,-1,0.80
"20220104","1783","003900360031004b","9600",富邦-七賢,3,0,3,1,1.20
"20220104","1783","1440","1440",美林,1,3,2,-1,0.80
"20220105","1783","0039004100390032","9A00",永豐金-萬盛,10,0,10,1,9.62
"20220105","1783","9268","9200",凱基-台北,7,17,10,-1,9.62
"20220105","1783","003900380033006a","9800",元大-仁愛,7,0,7,1,6.73
"20220105","1783","1560","1560",港商野村,0,7,7,-1,6.73
"20220105","1783","1480","1480",美商高盛,7,1,6,1,5.77
"20220105","1783","0038003100350042","8150",台新-台中,0,6,6,-1,5.77
"20220105","1783","0039003200320048","9200",凱基-復興,5,0,5,1,4.81
"20220105","1783","003500320036004b","5260",美好-富順,0,5,5,-1,4.81
"20220105","1783","9692","9600",富邦-嘉義,5,0,5,1,4.81
"20220105","1783","1440","1440",美林,0,3,3,-1,2.88
"20220105","1783","1650","1650",新加坡商瑞銀,4,0,4,1,3.85
"20220105","1783","0037003000300048","7000",兆豐-東門,0,3,3,-1,2.88
"20220105","1783","0039004100370039","9A00",永豐金-埔里,4,0,4,1,3.85
"20220105","1783","003800380034004a","8840",玉山-大里,0,3,3,-1,2.88
"20220105","1783","5857","5850",統一-新竹,2,0,2,1,1.92
"20220105","1783","0039003800390044","9800",元大-左營,0,3,3,-1,2.88
"20220105","1783","8888","8880",國泰-敦南,2,0,2,1,1.92
"20220105","1783","1041","1040",臺銀-鳳山,0,2,2,-1,1.92
"20220105","1783","9225","9200",凱基-內埔,2,0,2,1,1.92
"20220105","1783","7797","7790",國票-中正,0,2,2,-1,1.92
"20220105","1783","9227","9200",凱基-城中,2,0,2,1,1.92
"20220105","1783","8440","8440",摩根大通,0,2,2,-1,1.92
"20220105","1783","9815","9800",元大-大灣,2,0,2,1,1.92
"20220105","1783","9307","9300",華南永昌-大安,0,2,2,-1,1.92
"20220105","1783","9859","9800",元大-新竹經國,2,0,2,1,1.92
"20220105","1783","9309","9300",華南永昌-古亭,0,2,2,-1,1.92
"20220105","1783","003900410039004b","9A00",永豐金-三重,2,0,2,1,1.92
"20220105","1783","9623","9600",富邦-台北,0,2,2,-1,1.92
"20220106","1783","9276","9200",凱基-苗栗,14,0,14,1,7.65
"20220106","1783","9237","9200",凱基-敦北,0,19,19,-1,10.38
"20220106","1783","0037003000300048","7000",兆豐-東門,14,3,11,1,6.01
"20220106","1783","5854","5850",統一-城中,0,15,15,-1,8.20
"20220106","1783","0037003700390076","7790",國票-台中,10,0,10,1,5.46
"20220106","1783","9322","9300",華南永昌-公誠,1,12,11,-1,6.01
"20220106","1783","1650","1650",新加坡商瑞銀,10,1,9,1,4.92
"20220106","1783","9268","9200",凱基-台北,8,17,9,-1,4.92
"20220106","1783","8440","8440",摩根大通,9,0,9,1,4.92
"20220106","1783","7750","7750",北城證券,0,5,5,-1,2.73
"20220106","1783","0037003700390065","7790",國票-南科,6,0,6,1,3.28
"20220106","1783","0039003200300044","9200",凱基-市府,0,5,5,-1,2.73
"20220106","1783","9239","9200",凱基-市政,6,0,6,1,3.28
"20220106","1783","0035003800350057","5850",統一-金門,0,4,4,-1,2.19
"20220106","1783","0037003000300056","7000",兆豐-新竹,5,0,5,1,2.73
"20220106","1783","9813","9800",元大-八德,0,4,4,-1,2.19
"20220106","1783","9303","9300",華南永昌-高雄,5,0,5,1,2.73
"20220106","1783","0037003700390044","7790",國票-台南,0,3,3,-1,1.64
"20220106","1783","003900380031004e","9800",元大-金門,5,0,5,1,2.73
"20220106","1783","8560","8560",新光,0,3,3,-1,1.64
"20220106","1783","0039003800320041","9800",元大-羅東,4,0,4,1,2.19
"20220106","1783","003900310038004d","9100",群益金鼎-嘉義,0,3,3,-1,1.64
"20220106","1783","0035003300380057","5380",第一金-華江,3,0,3,1,1.64
"20220106","1783","9332","9300",華南永昌-楠梓,0,3,3,-1,1.64
"20220106","1783","0031003200360055","1260",宏遠-館前,3,0,3,1,1.64
"20220106","1783","9852","9800",元大-永春,0,3,3,-1,1.64
"20220106","1783","8886","8880",國泰-新莊,3,0,3,1,1.64
"20220106","1783","5323","5320",高橋-內壢,0,2,2,-1,1.09
"20220107","1783","9665","9600",富邦-桃園,15,0,15,1,3.43
"20220107","1783","0037003000300048","7000",兆豐-東門,0,43,43,-1,9.84
"20220107","1783","8560","8560",新光,14,0,14,1,3.20
"20220107","1783","5854","5850",統一-城中,0,41,41,-1,9.38
"20220107","1783","0039003800390051","9800",元大-汐止,11,0,11,1,2.52
"20220107","1783","0039003800390043","9800",元大-板橋,0,23,23,-1,5.26
"20220107","1783","0039003600320056","9600",富邦-復興,10,0,10,1,2.29
"20220107","1783","8440","8440",摩根大通,0,16,16,-1,3.66
"20220107","1783","9813","9800",元大-八德,11,3,8,1,1.83
"20220107","1783","9276","9200",凱基-苗栗,0,14,14,-1,3.20
"20220107","1783","5603","5600",永興-台中,7,0,7,1,1.60
"20220107","1783","003700300030004e","7000",兆豐-埔墘,0,11,11,-1,2.52
"20220107","1783","9322","9300",華南永昌-公誠,13,6,7,1,1.60
"20220107","1783","8150","8150",台新證券,4,15,11,-1,2.52
"20220107","1783","7750","7750",北城證券,6,0,6,1,1.37
"20220107","1783","9875","9800",元大-土城永寧,0,8,8,-1,1.83
"20220107","1783","9302","9300",華南永昌-台中,6,0,6,1,1.37
"20220107","1783","1560","1560",港商野村,0,6,6,-1,1.37
"20220107","1783","9692","9600",富邦-嘉義,6,0,6,1,1.37
"20220107","1783","1480","1480",美商高盛,0,6,6,-1,1.37
"20220107","1783","0039003800310044","9800",元大-南投,7,1,6,1,1.37
"20220107","1783","6110","6110",台中銀,0,5,5,-1,1.14
"20220107","1783","1470","1470",台灣摩根士丹利,5,0,5,1,1.14
"20220107","1783","0039003200300046","9200",凱基-站前,0,5,5,-1,1.14
"20220107","1783","0035003900320049","5920",元富-嘉義,5,0,5,1,1.14
"20220107","1783","9898","9800",元大-新莊,0,5,5,-1,1.14
"20220107","1783","8886","8880",國泰-新莊,5,0,5,1,1.14
"20220107","1783","1040","1040",臺銀,0,4,4,-1,0.92
"20220110","1783","003900380033006a","9800",元大-仁愛,21,0,21,1,13.04
"20220110","1783","0039004100390043","9A00",永豐金-員林,3,20,17,-1,10.56
"20220110","1783","9614","9600",富邦-基隆,10,0,10,1,6.21
"20220110","1783","0039004100390041","9A00",永豐金-羅東,0,10,10,-1,6.21
"20220110","1783","5323","5320",高橋-內壢,5,0,5,1,3.11
"20220110","1783","5854","5850",統一-城中,0,9,9,-1,5.59
"20220110","1783","9278","9200",凱基-永康,5,0,5,1,3.11
"20220110","1783","8440","8440",摩根大通,1,9,8,-1,4.97
"20220110","1783","8560","8560",新光,5,0,5,1,3.11
"20220110","1783","1470","1470",台灣摩根士丹利,3,10,7,-1,4.35
"20220110","1783","9858","9800",元大-龍潭,4,0,4,1,2.48
"20220110","1783","1650","1650",新加坡商瑞銀,8,14,6,-1,3.73
"20220110","1783","5855","5850",統一-台南,4,0,4,1,2.48
"20220110","1783","6114","6110",台中銀-員林,0,5,5,-1,3.11
"20220110","1783","9856","9800",元大-花蓮,4,0,4,1,2.48
"20220110","1783","9322","9300",華南永昌-公誠,1,6,5,-1,3.11
"20220110","1783","9329","9300",華南永昌-朴子,3,0,3,1,1.86
"20220110","1783","003900380036004b","9800",元大-基隆孝二,0,5,5,-1,3.11
"20220110","1783","9608","9600",富邦-台東,3,0,3,1,1.86
"20220110","1783","5320","5320",高橋,0,4,4,-1,2.48
"20220110","1783","003900380031004e","9800",元大-金門,3,0,3,1,1.86
"20220110","1783","5928","5920",元富-新莊,0,4,4,-1,2.48
"20220110","1783","0039004100390032","9A00",永豐金-萬盛,6,3,3,1,1.86
"20220110","1783","0038003400350042","8450",康和-永和,0,4,4,-1,2.48
"20220110","1783","0035003900320062","5920",元富-板橋,2,0,2,1,1.24
"20220110","1783","5261","5260",美好-蘆洲,0,3,3,-1,1.86
"20220110","1783","0038003100350059","8150",台新-新營,2,0,2,1,1.24
"20220110","1783","9315","9300",華南永昌-苑裡,0,3,3,-1,1.86
"20220111","1783","5603","5600",永興-台中,41,0,41,1,11.71
"20220111","1783","9873","9800",元大-西門,0,20,20,-1,5.71
"20220111","1783","8848","8840",玉山-嘉義,18,0,18,1,5.14
"20220111","1783","1650","1650",新加坡商瑞銀,2,19,17,-1,4.86
"20220111","1783","6165","6160",中國信託-新竹,11,0,11,1,3.14
"20220111","1783","1470","1470",台灣摩根士丹利,2,10,8,-1,2.29
"20220111","1783","0039004100390032","9A00",永豐金-萬盛,12,2,10,1,2.86
"20220111","1783","003500380035004a","5850",統一-三重,0,8,8,-1,2.29
"20220111","1783","8565","8560",新光-桃園,8,0,8,1,2.29
"20220111","1783","6161","6160",中國信託-三重,14,22,8,-1,2.29
"20220111","1783","5263","5260",美好-泰山,6,0,6,1,1.71
"20220111","1783","0039003200300044","9200",凱基-市府,0,8,8,-1,2.29
"20220111","1783","9322","9300",華南永昌-公誠,6,0,6,1,1.71
"20220111","1783","003900380039004a","9800",元大-彰化民生,0,7,7,-1,2.00
"20220111","1783","0039003800310044","9800",元大-南投,6,0,6,1,1.71
"20220111","1783","8440","8440",摩根大通,0,6,6,-1,1.71
"20220111","1783","5853","5850",統一-中壢,5,0,5,1,1.43
"20220111","1783","8560","8560",新光,2,8,6,-1,1.71
"20220111","1783","9227","9200",凱基-城中,5,0,5,1,1.43
"20220111","1783","9268","9200",凱基-台北,19,25,6,-1,1.71
"20220111","1783","9608","9600",富邦-台東,5,0,5,1,1.43
"20220111","1783","6380","6380",光和,0,5,5,-1,1.43
"20220111","1783","9614","9600",富邦-基隆,5,0,5,1,1.43
"20220111","1783","9676","9600",富邦-仁愛,0,5,5,-1,1.43
"20220111","1783","9665","9600",富邦-桃園,5,0,5,1,1.43
"20220111","1783","0039004100300030","9A00",永豐金證券,0,5,5,-1,1.43
"20220111","1783","0039003800390051","9800",元大-汐止,5,0,5,1,1.43
"20220111","1783","5856","5850",統一-台中,0,4,4,-1,1.14
"20220112","1783","1520","1520",瑞士信貸,24,0,24,1,8.45
"20220112","1783","9231","9200",凱基-員林,0,20,20,-1,7.04
"20220112","1783","1470","1470",台灣摩根士丹利,12,0,12,1,4.23
"20220112","1783","0039003200300047","9200",凱基-彰化,0,15,15,-1,5.28
"20220112","1783","8848","8840",玉山-嘉義,10,0,10,1,3.52
"20220112","1783","9331","9300",華南永昌-鳳山,0,11,11,-1,3.87
"20220112","1783","0039003100380045","9100",群益金鼎-南京,10,0,10,1,3.52
"20220112","1783","1650","1650",新加坡商瑞銀,6,14,8,-1,2.82
"20220112","1783","9858","9800",元大-龍潭,10,0,10,1,3.52
"20220112","1783","9875","9800",元大-土城永寧,0,8,8,-1,2.82
"20220112","1783","9813","9800",元大-八德,8,0,8,1,2.82
"20220112","1783","003900380039004a","9800",元大-彰化民生,0,8,8,-1,2.82
"20220112","1783","003600310036004b","6160",中國信託-高雄,6,0,6,1,2.11
"20220112","1783","9896","9800",元大-台南,0,7,7,-1,2.46
"20220112","1783","1440","1440",美林,6,1,5,1,1.76
"20220112","1783","5854","5850",統一-城中,0,6,6,-1,2.11
"20220112","1783","5850","5850",統一,5,0,5,1,1.76
"20220112","1783","0039003600320055","9600",富邦-縣政,0,6,6,-1,2.11
"20220112","1783","5853","5850",統一-中壢,5,0,5,1,1.76
"20220112","1783","0035003300380050","5380",第一金-路竹,0,5,5,-1,1.76
"20220112","1783","9608","9600",富邦-台東,5,0,5,1,1.76
"20220112","1783","9853","9800",元大-南屯,0,5,5,-1,1.76
"20220112","1783","0039004100390032","9A00",永豐金-萬盛,5,0,5,1,1.76
"20220112","1783","1021","1020",合庫-台中,0,4,4,-1,1.41
"20220112","1783","9667","9600",富邦-台南,5,1,4,1,1.41
"20220112","1783","6165","6160",中國信託-新竹,1,5,4,-1,1.41
"20220112","1783","1023","1020",合庫-高雄,4,0,4,1,1.41
"20220112","1783","8846","8840",玉山-板橋,0,4,4,-1,1.41
"20220113","1783","1650","1650",新加坡商瑞銀,21,7,14,1,5.96
"20220113","1783","0039003800320041","9800",元大-羅東,0,19,19,-1,8.09
"20220113","1783","1520","1520",瑞士信貸,8,0,8,1,3.40
"20220113","1783","0039004100390043","9A00",永豐金-員林,12,30,18,-1,7.66
"20220113","1783","1480","1480",美商高盛,8,0,8,1,3.40
"20220113","1783","003900380039004a","9800",元大-彰化民生,0,11,11,-1,4.68
"20220113","1783","1440","1440",美林,8,1,7,1,2.98
"20220113","1783","003900410039004e","9A00",永豐金-桃盛,0,10,10,-1,4.26
"20220113","1783","8440","8440",摩根大通,8,1,7,1,2.98
"20220113","1783","0031003000330046","1030",土銀-南港,0,8,8,-1,3.40
"20220113","1783","8888","8880",國泰-敦南,8,2,6,1,2.55
"20220113","1783","0039003200300047","9200",凱基-彰化,0,8,8,-1,3.40
"20220113","1783","1470","1470",台灣摩根士丹利,14,9,5,1,2.13
"20220113","1783","8848","8840",玉山-嘉義,0,6,6,-1,2.55
"20220113","1783","6114","6110",台中銀-員林,5,0,5,1,2.13
"20220113","1783","0039003200300046","9200",凱基-站前,0,6,6,-1,2.55
"20220113","1783","9608","9600",富邦-台東,5,0,5,1,2.13
"20220113","1783","0035003800350055","5850",統一-南京,0,5,5,-1,2.13
"20220113","1783","0039004100390032","9A00",永豐金-萬盛,5,0,5,1,2.13
"20220113","1783","6165","6160",中國信託-新竹,0,5,5,-1,2.13
"20220113","1783","9278","9200",凱基-永康,4,0,4,1,1.70
"20220113","1783","9208","9200",凱基-桃園,0,5,5,-1,2.13
"20220113","1783","8150","8150",台新證券,3,0,3,1,1.28
"20220113","1783","9813","9800",元大-八德,10,13,3,-1,1.28
"20220113","1783","9329","9300",華南永昌-朴子,3,0,3,1,1.28
"20220113","1783","0035003300380057","5380",第一金-華江,0,2,2,-1,0.85
"20220113","1783","9817","9800",元大-東泰,3,0,3,1,1.28
"20220113","1783","7797","7790",國票-中正,0,2,2,-1,0.85
"20220114","1783","8440","8440",摩根大通,19,2,17,1,6.14
"20220114","1783","9614","9600",富邦-基隆,0,17,17,-1,6.14
"20220114","1783","7006","7000",兆豐-台南,12,0,12,1,4.33
"20220114","1783","1650","1650",新加坡商瑞銀,17,33,16,-1,5.78
"20220114","1783","0039003800320043","9800",元大-六合,11,0,11,1,3.97
"20220114","1783","0035003800350055","5850",統一-南京,4,19,15,-1,5.42
"20220114","1783","9665","9600",富邦-桃園,10,0,10,1,3.61
"20220114","1783","8456","8450",康和-新竹,0,12,12,-1,4.33
"20220114","1783","9800","9800",元大證券,10,0,10,1,3.61
"20220114","1783","6168","6160",中國信託-嘉義,0,10,10,-1,3.61
"20220114","1783","0039004100390032","9A00",永豐金-萬盛,10,0,10,1,3.61
"20220114","1783","0039003200310045","9200",凱基-三峽,0,10,10,-1,3.61
"20220114","1783","9227","9200",凱基-城中,9,0,9,1,3.25
"20220114","1783","0039003600320042","9600",富邦-二林,0,10,10,-1,3.61
"20220114","1783","9813","9800",元大-八德,12,4,8,1,2.89
"20220114","1783","0037003000300057","7000",兆豐-城中,0,9,9,-1,3.25
"20220114","1783","8886","8880",國泰-新莊,7,0,7,1,2.53
"20220114","1783","003600310036004b","6160",中國信託-高雄,0,8,8,-1,2.89
"20220114","1783","9255","9200",凱基-和平,6,0,6,1,2.17
"20220114","1783","1440","1440",美林,1,6,5,-1,1.81
"20220114","1783","1470","1470",台灣摩根士丹利,5,0,5,1,1.81
"20220114","1783","8563","8560",新光-新竹,0,5,5,-1,1.81
"20220114","1783","0035003800350048","5850",統一-桃園,5,0,5,1,1.81
"20220114","1783","0039003200300046","9200",凱基-站前,0,5,5,-1,1.81
"20220114","1783","9308","9300",華南永昌-麻豆,5,0,5,1,1.81
"20220114","1783","9322","9300",華南永昌-公誠,0,5,5,-1,1.81
"20220114","1783","0039004100390042","9A00",永豐金-中和,5,0,5,1,1.81
"20220114","1783","003900380031004d","9800",元大-苗栗,0,5,5,-1,1.81
"20211216","1783","0039004100390043","9A00",永豐金-員林,28,0,28,1,6.31
"20211216","1783","0039003600320056","9600",富邦-復興,0,38,38,-1,8.56
"20211216","1783","9268","9200",凱基-台北,33,10,23,1,5.18
"20211216","1783","1119","1110",台灣企銀-岡山,0,30,30,-1,6.76
"20211216","1783","1650","1650",新加坡商瑞銀,26,4,22,1,4.95
"20211216","1783","6160","6160",中國信託,1,30,29,-1,6.53
"20211216","1783","9285","9200",凱基-中壢,11,0,11,1,2.48
"20211216","1783","0039003800390041","9800",元大-北投,0,23,23,-1,5.18
"20211216","1783","9874","9800",元大-雙和,9,0,9,1,2.03
"20211216","1783","003900380031004b","9800",元大-林園,0,21,21,-1,4.73
"20211216","1783","0039003600310048","9600",富邦-新板,8,0,8,1,1.80
"20211216","1783","1470","1470",台灣摩根士丹利,2,21,19,-1,4.28
"20211216","1783","003500320036004b","5260",美好-富順,8,1,7,1,1.58
"20211216","1783","8560","8560",新光,3,16,13,-1,2.93
"20211216","1783","9255","9200",凱基-和平,6,0,6,1,1.35
"20211216","1783","8150","8150",台新證券,0,12,12,-1,2.70
"20211216","1783","5384","5380",第一金-台南,5,0,5,1,1.13
"20211216","1783","8440","8440",摩根大通,2,13,11,-1,2.48
"20211216","1783","1022","1020",合庫-台南,5,0,5,1,1.13
"20211216","1783","1040","1040",臺銀,1,10,9,-1,2.03
"20211216","1783","5263","5260",美好-泰山,5,0,5,1,1.13
"20211216","1783","0037003700390058","7790",國票-中和,0,9,9,-1,2.03
"20211216","1783","5858","5850",統一-嘉義,5,0,5,1,1.13
"20211216","1783","0039003800310053","9800",元大-崇德,0,8,8,-1,1.80
"20211216","1783","7005","7000",兆豐-台中港,5,0,5,1,1.13
"20211216","1783","0039003800390045","9800",元大-草屯,0,7,7,-1,1.58
"20211216","1783","9315","9300",華南永昌-苑裡,5,0,5,1,1.13
"20211216","1783","5854","5850",統一-城中,0,6,6,-1,1.35
"20211217","1783","5853","5850",統一-中壢,21,0,21,1,5.48
"20211217","1783","0035003800350055","5850",統一-南京,0,30,30,-1,7.83
"20211217","1783","0039004100390043","9A00",永豐金-員林,20,0,20,1,5.22
"20211217","1783","6160","6160",中國信託,0,30,30,-1,7.83
"20211217","1783","9800","9800",元大證券,12,2,10,1,2.61
"20211217","1783","9206","9200",凱基-高雄,4,28,24,-1,6.27
"20211217","1783","9874","9800",元大-雙和,9,0,9,1,2.35
"20211217","1783","1470","1470",台灣摩根士丹利,5,26,21,-1,5.48
"20211217","1783","7750","7750",北城證券,7,0,7,1,1.83
"20211217","1783","0038003100350053","8150",台新-中壢,0,15,15,-1,3.92
"20211217","1783","9308","9300",華南永昌-麻豆,7,0,7,1,1.83
"20211217","1783","0039003200310059","9200",凱基-東勢,0,15,15,-1,3.92
"20211217","1783","9255","9200",凱基-和平,6,0,6,1,1.57
"20211217","1783","0039003600310048","9600",富邦-新板,0,13,13,-1,3.39
"20211217","1783","9285","9200",凱基-中壢,6,0,6,1,1.57
"20211217","1783","9268","9200",凱基-台北,25,36,11,-1,2.87
"20211217","1783","8888","8880",國泰-敦南,6,1,5,1,1.31
"20211217","1783","0035003900320045","5920",元富-城中,0,10,10,-1,2.61
"20211217","1783","5858","5850",統一-嘉義,5,0,5,1,1.31
"20211217","1783","6480","6480",福邦證券,0,10,10,-1,2.61
"20211217","1783","8151","8150",台新-建北,5,0,5,1,1.31
"20211217","1783","0039003100380063","9100",群益金鼎-鳳山,0,10,10,-1,2.61
"20211217","1783","8843","8840",玉山-高雄,5,0,5,1,1.31
"20211217","1783","9322","9300",華南永昌-公誠,2,11,9,-1,2.35
"20211217","1783","9105","9100",群益金鼎-高盛,5,0,5,1,1.31
"20211217","1783","003500380035004a","5850",統一-三重,0,8,8,-1,2.09
"20211217","1783","9108","9100",群益金鼎-海山,5,0,5,1,1.31
"20211217","1783","0037003000300077","7000",兆豐-新莊,0,8,8,-1,2.09
"20211220","1783","1560","1560",港商野村,10,0,10,1,5.68
"20211220","1783","9268","9200",凱基-台北,7,22,15,-1,8.52
"20211220","1783","003900380039004c","9800",元大-成功,7,0,7,1,3.98
"20211220","1783","0035003900320045","5920",元富-城中,0,10,10,-1,5.68
"20211220","1783","1650","1650",新加坡商瑞銀,16,10,6,1,3.41
"20211220","1783","7750","7750",北城證券,0,7,7,-1,3.98
"20211220","1783","1480","1480",美商高盛,6,1,5,1,2.84
"20211220","1783","9215","9200",凱基-高美館,0,7,7,-1,3.98
"20211220","1783","0037003000300071","7000",兆豐-內湖,5,0,5,1,2.84
"20211220","1783","1470","1470",台灣摩根士丹利,0,6,6,-1,3.41
"20211220","1783","8847","8840",玉山-台南,5,0,5,1,2.84
"20211220","1783","9800","9800",元大證券,0,5,5,-1,2.84
"20211220","1783","0039003100380047","9100",群益金鼎-新莊,5,0,5,1,2.84
"20211220","1783","1520","1520",瑞士信貸,0,4,4,-1,2.27
"20211220","1783","9302","9300",華南永昌-台中,5,0,5,1,2.84
"20211220","1783","1042","1040",臺銀-臺南,0,4,4,-1,2.27
"20211220","1783","003900380033005a","9800",元大-鳳山,5,0,5,1,2.84
"20211220","1783","0035003900320069","5920",元富-中港,0,4,4,-1,2.27
"20211220","1783","0039003800390043","9800",元大-板橋,5,0,5,1,2.84
"20211220","1783","8560","8560",新光,0,4,4,-1,2.27
"20211220","1783","0039003100330044","9100",群益金鼎-潭子,4,0,4,1,2.27
"20211220","1783","1041","1040",臺銀-鳳山,0,3,3,-1,1.70
"20211220","1783","0039003800350043","9800",元大-鳳中,4,0,4,1,2.27
"20211220","1783","9208","9200",凱基-桃園,0,3,3,-1,1.70
"20211220","1783","1040","1040",臺銀,3,0,3,1,1.70
"20211220","1783","9663","9600",富邦-敦南,0,3,3,-1,1.70
"20211220","1783","9686","9600",富邦-宜蘭,3,0,3,1,1.70
"20211220","1783","5262","5260",美好-楊梅,0,2,2,-1,1.14
"20211221","1783","1440","1440",美林,11,0,11,1,7.53
"20211221","1783","0035003900320045","5920",元富-城中,0,20,20,-1,13.70
"20211221","1783","0039003100380069","9100",群益金鼎-竹南,11,0,11,1,7.53
"20211221","1783","003500390032007a","5920",元富-文心,0,10,10,-1,6.85
"20211221","1783","1560","1560",港商野村,8,0,8,1,5.48
"20211221","1783","9800","9800",元大證券,0,10,10,-1,6.85
"20211221","1783","1650","1650",新加坡商瑞銀,13,7,6,1,4.11
"20211221","1783","1470","1470",台灣摩根士丹利,0,8,8,-1,5.48
"20211221","1783","0035003800350059","5850",統一-土城,5,0,5,1,3.42
"20211221","1783","5854","5850",統一-城中,0,6,6,-1,4.11
"20211221","1783","8440","8440",摩根大通,11,6,5,1,3.42
"20211221","1783","5263","5260",美好-泰山,0,5,5,-1,3.42
"20211221","1783","0039003100330044","9100",群益金鼎-潭子,5,0,5,1,3.42
"20211221","1783","0037003700390076","7790",國票-台中,0,5,5,-1,3.42
"20211221","1783","0039003800390055","9800",元大-大甲,5,0,5,1,3.42
"20211221","1783","0039003800350043","9800",元大-鳳中,0,4,4,-1,2.74
"20211221","1783","1116","1110",台灣企銀-屏東,4,0,4,1,2.74
"20211221","1783","1029","1020",合庫-鳳山,0,2,2,-1,1.37
"20211221","1783","8847","8840",玉山-台南,3,0,3,1,2.05
"20211221","1783","0035003900320069","5920",元富-中港,0,2,2,-1,1.37
"20211221","1783","1590","1590",花旗環球,2,0,2,1,1.37
"20211221","1783","7750","7750",北城證券,0,2,2,-1,1.37
"20211221","1783","0035003800350046","5850",統一-彰化,2,0,2,1,1.37
"20211221","1783","9215","9200",凱基-高美館,0,2,2,-1,1.37
"20211221","1783","0039003100380042","9100",群益金鼎-板橋,2,0,2,1,1.37
"20211221","1783","0039003600310053","9600",富邦-景美,0,2,2,-1,1.37
"20211221","1783","9315","9300",華南永昌-苑裡,2,0,2,1,1.37
"20211221","1783","9834","9800",元大-中壢,0,2,2,-1,1.37
"20211222","1783","5058","5050",大展-台南,10,0,10,1,6.17
"20211222","1783","0035003900320045","5920",元富-城中,0,17,17,-1,10.49
"20211222","1783","5266","5260",美好-中壢,5,0,5,1,3.09
"20211222","1783","5854","5850",統一-城中,0,15,15,-1,9.26
"20211222","1783","6380","6380",光和,5,0,5,1,3.09
"20211222","1783","9268","9200",凱基-台北,8,19,11,-1,6.79
"20211222","1783","9302","9300",華南永昌-台中,5,0,5,1,3.09
"20211222","1783","1470","1470",台灣摩根士丹利,0,8,8,-1,4.94
"20211222","1783","9692","9600",富邦-嘉義,5,0,5,1,3.09
"20211222","1783","8847","8840",玉山-台南,0,8,8,-1,4.94
"20211222","1783","9813","9800",元大-八德,5,0,5,1,3.09
"20211222","1783","7005","7000",兆豐-台中港,0,6,6,-1,3.70
"20211222","1783","0039003800390067","9800",元大-嘉義,5,0,5,1,3.09
"20211222","1783","1560","1560",港商野村,0,5,5,-1,3.09
"20211222","1783","9285","9200",凱基-中壢,4,0,4,1,2.47
"20211222","1783","9834","9800",元大-中壢,0,5,5,-1,3.09
"20211222","1783","0039003800390055","9800",元大-大甲,4,0,4,1,2.47
"20211222","1783","0039003800320041","9800",元大-羅東,0,4,4,-1,2.47
"20211222","1783","0031003000330046","1030",土銀-南港,3,0,3,1,1.85
"20211222","1783","9838","9800",元大-豐原,0,4,4,-1,2.47
"20211222","1783","5320","5320",高橋,3,0,3,1,1.85
"20211222","1783","8440","8440",摩根大通,1,4,3,-1,1.85
"20211222","1783","6460","6460",大昌,3,0,3,1,1.85
"20211222","1783","1440","1440",美林,0,2,2,-1,1.23
"20211222","1783","0037003000300071","7000",兆豐-內湖,3,0,3,1,1.85
"20211222","1783","8843","8840",玉山-高雄,0,2,2,-1,1.23
"20211222","1783","0037003700390057","7790",國票-彰化,3,0,3,1,1.85
"20211222","1783","0039003600310057","9600",富邦-東花蓮,0,2,2,-1,1.23
"20211223","1783","0039003800310046","9800",元大-福營,11,0,11,1,10.09
"20211223","1783","1470","1470",台灣摩根士丹利,0,10,10,-1,9.17
"20211223","1783","0035003900320045","5920",元富-城中,9,0,9,1,8.26
"20211223","1783","0039003800320041","9800",元大-羅東,1,9,8,-1,7.34
"20211223","1783","0035003800350059","5850",統一-土城,5,0,5,1,4.59
"20211223","1783","5854","5850",統一-城中,0,5,5,-1,4.59
"20211223","1783","8459","8450",康和-嘉義,5,0,5,1,4.59
"20211223","1783","0037003000300048","7000",兆豐-東門,0,5,5,-1,4.59
"20211223","1783","1116","1110",台灣企銀-屏東,3,0,3,1,2.75
"20211223","1783","9229","9200",凱基-中山,0,5,5,-1,4.59
"20211223","1783","6380","6380",光和,3,0,3,1,2.75
"20211223","1783","9667","9600",富邦-台南,0,5,5,-1,4.59
"20211223","1783","8881","8880",國泰-高雄,3,0,3,1,2.75
"20211223","1783","1650","1650",新加坡商瑞銀,1,4,3,-1,2.75
"20211223","1783","003900310038004a","9100",群益金鼎-永和,2,0,2,1,1.83
"20211223","1783","1480","1480",美商高盛,1,4,3,-1,2.75
"20211223","1783","9237","9200",凱基-敦北,2,0,2,1,1.83
"20211223","1783","8587","8580",聯邦-興中,0,3,3,-1,2.75
"20211223","1783","9285","9200",凱基-中壢,2,0,2,1,1.83
"20211223","1783","9202","9200",凱基-中港,0,3,3,-1,2.75
"20211223","1783","0039003800300043","9800",元大-斗六,2,0,2,1,1.83
"20211223","1783","0036003300380044","6380",光和-高雄,0,2,2,-1,1.83
"20211223","1783","0039003800320043","9800",元大-六合,2,0,2,1,1.83
"20211223","1783","8440","8440",摩根大通,0,2,2,-1,1.83
"20211223","1783","003500320036004b","5260",美好-富順,1,0,1,1,0.92
"20211223","1783","8560","8560",新光,1,3,2,-1,1.83
"20211223","1783","1028","1020",合庫-彰化,1,0,1,1,0.92
"20211223","1783","003800380034004a","8840",玉山-大里,0,2,2,-1,1.83
"20211224","1783","1440","1440",美林,34,7,27,1,4.27
"20211224","1783","6160","6160",中國信託,2,120,118,-1,18.64
"20211224","1783","9268","9200",凱基-台北,38,14,24,1,3.79
"20211224","1783","0035003800350055","5850",統一-南京,0,40,40,-1,6.32
"20211224","1783","1650","1650",新加坡商瑞銀,42,21,21,1,3.32
"20211224","1783","0039003800390047","9800",元大-大同,0,30,30,-1,4.74
"20211224","1783","5853","5850",統一-中壢,15,0,15,1,2.37
"20211224","1783","1470","1470",台灣摩根士丹利,12,36,24,-1,3.79
"20211224","1783","1041","1040",臺銀-鳳山,13,0,13,1,2.05
"20211224","1783","0039003800310079","9800",元大-善化,0,19,19,-1,3.00
"20211224","1783","5320","5320",高橋,10,0,10,1,1.58
"20211224","1783","8150","8150",台新證券,8,26,18,-1,2.84
"20211224","1783","5850","5850",統一,10,0,10,1,1.58
"20211224","1783","003100320036004c","1260",宏遠-台中,0,15,15,-1,2.37
"20211224","1783","9813","9800",元大-八德,13,3,10,1,1.58
"20211224","1783","5854","5850",統一-城中,0,10,10,-1,1.58
"20211224","1783","0039003100380063","9100",群益金鼎-鳳山,9,0,9,1,1.42
"20211224","1783","0039003600320055","9600",富邦-縣政,0,10,10,-1,1.58
"20211224","1783","0039003800310044","9800",元大-南投,9,0,9,1,1.42
"20211224","1783","0037003000300048","7000",兆豐-東門,1,10,9,-1,1.42
"20211224","1783","0039004100390058","9A00",永豐金-竹科,9,0,9,1,1.42
"20211224","1783","003900410039004c","9A00",永豐金-台中,1,10,9,-1,1.42
"20211224","1783","0039003100380069","9100",群益金鼎-竹南,8,0,8,1,1.26
"20211224","1783","0031003100310045","1110",台灣企銀-桃園,0,6,6,-1,0.95
"20211224","1783","7750","7750",北城證券,7,0,7,1,1.11
"20211224","1783","9693","9600",富邦-新營,0,6,6,-1,0.95
"20211224","1783","8843","8840",玉山-高雄,7,0,7,1,1.11
"20211224","1783","003900380039004a","9800",元大-彰化民生,1,7,6,-1,0.95
"20211227","1783","0039004100390041","9A00",永豐金-羅東,30,0,30,1,13.16
"20211227","1783","0039004100390057","9A00",永豐金-市政,0,30,30,-1,13.16
"20211227","1783","0039004100390043","9A00",永豐金-員林,18,0,18,1,7.89
"20211227","1783","9268","9200",凱基-台北,4,27,23,-1,10.09
"20211227","1783","1440","1440",美林,15,0,15,1,6.58
"20211227","1783","0039003600310044","9600",富邦-忠孝,0,11,11,-1,4.82
"20211227","1783","1470","1470",台灣摩根士丹利,14,7,7,1,3.07
"20211227","1783","9813","9800",元大-八德,0,7,7,-1,3.07
"20211227","1783","003500390032007a","5920",元富-文心,5,0,5,1,2.19
"20211227","1783","0039003600320057","9600",富邦-龍潭,0,6,6,-1,2.63
"20211227","1783","0036003100360041","6160",中國信託-中壢,5,0,5,1,2.19
"20211227","1783","0039003800390045","9800",元大-草屯,0,6,6,-1,2.63
"20211227","1783","0039003600320048","9600",富邦-鳳山,5,0,5,1,2.19
"20211227","1783","9215","9200",凱基-高美館,0,5,5,-1,2.19
"20211227","1783","9831","9800",元大-四維,5,0,5,1,2.19
"20211227","1783","003900410039004e","9A00",永豐金-桃盛,0,5,5,-1,2.19
"20211227","1783","003900380033005a","9800",元大-鳳山,5,0,5,1,2.19
"20211227","1783","0031003000340044","1040",臺銀-金山,0,4,4,-1,1.75
"20211227","1783","0039004100360031","9A00",永豐金-鳳山,5,0,5,1,2.19
"20211227","1783","0039003600310057","9600",富邦-東花蓮,0,4,4,-1,1.75
"20211227","1783","0038003800340048","8840",玉山-新竹,4,0,4,1,1.75
"20211227","1783","7750","7750",北城證券,1,4,3,-1,1.32
"20211227","1783","8886","8880",國泰-新莊,4,0,4,1,1.75
"20211227","1783","8440","8440",摩根大通,7,10,3,-1,1.32
"20211227","1783","0039003800320041","9800",元大-羅東,4,0,4,1,1.75
"20211227","1783","8560","8560",新光,0,3,3,-1,1.32
"20211227","1783","1650","1650",新加坡商瑞銀,8,5,3,1,1.32
"20211227","1783","8561","8560",新光-台中,0,3,3,-1,1.32
"20211228","1783","9275","9200",凱基-三多,15,0,15,1,6.73
"20211228","1783","0035003800350055","5850",統一-南京,0,24,24,-1,10.76
"20211228","1783","003900380031006d","9800",元大-前金,15,0,15,1,6.73
"20211228","1783","0039004100390041","9A00",永豐金-羅東,0,20,20,-1,8.97
"20211228","1783","0035003900320045","5920",元富-城中,10,0,10,1,4.48
"20211228","1783","9268","9200",凱基-台北,18,32,14,-1,6.28
"20211228","1783","1650","1650",新加坡商瑞銀,8,0,8,1,3.59
"20211228","1783","9813","9800",元大-八德,4,12,8,-1,3.59
"20211228","1783","1023","1020",合庫-高雄,6,0,6,1,2.69
"20211228","1783","1040","1040",臺銀,1,5,4,-1,1.79
"20211228","1783","8848","8840",玉山-嘉義,6,0,6,1,2.69
"20211228","1783","5856","5850",統一-台中,0,4,4,-1,1.79
"20211228","1783","0039003200320048","9200",凱基-復興,6,0,6,1,2.69
"20211228","1783","0037003700390056","7790",國票-天祥,0,4,4,-1,1.79
"20211228","1783","8886","8880",國泰-新莊,5,0,5,1,2.24
"20211228","1783","5381","5380",第一金-員林,0,3,3,-1,1.35
"20211228","1783","0039003600320048","9600",富邦-鳳山,5,0,5,1,2.24
"20211228","1783","9108","9100",群益金鼎-海山,0,3,3,-1,1.35
"20211228","1783","0039003600320057","9600",富邦-龍潭,5,0,5,1,2.24
"20211228","1783","9333","9300",華南永昌-長虹,0,3,3,-1,1.35
"20211228","1783","1440","1440",美林,12,8,4,1,1.79
"20211228","1783","0039003800320041","9800",元大-羅東,0,3,3,-1,1.35
"20211228","1783","1520","1520",瑞士信貸,3,0,3,1,1.35
"20211228","1783","0039004100390032","9A00",永豐金-萬盛,0,2,2,-1,0.90
"20211228","1783","9206","9200",凱基-高雄,3,0,3,1,1.35
"20211228","1783","5926","5920",元富-四維(停),0,2,2,-1,0.90
"20211228","1783","0035003300380057","5380",第一金-華江,2,0,2,1,0.90
"20211228","1783","5927","5920",元富-林園,0,2,2,-1,0.90
"20211229","1783","1480","1480",美商高盛,18,1,17,1,7.80
"20211229","1783","5854","5850",統一-城中,0,25,25,-1,11.47
"20211229","1783","8440","8440",摩根大通,12,0,12,1,5.50
"20211229","1783","0035003800350055","5850",統一-南京,0,20,20,-1,9.17
"20211229","1783","1440","1440",美林,10,0,10,1,4.59
"20211229","1783","0039003600310056","9600",富邦-板橋中山,0,15,15,-1,6.88
"20211229","1783","0035003900320045","5920",元富-城中,10,0,10,1,4.59
"20211229","1783","0039003600320048","9600",富邦-鳳山,0,10,10,-1,4.59
"20211229","1783","9692","9600",富邦-嘉義,10,0,10,1,4.59
"20211229","1783","5261","5260",美好-蘆洲,0,5,5,-1,2.29
"20211229","1783","9275","9200",凱基-三多,9,0,9,1,4.13
"20211229","1783","0039003800310072","9800",元大-屏南,0,5,5,-1,2.29
"20211229","1783","0039004100390043","9A00",永豐金-員林,9,0,9,1,4.13
"20211229","1783","0039003800390046","9800",元大-高雄,0,5,5,-1,2.29
"20211229","1783","9206","9200",凱基-高雄,8,0,8,1,3.67
"20211229","1783","8563","8560",新光-新竹,0,3,3,-1,1.38
"20211229","1783","1030","1030",土銀,6,0,6,1,2.75
"20211229","1783","1037","1030",土銀-花蓮,0,3,3,-1,1.38
"20211229","1783","5603","5600",永興-台中,5,0,5,1,2.29
"20211229","1783","5320","5320",高橋,0,3,3,-1,1.38
"20211229","1783","0037003700390057","7790",國票-彰化,5,0,5,1,2.29
"20211229","1783","0035003800350057","5850",統一-金門,0,3,3,-1,1.38
"20211229","1783","0039003800390061","9800",元大-苑裡,5,0,5,1,2.29
"20211229","1783","9333","9300",華南永昌-長虹,1,4,3,-1,1.38
"20211229","1783","0039003600320051","9600",富邦-北高雄,4,0,4,1,1.83
"20211229","1783","0039003800300061","9800",元大-承德,0,3,3,-1,1.38
"20211229","1783","9816","9800",元大-新竹,4,0,4,1,1.83
"20211229","1783","0039003800390067","9800",元大-嘉義,0,3,3,-1,1.38
"20211230","1783","0039003600310044","9600",富邦-忠孝,30,0,30,1,13.10
"20211230","1783","1470","1470",台灣摩根士丹利,2,25,23,-1,10.04
"20211230","1783","9873","9800",元大-西門,30,0,30,1,13.10
"20211230","1783","0039003200320048","9200",凱基-復興,0,20,20,-1,8.73
"20211230","1783","6114","6110",台中銀-員林,8,0,8,1,3.49
"20211230","1783","5854","5850",統一-城中,0,12,12,-1,5.24
"20211230","1783","9206","9200",凱基-高雄,6,0,6,1,2.62
"20211230","1783","8848","8840",玉山-嘉義,0,10,10,-1,4.37
"20211230","1783","1028","1020",合庫-彰化,5,0,5,1,2.18
"20211230","1783","1440","1440",美林,3,10,7,-1,3.06
"20211230","1783","9658","9600",富邦-建國,5,0,5,1,2.18
"20211230","1783","9208","9200",凱基-桃園,0,7,7,-1,3.06
"20211230","1783","1480","1480",美商高盛,5,1,4,1,1.75
"20211230","1783","0039003800310046","9800",元大-福營,0,7,7,-1,3.06
"20211230","1783","9322","9300",華南永昌-公誠,5,1,4,1,1.75
"20211230","1783","9667","9600",富邦-台南,0,7,7,-1,3.06
"20211230","1783","0039003800300044","9800",元大-北府,3,0,3,1,1.31
"20211230","1783","8440","8440",摩根大通,0,6,6,-1,2.62
"20211230","1783","0035003900320041","5920",元富-緯城,3,0,3,1,1.31
"20211230","1783","9268","9200",凱基-台北,7,13,6,-1,2.62
"20211230","1783","003500380035004a","5850",統一-三重,2,0,2,1,0.87
"20211230","1783","7750","7750",北城證券,0,4,4,-1,1.75
"20211230","1783","0036003300380044","6380",光和-高雄,2,0,2,1,0.87
"20211230","1783","9835","9800",元大-員林中山,0,4,4,-1,1.75
"20211230","1783","6465","6460",大昌-桃園,2,0,2,1,0.87
"20211230","1783","0039003800390044","9800",元大-左營,0,4,4,-1,1.75
"20211230","1783","0037003000300058","7000",兆豐-永和,2,0,2,1,0.87
"20211230","1783","8882","8880",國泰-台中,0,2,2,-1,0.87
"20211201","1783","8440","8440",摩根大通,86,17,69,1,6.57
"20211201","1783","0031003100310042","1110",台灣企銀-建成,0,30,30,-1,2.86
"20211201","1783","9268","9200",凱基-台北,85,24,61,1,5.81
"20211201","1783","0036003000310064","6010",(牛牛牛)亞-鑫豐,2,24,22,-1,2.10
"20211201","1783","5384","5380",第一金-台南,29,0,29,1,2.76
"20211201","1783","0039004100390043","9A00",永豐金-員林,0,20,20,-1,1.90
"20211201","1783","8580","8580",聯邦商銀,21,0,21,1,2.00
"20211201","1783","0035003900320071","5920",元富-屏東,0,18,18,-1,1.71
"20211201","1783","0039003800310079","9800",元大-善化,19,0,19,1,1.81
"20211201","1783","8881","8880",國泰-高雄,3,21,18,-1,1.71
"20211201","1783","003900410039006a","9A00",永豐金-嘉義,21,2,19,1,1.81
"20211201","1783","0039003800390058","9800",元大-民生,0,18,18,-1,1.71
"20211201","1783","1470","1470",台灣摩根士丹利,26,11,15,1,1.43
"20211201","1783","003900380031004e","9800",元大-金門,1,16,15,-1,1.43
"20211201","1783","9319","9300",華南永昌-鶯歌,19,4,15,1,1.43
"20211201","1783","0039004100390061","9A00",永豐金-苓雅,0,14,14,-1,1.33
"20211201","1783","6012","6010",(牛牛牛)亞-網路,12,0,12,1,1.14
"20211201","1783","0039003600320056","9600",富邦-復興,0,12,12,-1,1.14
"20211201","1783","9308","9300",華南永昌-麻豆,12,0,12,1,1.14
"20211201","1783","6460","6460",大昌,0,11,11,-1,1.05
"20211201","1783","0031003200360044","1260",宏遠-台南,10,0,10,1,0.95
"20211201","1783","8848","8840",玉山-嘉義,2,13,11,-1,1.05
"20211201","1783","1560","1560",港商野村,19,9,10,1,0.95
"20211201","1783","0039003600320047","9600",富邦-斗六,0,11,11,-1,1.05
"20211201","1783","0039003200310047","9200",凱基-五股,11,2,9,1,0.86
"20211201","1783","1480","1480",美商高盛,13,23,10,-1,0.95
"20211201","1783","1440","1440",美林,9,2,7,1,0.67
"20211201","1783","0035003300380045","5380",第一金-自由,1,11,10,-1,0.95
"20211202","1783","5384","5380",第一金-台南,42,0,42,1,2.99
"20211202","1783","1520","1520",瑞士信貸,0,151,151,-1,10.73
"20211202","1783","0037003000300048","7000",兆豐-東門,41,6,35,1,2.49
"20211202","1783","1470","1470",台灣摩根士丹利,2,102,100,-1,7.11
"20211202","1783","8580","8580",聯邦商銀,32,0,32,1,2.27
"20211202","1783","9268","9200",凱基-台北,43,118,75,-1,5.33
"20211202","1783","9366","9300",華南永昌-豐原,25,0,25,1,1.78
"20211202","1783","0035003800350055","5850",統一-南京,84,129,45,-1,3.20
"20211202","1783","5850","5850",統一,25,2,23,1,1.63
"20211202","1783","1650","1650",新加坡商瑞銀,53,98,45,-1,3.20
"20211202","1783","8843","8840",玉山-高雄,21,0,21,1,1.49
"20211202","1783","9634","9600",富邦-羅東,0,40,40,-1,2.84
"20211202","1783","9215","9200",凱基-高美館,21,0,21,1,1.49
"20211202","1783","1440","1440",美林,2,33,31,-1,2.20
"20211202","1783","0039003200300047","9200",凱基-彰化,20,0,20,1,1.42
"20211202","1783","1480","1480",美商高盛,3,33,30,-1,2.13
"20211202","1783","5858","5850",統一-嘉義,15,0,15,1,1.07
"20211202","1783","6012","6010",(牛牛牛)亞-網路,5,24,19,-1,1.35
"20211202","1783","0035003900320044","5920",元富-大昌,15,0,15,1,1.07
"20211202","1783","8842","8840",玉山-新莊,1,20,19,-1,1.35
"20211202","1783","0037003700390058","7790",國票-中和,15,0,15,1,1.07
"20211202","1783","1560","1560",港商野村,3,14,11,-1,0.78
"20211202","1783","8848","8840",玉山-嘉義,15,0,15,1,1.07
"20211202","1783","8584","8580",聯邦-雙和,0,10,10,-1,0.71
"20211202","1783","0039003100330044","9100",群益金鼎-潭子,15,1,14,1,1.00
"20211202","1783","0039003800390055","9800",元大-大甲,1,10,9,-1,0.64
"20211202","1783","0039003600320056","9600",富邦-復興,13,0,13,1,0.92
"20211202","1783","9184","9100",群益金鼎-台中,0,7,7,-1,0.50
"20211203","1783","9268","9200",凱基-台北,39,0,39,1,12.66
"20211203","1783","1650","1650",新加坡商瑞銀,4,29,25,-1,8.12
"20211203","1783","1470","1470",台灣摩根士丹利,24,2,22,1,7.14
"20211203","1783","0039003800300065","9800",元大-清水,0,21,21,-1,6.82
"20211203","1783","0039003800310053","9800",元大-崇德,20,0,20,1,6.49
"20211203","1783","0039003600320056","9600",富邦-復興,0,12,12,-1,3.90
"20211203","1783","1560","1560",港商野村,14,0,14,1,4.55
"20211203","1783","8565","8560",新光-桃園,0,10,10,-1,3.25
"20211203","1783","0037003000300071","7000",兆豐-內湖,10,0,10,1,3.25
"20211203","1783","8840","8840",玉山證券,0,9,9,-1,2.92
"20211203","1783","0037003700390050","7790",國票-九鼎,10,0,10,1,3.25
"20211203","1783","9800","9800",元大證券,0,9,9,-1,2.92
"20211203","1783","9272","9200",凱基-竹科,10,0,10,1,3.25
"20211203","1783","6915","6910",德信-和平,0,8,8,-1,2.60
"20211203","1783","9206","9200",凱基-高雄,12,3,9,1,2.92
"20211203","1783","9308","9300",華南永昌-麻豆,3,11,8,-1,2.60
"20211203","1783","8440","8440",摩根大通,6,0,6,1,1.95
"20211203","1783","9859","9800",元大-新竹經國,0,8,8,-1,2.60
"20211203","1783","0039003800320041","9800",元大-羅東,6,0,6,1,1.95
"20211203","1783","5854","5850",統一-城中,0,7,7,-1,2.27
"20211203","1783","1520","1520",瑞士信貸,8,3,5,1,1.62
"20211203","1783","9854","9800",元大-文心興安,0,7,7,-1,2.27
"20211203","1783","0035003900320062","5920",元富-板橋,7,2,5,1,1.62
"20211203","1783","003500380035004d","5850",統一-士林,0,5,5,-1,1.62
"20211203","1783","8150","8150",台新證券,5,0,5,1,1.62
"20211203","1783","003600310036004b","6160",中國信託-高雄,0,5,5,-1,1.62
"20211203","1783","9869","9800",元大-新盛,5,0,5,1,1.62
"20211203","1783","0039003100330045","9100",群益金鼎-基隆,0,5,5,-1,1.62
"20211206","1783","9205","9200",凱基-三重,30,15,15,1,2.82
"20211206","1783","6160","6160",中國信託,0,30,30,-1,5.65
"20211206","1783","9215","9200",凱基-高美館,18,3,15,1,2.82
"20211206","1783","1520","1520",瑞士信貸,2,30,28,-1,5.27
"20211206","1783","1480","1480",美商高盛,20,7,13,1,2.45
"20211206","1783","5854","5850",統一-城中,0,26,26,-1,4.90
"20211206","1783","0031003000330046","1030",土銀-南港,15,2,13,1,2.45
"20211206","1783","003900410039006a","9A00",永豐金-嘉義,1,21,20,-1,3.77
"20211206","1783","0037003000300048","7000",兆豐-東門,13,0,13,1,2.45
"20211206","1783","1650","1650",新加坡商瑞銀,34,49,15,-1,2.82
"20211206","1783","8580","8580",聯邦商銀,12,0,12,1,2.26
"20211206","1783","0039003100330044","9100",群益金鼎-潭子,0,13,13,-1,2.45
"20211206","1783","5384","5380",第一金-台南,10,0,10,1,1.88
"20211206","1783","9859","9800",元大-新竹經國,0,11,11,-1,2.07
"20211206","1783","5850","5850",統一,11,2,9,1,1.69
"20211206","1783","9800","9800",元大證券,2,12,10,-1,1.88
"20211206","1783","0039003200320048","9200",凱基-復興,9,0,9,1,1.69
"20211206","1783","0039003800390045","9800",元大-草屯,0,10,10,-1,1.88
"20211206","1783","5858","5850",統一-嘉義,8,0,8,1,1.51
"20211206","1783","9278","9200",凱基-永康,0,9,9,-1,1.69
"20211206","1783","8882","8880",國泰-台中,8,0,8,1,1.51
"20211206","1783","0039003600320055","9600",富邦-縣政,0,6,6,-1,1.13
"20211206","1783","1030","1030",土銀,6,0,6,1,1.13
"20211206","1783","0039004100380046","9A00",永豐金-敦南,0,6,6,-1,1.13
"20211206","1783","0035003300380041","5380",第一金-新興,6,0,6,1,1.13
"20211206","1783","0039004100390043","9A00",永豐金-員林,0,6,6,-1,1.13
"20211206","1783","9308","9300",華南永昌-麻豆,6,0,6,1,1.13
"20211206","1783","003900380031006e","9800",元大-旗山,0,5,5,-1,0.94
"20211207","1783","0039003800390058","9800",元大-民生,25,0,25,1,7.46
"20211207","1783","1650","1650",新加坡商瑞銀,3,22,19,-1,5.67
"20211207","1783","5850","5850",統一,18,0,18,1,5.37
"20211207","1783","9205","9200",凱基-三重,0,15,15,-1,4.48
"20211207","1783","8580","8580",聯邦商銀,14,0,14,1,4.18
"20211207","1783","0035003800350055","5850",統一-南京,22,36,14,-1,4.18
"20211207","1783","1232","1230",彰銀-七賢,11,0,11,1,3.28
"20211207","1783","1560","1560",港商野村,0,11,11,-1,3.28
"20211207","1783","0037003000300048","7000",兆豐-東門,10,0,10,1,2.99
"20211207","1783","9206","9200",凱基-高雄,1,12,11,-1,3.28
"20211207","1783","0039003800320043","9800",元大-六合,7,0,7,1,2.09
"20211207","1783","1520","1520",瑞士信貸,4,14,10,-1,2.99
"20211207","1783","0039003200320048","9200",凱基-復興,6,0,6,1,1.79
"20211207","1783","003500380035004d","5850",統一-士林,0,10,10,-1,2.99
"20211207","1783","1036","1030",土銀-玉里,5,0,5,1,1.49
"20211207","1783","6012","6010",(牛牛牛)亞-網路,0,10,10,-1,2.99
"20211207","1783","6168","6160",中國信託-嘉義,5,0,5,1,1.49
"20211207","1783","9858","9800",元大-龍潭,0,10,10,-1,2.99
"20211207","1783","8382","8380",安泰-楠梓,5,0,5,1,1.49
"20211207","1783","0039003800310065","9800",元大-佳里,1,10,9,-1,2.69
"20211207","1783","003800380034004a","8840",玉山-大里,5,0,5,1,1.49
"20211207","1783","0031003200360044","1260",宏遠-台南,0,8,8,-1,2.39
"20211207","1783","9268","9200",凱基-台北,28,23,5,1,1.49
"20211207","1783","1470","1470",台灣摩根士丹利,3,11,8,-1,2.39
"20211207","1783","0039003800350043","9800",元大-鳳中,5,0,5,1,1.49
"20211207","1783","003700370039007a","7790",國票-博愛,0,8,8,-1,2.39
"20211207","1783","0031003000330046","1030",土銀-南港,4,0,4,1,1.19
"20211207","1783","8156","8150",台新-三民,0,8,8,-1,2.39
"20211208","1783","8440","8440",摩根大通,61,5,56,1,7.94
"20211208","1783","9215","9200",凱基-高美館,2,36,34,-1,4.82
"20211208","1783","1480","1480",美商高盛,40,0,40,1,5.67
"20211208","1783","0039004100390043","9A00",永豐金-員林,1,22,21,-1,2.98
"20211208","1783","8560","8560",新光,44,4,40,1,5.67
"20211208","1783","0039003600320055","9600",富邦-縣政,0,20,20,-1,2.84
"20211208","1783","9672","9600",富邦-員林,38,0,38,1,5.39
"20211208","1783","9206","9200",凱基-高雄,5,22,17,-1,2.41
"20211208","1783","1440","1440",美林,41,4,37,1,5.25
"20211208","1783","0035003800350055","5850",統一-南京,0,16,16,-1,2.27
"20211208","1783","1520","1520",瑞士信貸,27,0,27,1,3.83
"20211208","1783","0039004100300030","9A00",永豐金證券,1,17,16,-1,2.27
"20211208","1783","1560","1560",港商野村,32,8,24,1,3.40
"20211208","1783","0035003900320041","5920",元富-緯城,0,15,15,-1,2.13
"20211208","1783","0039003800390045","9800",元大-草屯,16,0,16,1,2.27
"20211208","1783","8888","8880",國泰-敦南,0,15,15,-1,2.13
"20211208","1783","0039003800310053","9800",元大-崇德,13,0,13,1,1.84
"20211208","1783","0039003800390058","9800",元大-民生,0,15,15,-1,2.13
"20211208","1783","0035003900320045","5920",元富-城中,10,0,10,1,1.42
"20211208","1783","9308","9300",華南永昌-麻豆,2,16,14,-1,1.99
"20211208","1783","9319","9300",華南永昌-鶯歌,10,0,10,1,1.42
"20211208","1783","0037003000300048","7000",兆豐-東門,10,23,13,-1,1.84
"20211208","1783","5384","5380",第一金-台南,12,3,9,1,1.28
"20211208","1783","8882","8880",國泰-台中,0,12,12,-1,1.70
"20211208","1783","9239","9200",凱基-市政,9,0,9,1,1.28
"20211208","1783","0039004100380046","9A00",永豐金-敦南,0,11,11,-1,1.56
"20211208","1783","0039004100390042","9A00",永豐金-中和,10,1,9,1,1.28
"20211208","1783","5854","5850",統一-城中,0,10,10,-1,1.42
"20211209","1783","9215","9200",凱基-高美館,38,0,38,1,6.44
"20211209","1783","9686","9600",富邦-宜蘭,0,53,53,-1,8.98
"20211209","1783","0039004100300030","9A00",永豐金證券,22,0,22,1,3.73
"20211209","1783","8562","8560",新光-高雄,0,44,44,-1,7.46
"20211209","1783","9366","9300",華南永昌-豐原,20,0,20,1,3.39
"20211209","1783","9268","9200",凱基-台北,15,53,38,-1,6.44
"20211209","1783","9308","9300",華南永昌-麻豆,17,1,16,1,2.71
"20211209","1783","8440","8440",摩根大通,0,34,34,-1,5.76
"20211209","1783","6163","6160",中國信託-永康,10,0,10,1,1.69
"20211209","1783","1440","1440",美林,6,35,29,-1,4.92
"20211209","1783","8881","8880",國泰-高雄,10,0,10,1,1.69
"20211209","1783","1650","1650",新加坡商瑞銀,10,39,29,-1,4.92
"20211209","1783","0039003600320051","9600",富邦-北高雄,10,0,10,1,1.69
"20211209","1783","1480","1480",美商高盛,2,27,25,-1,4.24
"20211209","1783","0039003600320057","9600",富邦-龍潭,10,0,10,1,1.69
"20211209","1783","0039003100380075","9100",群益金鼎-瑞豐,1,14,13,-1,2.20
"20211209","1783","9676","9600",富邦-仁愛,10,0,10,1,1.69
"20211209","1783","1560","1560",港商野村,0,12,12,-1,2.03
"20211209","1783","0039003100330044","9100",群益金鼎-潭子,8,0,8,1,1.36
"20211209","1783","1520","1520",瑞士信貸,0,11,11,-1,1.86
"20211209","1783","9665","9600",富邦-桃園,8,0,8,1,1.36
"20211209","1783","6160","6160",中國信託,0,10,10,-1,1.69
"20211209","1783","0035003800350057","5850",統一-金門,7,0,7,1,1.19
"20211209","1783","0039003600330042","9600",富邦-北宜蘭,0,10,10,-1,1.69
"20211209","1783","5384","5380",第一金-台南,6,0,6,1,1.02
"20211209","1783","0039004100390042","9A00",永豐金-中和,0,10,10,-1,1.69
"20211209","1783","0035003800350046","5850",統一-彰化,6,0,6,1,1.02
"20211209","1783","8847","8840",玉山-台南,0,9,9,-1,1.53
"20211210","1783","9614","9600",富邦-基隆,37,0,37,1,3.20
"20211210","1783","1520","1520",瑞士信貸,0,54,54,-1,4.68
"20211210","1783","9268","9200",凱基-台北,82,54,28,1,2.42
"20211210","1783","9285","9200",凱基-中壢,0,54,54,-1,4.68
"20211210","1783","0039003600320056","9600",富邦-復興,25,0,25,1,2.16
"20211210","1783","8440","8440",摩根大通,22,61,39,-1,3.38
"20211210","1783","003900380031004b","9800",元大-林園,25,0,25,1,2.16
"20211210","1783","9672","9600",富邦-員林,0,38,38,-1,3.29
"20211210","1783","0039004100390043","9A00",永豐金-員林,18,0,18,1,1.56
"20211210","1783","8560","8560",新光,12,48,36,-1,3.12
"20211210","1783","0036003300380044","6380",光和-高雄,15,0,15,1,1.30
"20211210","1783","0039003800390041","9800",元大-北投,0,34,34,-1,2.94
"20211210","1783","003900380031006d","9800",元大-前金,15,0,15,1,1.30
"20211210","1783","0039003100380050","9100",群益金鼎-天母,0,31,31,-1,2.68
"20211210","1783","0037003000300048","7000",兆豐-東門,20,8,12,1,1.04
"20211210","1783","1040","1040",臺銀,2,31,29,-1,2.51
"20211210","1783","8888","8880",國泰-敦南,14,2,12,1,1.04
"20211210","1783","5922","5920",元富-新店,0,25,25,-1,2.16
"20211210","1783","0031003000340043","1040",臺銀-高雄,11,0,11,1,0.95
"20211210","1783","9661","9600",富邦-新店,0,22,22,-1,1.90
"20211210","1783","5320","5320",高橋,11,0,11,1,0.95
"20211210","1783","1470","1470",台灣摩根士丹利,0,21,21,-1,1.82
"20211210","1783","0039003800310072","9800",元大-屏南,11,0,11,1,0.95
"20211210","1783","5925","5920",元富-台中,1,20,19,-1,1.65
"20211210","1783","5858","5850",統一-嘉義,10,0,10,1,0.87
"20211210","1783","9857","9800",元大-東蘆,5,24,19,-1,1.65
"20211210","1783","0035003800350048","5850",統一-桃園,10,0,10,1,0.87
"20211210","1783","1650","1650",新加坡商瑞銀,49,67,18,-1,1.56
"20211213","1783","9834","9800",元大-中壢,22,0,22,1,5.09
"20211213","1783","1520","1520",瑞士信貸,0,44,44,-1,10.19
"20211213","1783","9686","9600",富邦-宜蘭,17,0,17,1,3.94
"20211213","1783","9366","9300",華南永昌-豐原,0,40,40,-1,9.26
"20211213","1783","8440","8440",摩根大通,33,18,15,1,3.47
"20211213","1783","6160","6160",中國信託,0,30,30,-1,6.94
"20211213","1783","1650","1650",新加坡商瑞銀,15,1,14,1,3.24
"20211213","1783","9854","9800",元大-文心興安,0,24,24,-1,5.56
"20211213","1783","0039003800390051","9800",元大-汐止,12,0,12,1,2.78
"20211213","1783","9308","9300",華南永昌-麻豆,0,22,22,-1,5.09
"20211213","1783","0035003300380044","5380",第一金-忠孝,10,0,10,1,2.31
"20211213","1783","1480","1480",美商高盛,3,22,19,-1,4.40
"20211213","1783","5850","5850",統一,10,0,10,1,2.31
"20211213","1783","0035003900320072","5920",元富-城東,0,10,10,-1,2.31
"20211213","1783","7034","7030",致和-金華,10,0,10,1,2.31
"20211213","1783","0035003900320077","5920",元富-佳里,0,10,10,-1,2.31
"20211213","1783","9238","9200",凱基-士林,10,0,10,1,2.31
"20211213","1783","9215","9200",凱基-高美館,0,10,10,-1,2.31
"20211213","1783","9256","9200",凱基-南崁,10,0,10,1,2.31
"20211213","1783","003700300030006a","7000",兆豐-大安,0,7,7,-1,1.62
"20211213","1783","9889","9800",元大-員林,9,0,9,1,2.08
"20211213","1783","8150","8150",台新證券,1,8,7,-1,1.62
"20211213","1783","9206","9200",凱基-高雄,8,0,8,1,1.85
"20211213","1783","8846","8840",玉山-板橋,0,7,7,-1,1.62
"20211213","1783","0039003200320048","9200",凱基-復興,6,0,6,1,1.39
"20211213","1783","0038003800340045","8840",玉山-城中,0,7,7,-1,1.62
"20211213","1783","003900380031006e","9800",元大-旗山,6,0,6,1,1.39
"20211213","1783","1470","1470",台灣摩根士丹利,0,5,5,-1,1.16
"20211214","1783","8881","8880",國泰-高雄,31,0,31,1,5.79
"20211214","1783","1520","1520",瑞士信貸,0,23,23,-1,4.30
"20211214","1783","0039004100390043","9A00",永豐金-員林,28,2,26,1,4.86
"20211214","1783","9206","9200",凱基-高雄,3,26,23,-1,4.30
"20211214","1783","9898","9800",元大-新莊,12,0,12,1,2.24
"20211214","1783","0035003800350055","5850",統一-南京,0,22,22,-1,4.11
"20211214","1783","9268","9200",凱基-台北,36,24,12,1,2.24
"20211214","1783","8560","8560",新光,3,21,18,-1,3.36
"20211214","1783","5850","5850",統一,10,0,10,1,1.87
"20211214","1783","0039003100330044","9100",群益金鼎-潭子,2,20,18,-1,3.36
"20211214","1783","0035003800350059","5850",統一-土城,10,0,10,1,1.87
"20211214","1783","9834","9800",元大-中壢,3,20,17,-1,3.18
"20211214","1783","7006","7000",兆豐-台南,10,0,10,1,1.87
"20211214","1783","0037003000300048","7000",兆豐-東門,0,15,15,-1,2.80
"20211214","1783","1650","1650",新加坡商瑞銀,45,36,9,1,1.68
"20211214","1783","1480","1480",美商高盛,2,15,13,-1,2.43
"20211214","1783","8888","8880",國泰-敦南,8,0,8,1,1.50
"20211214","1783","1261","1260",宏遠-民生,0,10,10,-1,1.87
"20211214","1783","7750","7750",北城證券,7,1,6,1,1.12
"20211214","1783","0035003900320072","5920",元富-城東,0,10,10,-1,1.87
"20211214","1783","9322","9300",華南永昌-公誠,6,0,6,1,1.12
"20211214","1783","9215","9200",凱基-高美館,10,20,10,-1,1.87
"20211214","1783","9105","9100",群益金鼎-高盛,5,0,5,1,0.93
"20211214","1783","9859","9800",元大-新竹經國,1,11,10,-1,1.87
"20211214","1783","0039003200320048","9200",凱基-復興,5,0,5,1,0.93
"20211214","1783","8846","8840",玉山-板橋,0,7,7,-1,1.31
"20211214","1783","9319","9300",華南永昌-鶯歌,5,0,5,1,0.93
"20211214","1783","9676","9600",富邦-仁愛,1,8,7,-1,1.31
"20211215","1783","9614","9600",富邦-基隆,20,0,20,1,8.23
"20211215","1783","0039004100390043","9A00",永豐金-員林,8,26,18,-1,7.41
"20211215","1783","1560","1560",港商野村,11,2,9,1,3.70
"20211215","1783","5854","5850",統一-城中,0,15,15,-1,6.17
"20211215","1783","9322","9300",華南永昌-公誠,10,1,9,1,3.70
"20211215","1783","0035003800350055","5850",統一-南京,0,12,12,-1,4.94
"20211215","1783","9302","9300",華南永昌-台中,8,0,8,1,3.29
"20211215","1783","003900320031004d","9200",凱基-八德,0,10,10,-1,4.12
"20211215","1783","9256","9200",凱基-南崁,7,0,7,1,2.88
"20211215","1783","1470","1470",台灣摩根士丹利,0,8,8,-1,3.29
"20211215","1783","0035003900320057","5920",元富-吉利,5,0,5,1,2.06
"20211215","1783","0039003600320056","9600",富邦-復興,0,8,8,-1,3.29
"20211215","1783","9285","9200",凱基-中壢,5,0,5,1,2.06
"20211215","1783","0039003800320043","9800",元大-六合,0,7,7,-1,2.88
"20211215","1783","0039003600320051","9600",富邦-北高雄,5,0,5,1,2.06
"20211215","1783","1520","1520",瑞士信貸,0,6,6,-1,2.47
"20211215","1783","9672","9600",富邦-員林,5,0,5,1,2.06
"20211215","1783","8560","8560",新光,1,7,6,-1,2.47
"20211215","1783","0039003800300043","9800",元大-斗六,5,0,5,1,2.06
"20211215","1783","8440","8440",摩根大通,5,9,4,-1,1.65
"20211215","1783","0039004100300030","9A00",永豐金證券,5,0,5,1,2.06
"20211215","1783","003900380039006a","9800",元大-樹林,1,5,4,-1,1.65
"20211215","1783","0035003300380057","5380",第一金-華江,3,0,3,1,1.23
"20211215","1783","9859","9800",元大-新竹經國,0,3,3,-1,1.23
"20211215","1783","0036003300380044","6380",光和-高雄,3,0,3,1,1.23
"20211215","1783","5862","5860",盈溢-楠梓,0,2,2,-1,0.82
"20211215","1783","9343","9300",華南永昌-頭份,3,0,3,1,1.23
"20211215","1783","0035003900320069","5920",元富-中港,0,2,2,-1,0.82
"20211116","1783","8440","8440",摩根大通,44,12,32,1,4.55
"20211116","1783","0035003900320047","5920",元富-新竹,0,70,70,-1,9.96
"20211116","1783","0037003000300063","7000",兆豐-民生,34,3,31,1,4.41
"20211116","1783","0039004100390043","9A00",永豐金-員林,15,62,47,-1,6.69
"20211116","1783","5854","5850",統一-城中,30,0,30,1,4.27
"20211116","1783","8888","8880",國泰-敦南,4,25,21,-1,2.99
"20211116","1783","1440","1440",美林,24,1,23,1,3.27
"20211116","1783","0038003400350041","8450",康和-內湖,0,20,20,-1,2.84
"20211116","1783","9268","9200",凱基-台北,30,9,21,1,2.99
"20211116","1783","9333","9300",華南永昌-長虹,0,12,12,-1,1.71
"20211116","1783","0037003000300068","7000",兆豐-三民,20,0,20,1,2.84
"20211116","1783","1520","1520",瑞士信貸,0,12,12,-1,1.71
"20211116","1783","8880","8880",國泰證券,20,0,20,1,2.84
"20211116","1783","0039004100390057","9A00",永豐金-市政,0,12,12,-1,1.71
"20211116","1783","0039004100300030","9A00",永豐金證券,20,0,20,1,2.84
"20211116","1783","0039003800390050","9800",元大-敦南,0,11,11,-1,1.56
"20211116","1783","5603","5600",永興-台中,12,1,11,1,1.56
"20211116","1783","1470","1470",台灣摩根士丹利,10,20,10,-1,1.42
"20211116","1783","0039003200320048","9200",凱基-復興,11,0,11,1,1.56
"20211116","1783","0035003300380045","5380",第一金-自由,0,10,10,-1,1.42
"20211116","1783","0037003000300048","7000",兆豐-東門,10,0,10,1,1.42
"20211116","1783","6161","6160",中國信託-三重,0,10,10,-1,1.42
"20211116","1783","0038003400350055","8450",康和-台北,10,0,10,1,1.42
"20211116","1783","0038003100350053","8150",台新-中壢,0,10,10,-1,1.42
"20211116","1783","9322","9300",華南永昌-公誠,10,0,10,1,1.42
"20211116","1783","0039003100380075","9100",群益金鼎-瑞豐,0,10,10,-1,1.42
"20211116","1783","0039003600320056","9600",富邦-復興,10,1,9,1,1.28
"20211116","1783","9817","9800",元大-東泰,0,9,9,-1,1.28
"20211117","1783","9874","9800",元大-雙和,31,0,31,1,6.09
"20211117","1783","1650","1650",新加坡商瑞銀,6,37,31,-1,6.09
"20211117","1783","0039004100390043","9A00",永豐金-員林,25,6,19,1,3.73
"20211117","1783","5854","5850",統一-城中,10,40,30,-1,5.89
"20211117","1783","0039003100330059","9100",群益金鼎-館前,18,0,18,1,3.54
"20211117","1783","9322","9300",華南永昌-公誠,0,29,29,-1,5.70
"20211117","1783","0035003800350055","5850",統一-南京,17,1,16,1,3.14
"20211117","1783","0039003600320056","9600",富邦-復興,0,22,22,-1,4.32
"20211117","1783","1021","1020",合庫-台中,15,1,14,1,2.75
"20211117","1783","9333","9300",華南永昌-長虹,0,20,20,-1,3.93
"20211117","1783","9268","9200",凱基-台北,32,19,13,1,2.55
"20211117","1783","1520","1520",瑞士信貸,26,44,18,-1,3.54
"20211117","1783","8882","8880",國泰-台中,12,0,12,1,2.36
"20211117","1783","9229","9200",凱基-中山,0,11,11,-1,2.16
"20211117","1783","1470","1470",台灣摩根士丹利,10,0,10,1,1.96
"20211117","1783","1560","1560",港商野村,4,14,10,-1,1.96
"20211117","1783","0037003000300048","7000",兆豐-東門,10,0,10,1,1.96
"20211117","1783","6451","6450",永全-南崁,0,7,7,-1,1.38
"20211117","1783","0038003400350055","8450",康和-台北,10,0,10,1,1.96
"20211117","1783","1045","1040",臺銀-新竹,0,6,6,-1,1.18
"20211117","1783","0039004100390039","9A00",永豐金-中壢,10,0,10,1,1.96
"20211117","1783","6168","6160",中國信託-嘉義,0,6,6,-1,1.18
"20211117","1783","003500390032006d","5920",元富-成功,9,0,9,1,1.77
"20211117","1783","2180","2180",亞東,0,5,5,-1,0.98
"20211117","1783","0037003000300063","7000",兆豐-民生,22,14,8,1,1.57
"20211117","1783","0039003800330069","9800",元大-大雅,0,5,5,-1,0.98
"20211117","1783","9667","9600",富邦-台南,8,0,8,1,1.57
"20211117","1783","0037003700390044","7790",國票-台南,0,4,4,-1,0.79
"20211118","1783","0037003000300048","7000",兆豐-東門,35,0,35,1,7.38
"20211118","1783","0037003000300068","7000",兆豐-三民,2,40,38,-1,8.02
"20211118","1783","8440","8440",摩根大通,19,4,15,1,3.16
"20211118","1783","0039003100380050","9100",群益金鼎-天母,0,29,29,-1,6.12
"20211118","1783","1470","1470",台灣摩根士丹利,13,0,13,1,2.74
"20211118","1783","8887","8880",國泰-忠孝,0,20,20,-1,4.22
"20211118","1783","0039003800390047","9800",元大-大同,12,0,12,1,2.53
"20211118","1783","9229","9200",凱基-中山,0,20,20,-1,4.22
"20211118","1783","1560","1560",港商野村,12,1,11,1,2.32
"20211118","1783","0039004100390057","9A00",永豐金-市政,0,20,20,-1,4.22
"20211118","1783","0037003000300063","7000",兆豐-民生,10,0,10,1,2.11
"20211118","1783","0035003800350055","5850",統一-南京,11,26,15,-1,3.16
"20211118","1783","9237","9200",凱基-敦北,10,1,9,1,1.90
"20211118","1783","9322","9300",華南永昌-公誠,1,15,14,-1,2.95
"20211118","1783","0039003600310043","9600",富邦-南京,9,0,9,1,1.90
"20211118","1783","9238","9200",凱基-士林,0,12,12,-1,2.53
"20211118","1783","9215","9200",凱基-高美館,8,0,8,1,1.69
"20211118","1783","0031003000320043","1020",合庫-自強,0,11,11,-1,2.32
"20211118","1783","1480","1480",美商高盛,15,8,7,1,1.48
"20211118","1783","9872","9800",元大-復北,0,10,10,-1,2.11
"20211118","1783","0037003700390058","7790",國票-中和,7,0,7,1,1.48
"20211118","1783","7032","7030",致和-佳里,0,8,8,-1,1.69
"20211118","1783","8882","8880",國泰-台中,6,0,6,1,1.27
"20211118","1783","0039003600320056","9600",富邦-復興,0,8,8,-1,1.69
"20211118","1783","0039003200320048","9200",凱基-復興,6,0,6,1,1.27
"20211118","1783","6012","6010",(牛牛牛)亞-網路,0,6,6,-1,1.27
"20211118","1783","1040","1040",臺銀,5,0,5,1,1.05
"20211118","1783","6160","6160",中國信託,0,5,5,-1,1.05
"20211119","1783","8440","8440",摩根大通,46,8,38,1,7.28
"20211119","1783","9817","9800",元大-東泰,0,22,22,-1,4.21
"20211119","1783","0039003100380050","9100",群益金鼎-天母,31,0,31,1,5.94
"20211119","1783","0039003200300041","9200",凱基-板橋,0,19,19,-1,3.64
"20211119","1783","0039004100390043","9A00",永豐金-員林,24,0,24,1,4.60
"20211119","1783","1470","1470",台灣摩根士丹利,0,14,14,-1,2.68
"20211119","1783","1560","1560",港商野村,18,3,15,1,2.87
"20211119","1783","0039003800390047","9800",元大-大同,0,12,12,-1,2.30
"20211119","1783","1440","1440",美林,14,3,11,1,2.11
"20211119","1783","6012","6010",(牛牛牛)亞-網路,0,10,10,-1,1.92
"20211119","1783","1232","1230",彰銀-七賢,10,0,10,1,1.92
"20211119","1783","7005","7000",兆豐-台中港,0,10,10,-1,1.92
"20211119","1783","6161","6160",中國信託-三重,10,0,10,1,1.92
"20211119","1783","0037003000300048","7000",兆豐-東門,0,10,10,-1,1.92
"20211119","1783","9105","9100",群益金鼎-高盛,10,0,10,1,1.92
"20211119","1783","8380","8380",安泰,0,10,10,-1,1.92
"20211119","1783","9215","9200",凱基-高美館,10,0,10,1,1.92
"20211119","1783","9204","9200",凱基-台中,0,8,8,-1,1.53
"20211119","1783","0039003600320044","9600",富邦-新莊,10,0,10,1,1.92
"20211119","1783","9322","9300",華南永昌-公誠,3,10,7,-1,1.34
"20211119","1783","9857","9800",元大-東蘆,10,0,10,1,1.92
"20211119","1783","6168","6160",中國信託-嘉義,0,6,6,-1,1.15
"20211119","1783","0039003600320055","9600",富邦-縣政,8,0,8,1,1.53
"20211119","1783","6915","6910",德信-和平,0,5,5,-1,0.96
"20211119","1783","003900380031004e","9800",元大-金門,7,0,7,1,1.34
"20211119","1783","8881","8880",國泰-高雄,0,5,5,-1,0.96
"20211119","1783","7797","7790",國票-中正,6,0,6,1,1.15
"20211119","1783","003900380030006c","9800",元大-虎尾,0,5,5,-1,0.96
"20211122","1783","0035003800350055","5850",統一-南京,53,0,53,1,6.36
"20211122","1783","1520","1520",瑞士信貸,12,67,55,-1,6.60
"20211122","1783","9333","9300",華南永昌-長虹,26,0,26,1,3.12
"20211122","1783","1650","1650",新加坡商瑞銀,1,35,34,-1,4.08
"20211122","1783","8848","8840",玉山-嘉義,25,0,25,1,3.00
"20211122","1783","0035003900320047","5920",元富-新竹,0,31,31,-1,3.72
"20211122","1783","6162","6160",中國信託-忠孝,24,0,24,1,2.88
"20211122","1783","5854","5850",統一-城中,30,56,26,-1,3.12
"20211122","1783","1560","1560",港商野村,23,11,12,1,1.44
"20211122","1783","1440","1440",美林,5,21,16,-1,1.92
"20211122","1783","1260","1260",宏遠證券,11,0,11,1,1.32
"20211122","1783","0039003800310072","9800",元大-屏南,0,15,15,-1,1.80
"20211122","1783","6012","6010",(牛牛牛)亞-網路,11,0,11,1,1.32
"20211122","1783","0037003000300063","7000",兆豐-民生,9,22,13,-1,1.56
"20211122","1783","8881","8880",國泰-高雄,12,1,11,1,1.32
"20211122","1783","9268","9200",凱基-台北,40,52,12,-1,1.44
"20211122","1783","0039004100300030","9A00",永豐金證券,17,6,11,1,1.32
"20211122","1783","6161","6160",中國信託-三重,0,10,10,-1,1.20
"20211122","1783","0035003300380044","5380",第一金-忠孝,11,1,10,1,1.20
"20211122","1783","9238","9200",凱基-士林,0,10,10,-1,1.20
"20211122","1783","5922","5920",元富-新店,10,0,10,1,1.20
"20211122","1783","0039004100390057","9A00",永豐金-市政,1,11,10,-1,1.20
"20211122","1783","0039003600320056","9600",富邦-復興,10,0,10,1,1.20
"20211122","1783","9136","9100",群益金鼎-西松,0,9,9,-1,1.08
"20211122","1783","9857","9800",元大-東蘆,10,0,10,1,1.20
"20211122","1783","9237","9200",凱基-敦北,0,9,9,-1,1.08
"20211122","1783","003900380039004a","9800",元大-彰化民生,9,1,8,1,0.96
"20211122","1783","9834","9800",元大-中壢,0,9,9,-1,1.08
"20211123","1783","8156","8150",台新-三民,38,0,38,1,2.99
"20211123","1783","1520","1520",瑞士信貸,1,98,97,-1,7.64
"20211123","1783","5854","5850",統一-城中,55,26,29,1,2.29
"20211123","1783","9135","9100",群益金鼎-東大,3,100,97,-1,7.64
"20211123","1783","6161","6160",中國信託-三重,20,0,20,1,1.58
"20211123","1783","0039003800310053","9800",元大-崇德,0,66,66,-1,5.20
"20211123","1783","0037003000300048","7000",兆豐-東門,20,0,20,1,1.58
"20211123","1783","0039003100330059","9100",群益金鼎-館前,1,65,64,-1,5.04
"20211123","1783","003900380039004a","9800",元大-彰化民生,20,0,20,1,1.58
"20211123","1783","9276","9200",凱基-苗栗,0,38,38,-1,2.99
"20211123","1783","0035003900320050","5920",元富-同大,24,6,18,1,1.42
"20211123","1783","1470","1470",台灣摩根士丹利,0,33,33,-1,2.60
"20211123","1783","9215","9200",凱基-高美館,21,3,18,1,1.42
"20211123","1783","1650","1650",新加坡商瑞銀,3,35,32,-1,2.52
"20211123","1783","0039003600320056","9600",富邦-復興,15,0,15,1,1.18
"20211123","1783","6460","6460",大昌,0,21,21,-1,1.65
"20211123","1783","0039003600320057","9600",富邦-龍潭,20,5,15,1,1.18
"20211123","1783","0038003400350055","8450",康和-台北,0,20,20,-1,1.58
"20211123","1783","0035003800350055","5850",統一-南京,76,61,15,1,1.18
"20211123","1783","003900410039004d","9A00",永豐金-南投,10,28,18,-1,1.42
"20211123","1783","0035003900320043","5920",元富-潮州,12,0,12,1,0.95
"20211123","1783","0039004100300030","9A00",永豐金證券,0,17,17,-1,1.34
"20211123","1783","0039003100330044","9100",群益金鼎-潭子,12,0,12,1,0.95
"20211123","1783","1480","1480",美商高盛,17,32,15,-1,1.18
"20211123","1783","9255","9200",凱基-和平,18,6,12,1,0.95
"20211123","1783","9302","9300",華南永昌-台中,0,12,12,-1,0.95
"20211123","1783","1232","1230",彰銀-七賢,10,0,10,1,0.79
"20211123","1783","003500390032006d","5920",元富-成功,0,10,10,-1,0.79
"20211124","1783","8848","8840",玉山-嘉義,20,1,19,1,5.15
"20211124","1783","003900410039004d","9A00",永豐金-南投,0,50,50,-1,13.55
"20211124","1783","8882","8880",國泰-台中,16,0,16,1,4.34
"20211124","1783","0039003800310053","9800",元大-崇德,0,24,24,-1,6.50
"20211124","1783","1041","1040",臺銀-鳳山,10,0,10,1,2.71
"20211124","1783","9627","9600",富邦-內湖,0,18,18,-1,4.88
"20211124","1783","9268","9200",凱基-台北,24,14,10,1,2.71
"20211124","1783","1650","1650",新加坡商瑞銀,1,13,12,-1,3.25
"20211124","1783","1440","1440",美林,10,1,9,1,2.44
"20211124","1783","5852","5850",統一-敦南,0,10,10,-1,2.71
"20211124","1783","1470","1470",台灣摩根士丹利,10,2,8,1,2.17
"20211124","1783","9276","9200",凱基-苗栗,0,10,10,-1,2.71
"20211124","1783","0037003000300063","7000",兆豐-民生,7,0,7,1,1.90
"20211124","1783","5854","5850",統一-城中,1,9,8,-1,2.17
"20211124","1783","0037003000300045","7000",兆豐-斗南(停),7,0,7,1,1.90
"20211124","1783","8881","8880",國泰-高雄,0,8,8,-1,2.17
"20211124","1783","9319","9300",華南永昌-鶯歌,7,0,7,1,1.90
"20211124","1783","5265","5260",美好-苗栗,0,8,8,-1,2.17
"20211124","1783","9333","9300",華南永昌-長虹,7,0,7,1,1.90
"20211124","1783","9657","9600",富邦-苗栗,0,7,7,-1,1.90
"20211124","1783","0039004100300030","9A00",永豐金證券,7,0,7,1,1.90
"20211124","1783","0035003900320050","5920",元富-同大,0,5,5,-1,1.36
"20211124","1783","5851","5850",統一-高雄,6,0,6,1,1.63
"20211124","1783","0039003100330044","9100",群益金鼎-潭子,0,5,5,-1,1.36
"20211124","1783","9215","9200",凱基-高美館,6,0,6,1,1.63
"20211124","1783","9328","9300",華南永昌-潮州,0,5,5,-1,1.36
"20211124","1783","9281","9200",凱基-斗六,6,0,6,1,1.63
"20211124","1783","9623","9600",富邦-台北,0,5,5,-1,1.36
"20211125","1783","8156","8150",台新-三民,69,0,69,1,6.43
"20211125","1783","5854","5850",統一-城中,16,49,33,-1,3.08
"20211125","1783","0035003800350055","5850",統一-南京,83,20,63,1,5.87
"20211125","1783","9268","9200",凱基-台北,37,70,33,-1,3.08
"20211125","1783","1650","1650",新加坡商瑞銀,54,4,50,1,4.66
"20211125","1783","9614","9600",富邦-基隆,5,30,25,-1,2.33
"20211125","1783","9634","9600",富邦-羅東,41,0,41,1,3.82
"20211125","1783","0039004100390043","9A00",永豐金-員林,0,25,25,-1,2.33
"20211125","1783","1260","1260",宏遠證券,26,0,26,1,2.42
"20211125","1783","6161","6160",中國信託-三重,0,20,20,-1,1.86
"20211125","1783","8881","8880",國泰-高雄,27,5,22,1,2.05
"20211125","1783","9333","9300",華南永昌-長虹,0,20,20,-1,1.86
"20211125","1783","0039003800390047","9800",元大-大同,21,0,21,1,1.96
"20211125","1783","0039003600320057","9600",富邦-龍潭,0,20,20,-1,1.86
"20211125","1783","1440","1440",美林,25,5,20,1,1.86
"20211125","1783","0039003800390058","9800",元大-民生,0,20,20,-1,1.86
"20211125","1783","0035003900320050","5920",元富-同大,18,0,18,1,1.68
"20211125","1783","0039003800310053","9800",元大-崇德,0,16,16,-1,1.49
"20211125","1783","0035003900320041","5920",元富-緯城,17,0,17,1,1.58
"20211125","1783","8888","8880",國泰-敦南,3,19,16,-1,1.49
"20211125","1783","9206","9200",凱基-高雄,24,10,14,1,1.30
"20211125","1783","1021","1020",合庫-台中,0,15,15,-1,1.40
"20211125","1783","0035003300380045","5380",第一金-自由,11,0,11,1,1.03
"20211125","1783","0039003600310048","9600",富邦-新板,0,12,12,-1,1.12
"20211125","1783","0035003900320072","5920",元富-城東,10,0,10,1,0.93
"20211125","1783","8560","8560",新光,0,10,10,-1,0.93
"20211125","1783","9319","9300",華南永昌-鶯歌,10,0,10,1,0.93
"20211125","1783","8848","8840",玉山-嘉義,1,11,10,-1,0.93
"20211126","1783","8562","8560",新光-高雄,47,1,46,1,2.04
"20211126","1783","1520","1520",瑞士信貸,4,102,98,-1,4.35
"20211126","1783","8881","8880",國泰-高雄,41,9,32,1,1.42
"20211126","1783","1470","1470",台灣摩根士丹利,2,99,97,-1,4.30
"20211126","1783","8150","8150",台新證券,33,2,31,1,1.37
"20211126","1783","9268","9200",凱基-台北,88,183,95,-1,4.21
"20211126","1783","9659","9600",富邦-高雄,26,0,26,1,1.15
"20211126","1783","0031003100310042","1110",台灣企銀-建成,0,25,25,-1,1.11
"20211126","1783","0039004100390057","9A00",永豐金-市政,26,0,26,1,1.15
"20211126","1783","1480","1480",美商高盛,24,46,22,-1,0.98
"20211126","1783","6162","6160",中國信託-忠孝,50,25,25,1,1.11
"20211126","1783","9833","9800",元大-敦化,0,21,21,-1,0.93
"20211126","1783","9604","9600",富邦-陽明,24,1,23,1,1.02
"20211126","1783","0038003100350041","8150",台新-高雄,0,20,20,-1,0.89
"20211126","1783","0039003800310053","9800",元大-崇德,18,1,17,1,0.75
"20211126","1783","1260","1260",宏遠證券,15,34,19,-1,0.84
"20211126","1783","0039004100390037","9A00",永豐金-新竹,19,2,17,1,0.75
"20211126","1783","0039003800300043","9800",元大-斗六,1,20,19,-1,0.84
"20211126","1783","0039003800390058","9800",元大-民生,31,15,16,1,0.71
"20211126","1783","9315","9300",華南永昌-苑裡,0,18,18,-1,0.80
"20211126","1783","1440","1440",美林,19,4,15,1,0.67
"20211126","1783","0035003900320050","5920",元富-同大,0,14,14,-1,0.62
"20211126","1783","5854","5850",統一-城中,57,43,14,1,0.62
"20211126","1783","0037003000300048","7000",兆豐-東門,39,51,12,-1,0.53
"20211126","1783","6012","6010",(牛牛牛)亞-網路,11,0,11,1,0.49
"20211126","1783","9862","9800",元大-南京,3,15,12,-1,0.53
"20211126","1783","7006","7000",兆豐-台南,11,0,11,1,0.49
"20211126","1783","0039003100330044","9100",群益金鼎-潭子,0,10,10,-1,0.44
"20211129","1783","0039003600320055","9600",富邦-縣政,20,2,18,1,1.81
"20211129","1783","0039003100380050","9100",群益金鼎-天母,0,32,32,-1,3.22
"20211129","1783","0039004100390057","9A00",永豐金-市政,14,0,14,1,1.41
"20211129","1783","5854","5850",統一-城中,0,25,25,-1,2.52
"20211129","1783","6165","6160",中國信託-新竹,11,0,11,1,1.11
"20211129","1783","9604","9600",富邦-陽明,1,21,20,-1,2.01
"20211129","1783","6168","6160",中國信託-嘉義,11,0,11,1,1.11
"20211129","1783","1260","1260",宏遠證券,0,16,16,-1,1.61
"20211129","1783","8150","8150",台新證券,11,0,11,1,1.11
"20211129","1783","1470","1470",台灣摩根士丹利,2,17,15,-1,1.51
"20211129","1783","1232","1230",彰銀-七賢,10,0,10,1,1.01
"20211129","1783","1480","1480",美商高盛,16,31,15,-1,1.51
"20211129","1783","5922","5920",元富-新店,10,0,10,1,1.01
"20211129","1783","0039003800390058","9800",元大-民生,0,15,15,-1,1.51
"20211129","1783","0039003100380045","9100",群益金鼎-南京,10,0,10,1,1.01
"20211129","1783","0039003800310053","9800",元大-崇德,0,15,15,-1,1.51
"20211129","1783","9319","9300",華南永昌-鶯歌,10,0,10,1,1.01
"20211129","1783","9135","9100",群益金鼎-東大,0,14,14,-1,1.41
"20211129","1783","9693","9600",富邦-新營,10,0,10,1,1.01
"20211129","1783","1650","1650",新加坡商瑞銀,35,45,10,-1,1.01
"20211129","1783","5265","5260",美好-苗栗,10,0,10,1,1.01
"20211129","1783","0039003100380047","9100",群益金鼎-新莊,0,10,10,-1,1.01
"20211129","1783","9206","9200",凱基-高雄,9,0,9,1,0.91
"20211129","1783","9268","9200",凱基-台北,55,65,10,-1,1.01
"20211129","1783","9278","9200",凱基-永康,10,1,9,1,0.91
"20211129","1783","9359","9300",華南永昌-中正,0,10,10,-1,1.01
"20211129","1783","8881","8880",國泰-高雄,24,16,8,1,0.80
"20211129","1783","9874","9800",元大-雙和,0,10,10,-1,1.01
"20211130","1783","8440","8440",摩根大通,141,1,140,1,13.04
"20211130","1783","9204","9200",凱基-台中,0,67,67,-1,6.24
"20211130","1783","0039003100380050","9100",群益金鼎-天母,31,0,31,1,2.89
"20211130","1783","6162","6160",中國信託-忠孝,0,42,42,-1,3.91
"20211130","1783","9268","9200",凱基-台北,86,56,30,1,2.79
"20211130","1783","0039003200320048","9200",凱基-復興,4,22,18,-1,1.68
"20211130","1783","1119","1110",台灣企銀-岡山,30,0,30,1,2.79
"20211130","1783","1520","1520",瑞士信貸,18,35,17,-1,1.58
"20211130","1783","0039004100300030","9A00",永豐金證券,30,1,29,1,2.70
"20211130","1783","0039004100390037","9A00",永豐金-新竹,1,17,16,-1,1.49
"20211130","1783","1036","1030",土銀-玉里,27,0,27,1,2.51
"20211130","1783","8881","8880",國泰-高雄,12,27,15,-1,1.40
"20211130","1783","5384","5380",第一金-台南,20,2,18,1,1.68
"20211130","1783","0039004100390061","9A00",永豐金-苓雅,0,15,15,-1,1.40
"20211130","1783","0039004100390043","9A00",永豐金-員林,22,5,17,1,1.58
"20211130","1783","9659","9600",富邦-高雄,0,14,14,-1,1.30
"20211130","1783","5850","5850",統一,16,0,16,1,1.49
"20211130","1783","1480","1480",美商高盛,10,22,12,-1,1.12
"20211130","1783","7034","7030",致和-金華,10,0,10,1,0.93
"20211130","1783","1041","1040",臺銀-鳳山,0,11,11,-1,1.02
"20211130","1783","8841","8840",玉山-雙和,10,0,10,1,0.93
"20211130","1783","0039004100390057","9A00",永豐金-市政,0,11,11,-1,1.02
"20211130","1783","8840","8840",玉山證券,10,0,10,1,0.93
"20211130","1783","0037003000300055","7000",兆豐-桃鶯,10,20,10,-1,0.93
"20211130","1783","8847","8840",玉山-台南,8,0,8,1,0.74
"20211130","1783","8560","8560",新光,5,15,10,-1,0.93
"20211130","1783","9312","9300",華南永昌-民權,8,0,8,1,0.74
"20211130","1783","9359","9300",華南永昌-中正,0,10,10,-1,0.93
"20211101","1783","9255","9200",凱基-和平,54,6,48,1,5.85
"20211101","1783","5264","5260",美好-高雄,0,30,30,-1,3.66
"20211101","1783","0039004100300030","9A00",永豐金證券,43,0,43,1,5.24
"20211101","1783","9366","9300",華南永昌-豐原,0,30,30,-1,3.66
"20211101","1783","1650","1650",新加坡商瑞銀,39,0,39,1,4.76
"20211101","1783","0035003300380044","5380",第一金-忠孝,0,28,28,-1,3.41
"20211101","1783","1440","1440",美林,38,3,35,1,4.27
"20211101","1783","5854","5850",統一-城中,0,25,25,-1,3.05
"20211101","1783","0039004100390043","9A00",永豐金-員林,27,9,18,1,2.20
"20211101","1783","1030","1030",土銀,5,29,24,-1,2.93
"20211101","1783","1470","1470",台灣摩根士丹利,15,2,13,1,1.59
"20211101","1783","9206","9200",凱基-高雄,0,22,22,-1,2.68
"20211101","1783","1520","1520",瑞士信貸,11,0,11,1,1.34
"20211101","1783","9268","9200",凱基-台北,39,60,21,-1,2.56
"20211101","1783","9331","9300",華南永昌-鳳山,11,0,11,1,1.34
"20211101","1783","6163","6160",中國信託-永康,0,15,15,-1,1.83
"20211101","1783","0039003800320043","9800",元大-六合,11,0,11,1,1.34
"20211101","1783","9238","9200",凱基-士林,5,20,15,-1,1.83
"20211101","1783","1036","1030",土銀-玉里,10,0,10,1,1.22
"20211101","1783","9837","9800",元大-北港,0,15,15,-1,1.83
"20211101","1783","5603","5600",永興-台中,10,0,10,1,1.22
"20211101","1783","0039003800390058","9800",元大-民生,10,25,15,-1,1.83
"20211101","1783","9672","9600",富邦-員林,10,0,10,1,1.22
"20211101","1783","5850","5850",統一,0,10,10,-1,1.22
"20211101","1783","9831","9800",元大-四維,10,0,10,1,1.22
"20211101","1783","9319","9300",華南永昌-鶯歌,0,10,10,-1,1.22
"20211101","1783","0039004100390041","9A00",永豐金-羅東,10,0,10,1,1.22
"20211101","1783","0039003800310072","9800",元大-屏南,0,10,10,-1,1.22
"20211102","1783","0039004100390043","9A00",永豐金-員林,22,0,22,1,5.12
"20211102","1783","1233","1230",彰銀-台中,0,39,39,-1,9.07
"20211102","1783","5854","5850",統一-城中,20,0,20,1,4.65
"20211102","1783","1470","1470",台灣摩根士丹利,5,44,39,-1,9.07
"20211102","1783","0039003800390051","9800",元大-汐止,16,0,16,1,3.72
"20211102","1783","9268","9200",凱基-台北,10,41,31,-1,7.21
"20211102","1783","9319","9300",華南永昌-鶯歌,15,0,15,1,3.49
"20211102","1783","1520","1520",瑞士信貸,0,26,26,-1,6.05
"20211102","1783","0039003800390058","9800",元大-民生,15,0,15,1,3.49
"20211102","1783","1480","1480",美商高盛,0,21,21,-1,4.88
"20211102","1783","0039003800310053","9800",元大-崇德,10,0,10,1,2.33
"20211102","1783","1440","1440",美林,0,19,19,-1,4.42
"20211102","1783","0039004100390041","9A00",永豐金-羅東,10,0,10,1,2.33
"20211102","1783","1030","1030",土銀,0,19,19,-1,4.42
"20211102","1783","0039003600320056","9600",富邦-復興,8,0,8,1,1.86
"20211102","1783","9672","9600",富邦-員林,0,10,10,-1,2.33
"20211102","1783","9813","9800",元大-八德,11,3,8,1,1.86
"20211102","1783","0039004100380046","9A00",永豐金-敦南,1,10,9,-1,2.09
"20211102","1783","9867","9800",元大-北成功,8,0,8,1,1.86
"20211102","1783","0039003800300061","9800",元大-承德,0,7,7,-1,1.63
"20211102","1783","9238","9200",凱基-士林,9,2,7,1,1.63
"20211102","1783","0037003000300048","7000",兆豐-東門,1,7,6,-1,1.40
"20211102","1783","9859","9800",元大-新竹經國,7,1,6,1,1.40
"20211102","1783","8560","8560",新光,9,15,6,-1,1.40
"20211102","1783","1560","1560",港商野村,5,0,5,1,1.16
"20211102","1783","1029","1020",合庫-鳳山,0,5,5,-1,1.16
"20211102","1783","003500330038006a","5380",第一金-安和,5,0,5,1,1.16
"20211102","1783","1041","1040",臺銀-鳳山,2,6,4,-1,0.93
"20211103","1783","0031003000320043","1020",合庫-自強,10,0,10,1,4.95
"20211103","1783","1480","1480",美商高盛,1,20,19,-1,9.41
"20211103","1783","9326","9300",華南永昌-南京,10,0,10,1,4.95
"20211103","1783","8440","8440",摩根大通,2,13,11,-1,5.45
"20211103","1783","0037003700390050","7790",國票-九鼎,9,0,9,1,4.46
"20211103","1783","0039003100380044","9100",群益金鼎-東門,0,8,8,-1,3.96
"20211103","1783","5261","5260",美好-蘆洲,8,0,8,1,3.96
"20211103","1783","1030","1030",土銀,0,7,7,-1,3.47
"20211103","1783","0039003800310067","9800",元大-大里,8,0,8,1,3.96
"20211103","1783","9268","9200",凱基-台北,2,8,6,-1,2.97
"20211103","1783","0037003000300048","7000",兆豐-東門,6,0,6,1,2.97
"20211103","1783","5854","5850",統一-城中,0,5,5,-1,2.48
"20211103","1783","9239","9200",凱基-市政,5,0,5,1,2.48
"20211103","1783","9207","9200",凱基-永和,0,5,5,-1,2.48
"20211103","1783","9276","9200",凱基-苗栗,8,3,5,1,2.48
"20211103","1783","0039003800390058","9800",元大-民生,0,5,5,-1,2.48
"20211103","1783","9302","9300",華南永昌-台中,5,0,5,1,2.48
"20211103","1783","1440","1440",美林,1,5,4,-1,1.98
"20211103","1783","0039003800330057","9800",元大-大里德芳,10,5,5,1,2.48
"20211103","1783","9667","9600",富邦-台南,0,4,4,-1,1.98
"20211103","1783","0039003800390051","9800",元大-汐止,5,0,5,1,2.48
"20211103","1783","1560","1560",港商野村,0,3,3,-1,1.49
"20211103","1783","1520","1520",瑞士信貸,5,1,4,1,1.98
"20211103","1783","0037003000300063","7000",兆豐-民生,0,3,3,-1,1.49
"20211103","1783","003800380034004d","8840",玉山-數位,4,0,4,1,1.98
"20211103","1783","1470","1470",台灣摩根士丹利,1,3,2,-1,0.99
"20211103","1783","9891","9800",元大-永和,4,0,4,1,1.98
"20211103","1783","0035003300380050","5380",第一金-路竹,0,2,2,-1,0.99
"20211104","1783","8440","8440",摩根大通,39,5,34,1,13.39
"20211104","1783","9331","9300",華南永昌-鳳山,0,20,20,-1,7.87
"20211104","1783","6915","6910",德信-和平,15,0,15,1,5.91
"20211104","1783","6460","6460",大昌,0,15,15,-1,5.91
"20211104","1783","9268","9200",凱基-台北,18,6,12,1,4.72
"20211104","1783","9659","9600",富邦-高雄,0,13,13,-1,5.12
"20211104","1783","6168","6160",中國信託-嘉義,11,0,11,1,4.33
"20211104","1783","0039003800390051","9800",元大-汐止,0,11,11,-1,4.33
"20211104","1783","1030","1030",土銀,10,0,10,1,3.94
"20211104","1783","8459","8450",康和-嘉義,0,10,10,-1,3.94
"20211104","1783","1650","1650",新加坡商瑞銀,10,0,10,1,3.94
"20211104","1783","8882","8880",國泰-台中,0,10,10,-1,3.94
"20211104","1783","0039003200300041","9200",凱基-板橋,10,0,10,1,3.94
"20211104","1783","0031003000340044","1040",臺銀-金山,0,5,5,-1,1.97
"20211104","1783","9867","9800",元大-北成功,10,0,10,1,3.94
"20211104","1783","0035003800350046","5850",統一-彰化,0,4,4,-1,1.57
"20211104","1783","0036003000310064","6010",(牛牛牛)亞-鑫豐,7,0,7,1,2.76
"20211104","1783","8840","8840",玉山證券,0,4,4,-1,1.57
"20211104","1783","1440","1440",美林,10,4,6,1,2.36
"20211104","1783","9623","9600",富邦-台北,0,4,4,-1,1.57
"20211104","1783","0035003800350055","5850",統一-南京,6,0,6,1,2.36
"20211104","1783","1470","1470",台灣摩根士丹利,0,3,3,-1,1.18
"20211104","1783","6464","6460",大昌-新店,5,0,5,1,1.97
"20211104","1783","5265","5260",美好-苗栗,0,3,3,-1,1.18
"20211104","1783","0038003800340042","8840",玉山-台中,5,0,5,1,1.97
"20211104","1783","0035003900320062","5920",元富-板橋,0,3,3,-1,1.18
"20211104","1783","0037003000300070","7000",兆豐-復興,3,0,3,1,1.18
"20211104","1783","0035003900320050","5920",元富-同大,0,3,3,-1,1.18
"20211105","1783","5603","5600",永興-台中,22,0,22,1,11.22
"20211105","1783","5264","5260",美好-高雄,0,30,30,-1,15.31
"20211105","1783","003900410039004c","9A00",永豐金-台中,20,0,20,1,10.20
"20211105","1783","1560","1560",港商野村,0,18,18,-1,9.18
"20211105","1783","9268","9200",凱基-台北,24,5,19,1,9.69
"20211105","1783","9604","9600",富邦-陽明,0,15,15,-1,7.65
"20211105","1783","0037003000300048","7000",兆豐-東門,15,0,15,1,7.65
"20211105","1783","0039003600390043","9600",富邦-北港,0,15,15,-1,7.65
"20211105","1783","1650","1650",新加坡商瑞銀,8,0,8,1,4.08
"20211105","1783","1470","1470",台灣摩根士丹利,4,12,8,-1,4.08
"20211105","1783","0039003200300041","9200",凱基-板橋,6,0,6,1,3.06
"20211105","1783","1041","1040",臺銀-鳳山,0,5,5,-1,2.55
"20211105","1783","5261","5260",美好-蘆洲,5,0,5,1,2.55
"20211105","1783","003500390032005a","5920",元富-安南,0,5,5,-1,2.55
"20211105","1783","6168","6160",中國信託-嘉義,5,0,5,1,2.55
"20211105","1783","0037003000300077","7000",兆豐-新莊,0,5,5,-1,2.55
"20211105","1783","9105","9100",群益金鼎-高盛,5,0,5,1,2.55
"20211105","1783","1117","1110",台灣企銀-竹北,0,3,3,-1,1.53
"20211105","1783","9831","9800",元大-四維,5,0,5,1,2.55
"20211105","1783","0039003600310053","9600",富邦-景美,0,3,3,-1,1.53
"20211105","1783","0039003200320048","9200",凱基-復興,4,0,4,1,2.04
"20211105","1783","0035003900320041","5920",元富-緯城,0,3,3,-1,1.53
"20211105","1783","003900380039004a","9800",元大-彰化民生,4,0,4,1,2.04
"20211105","1783","8843","8840",玉山-高雄,0,2,2,-1,1.02
"20211105","1783","5265","5260",美好-苗栗,3,0,3,1,1.53
"20211105","1783","003900310038004d","9100",群益金鼎-嘉義,0,2,2,-1,1.02
"20211105","1783","8848","8840",玉山-嘉義,3,0,3,1,1.53
"20211105","1783","9207","9200",凱基-永和,0,2,2,-1,1.02
"20211108","1783","0039003800310053","9800",元大-崇德,30,0,30,1,11.32
"20211108","1783","9268","9200",凱基-台北,3,29,26,-1,9.81
"20211108","1783","1520","1520",瑞士信貸,21,0,21,1,7.92
"20211108","1783","6460","6460",大昌,0,20,20,-1,7.55
"20211108","1783","9874","9800",元大-雙和,13,0,13,1,4.91
"20211108","1783","8150","8150",台新證券,0,20,20,-1,7.55
"20211108","1783","003500320036004b","5260",美好-富順,10,0,10,1,3.77
"20211108","1783","9366","9300",華南永昌-豐原,0,20,20,-1,7.55
"20211108","1783","0039004100390043","9A00",永豐金-員林,9,0,9,1,3.40
"20211108","1783","1560","1560",港商野村,2,18,16,-1,6.04
"20211108","1783","0035003800350055","5850",統一-南京,8,0,8,1,3.02
"20211108","1783","1480","1480",美商高盛,0,15,15,-1,5.66
"20211108","1783","9255","9200",凱基-和平,8,0,8,1,3.02
"20211108","1783","0039003100380063","9100",群益金鼎-鳳山,0,6,6,-1,2.26
"20211108","1783","5261","5260",美好-蘆洲,5,0,5,1,1.89
"20211108","1783","0037003000300077","7000",兆豐-新莊,0,5,5,-1,1.89
"20211108","1783","9322","9300",華南永昌-公誠,5,0,5,1,1.89
"20211108","1783","9238","9200",凱基-士林,0,5,5,-1,1.89
"20211108","1783","003900410039004c","9A00",永豐金-台中,5,0,5,1,1.89
"20211108","1783","0039003800330057","9800",元大-大里德芳,0,5,5,-1,1.89
"20211108","1783","8886","8880",國泰-新莊,3,0,3,1,1.13
"20211108","1783","0039004100300030","9A00",永豐金證券,0,5,5,-1,1.89
"20211108","1783","0039003200300041","9200",凱基-板橋,3,0,3,1,1.13
"20211108","1783","6168","6160",中國信託-嘉義,0,4,4,-1,1.51
"20211108","1783","1650","1650",新加坡商瑞銀,4,2,2,1,0.75
"20211108","1783","0038003800380041","8880",國泰-館前,0,4,4,-1,1.51
"20211108","1783","1110","1110",台灣企銀,2,0,2,1,0.75
"20211108","1783","1440","1440",美林,3,6,3,-1,1.13
"20211109","1783","0035003800350055","5850",統一-南京,73,0,73,1,6.22
"20211109","1783","9302","9300",華南永昌-台中,0,76,76,-1,6.47
"20211109","1783","0039004100390031","9A00",永豐金-松山,72,0,72,1,6.13
"20211109","1783","0039003800390058","9800",元大-民生,0,42,42,-1,3.58
"20211109","1783","0039003200320048","9200",凱基-復興,60,0,60,1,5.11
"20211109","1783","0031003100310042","1110",台灣企銀-建成,0,35,35,-1,2.98
"20211109","1783","0039004100390037","9A00",永豐金-新竹,70,10,60,1,5.11
"20211109","1783","6460","6460",大昌,0,35,35,-1,2.98
"20211109","1783","0039003200300041","9200",凱基-板橋,55,0,55,1,4.68
"20211109","1783","1119","1110",台灣企銀-岡山,0,30,30,-1,2.56
"20211109","1783","1520","1520",瑞士信貸,51,0,51,1,4.34
"20211109","1783","9189","9100",群益金鼎-桃園,0,30,30,-1,2.56
"20211109","1783","1030","1030",土銀,48,2,46,1,3.92
"20211109","1783","9363","9300",華南永昌-彰化,0,29,29,-1,2.47
"20211109","1783","5856","5850",統一-台中,51,5,46,1,3.92
"20211109","1783","0039004100390043","9A00",永豐金-員林,0,27,27,-1,2.30
"20211109","1783","9205","9200",凱基-三重,45,0,45,1,3.83
"20211109","1783","9813","9800",元大-八德,0,24,24,-1,2.04
"20211109","1783","003500380035004a","5850",統一-三重,32,0,32,1,2.73
"20211109","1783","9255","9200",凱基-和平,0,21,21,-1,1.79
"20211109","1783","9333","9300",華南永昌-長虹,30,0,30,1,2.56
"20211109","1783","0039004100390041","9A00",永豐金-羅東,0,20,20,-1,1.70
"20211109","1783","9800","9800",元大證券,29,2,27,1,2.30
"20211109","1783","0039003200300044","9200",凱基-市府,0,18,18,-1,1.53
"20211109","1783","9268","9200",凱基-台北,69,46,23,1,1.96
"20211109","1783","9238","9200",凱基-士林,0,17,17,-1,1.45
"20211109","1783","003900310038004a","9100",群益金鼎-永和,20,0,20,1,1.70
"20211109","1783","1470","1470",台灣摩根士丹利,0,14,14,-1,1.19
"20211110","1783","0039004100390037","9A00",永豐金-新竹,172,2,170,1,6.06
"20211110","1783","8440","8440",摩根大通,72,296,224,-1,7.99
"20211110","1783","0037003000300048","7000",兆豐-東門,78,2,76,1,2.71
"20211110","1783","1650","1650",新加坡商瑞銀,0,191,191,-1,6.81
"20211110","1783","5854","5850",統一-城中,75,10,65,1,2.32
"20211110","1783","5850","5850",統一,1,90,89,-1,3.18
"20211110","1783","9831","9800",元大-四維,53,1,52,1,1.86
"20211110","1783","1520","1520",瑞士信貸,0,78,78,-1,2.78
"20211110","1783","9285","9200",凱基-中壢,50,0,50,1,1.78
"20211110","1783","0039004100390031","9A00",永豐金-松山,2,73,71,-1,2.53
"20211110","1783","9333","9300",華南永昌-長虹,39,0,39,1,1.39
"20211110","1783","1440","1440",美林,6,71,65,-1,2.32
"20211110","1783","0038003800340041","8840",玉山-士林,30,0,30,1,1.07
"20211110","1783","9268","9200",凱基-台北,129,191,62,-1,2.21
"20211110","1783","1560","1560",港商野村,68,43,25,1,0.89
"20211110","1783","0039003200320048","9200",凱基-復興,5,65,60,-1,2.14
"20211110","1783","9867","9800",元大-北成功,21,0,21,1,0.75
"20211110","1783","0039003200300041","9200",凱基-板橋,0,55,55,-1,1.96
"20211110","1783","0038003800340042","8840",玉山-台中,35,15,20,1,0.71
"20211110","1783","5856","5850",統一-台中,5,51,46,-1,1.64
"20211110","1783","0039003100330059","9100",群益金鼎-館前,20,0,20,1,0.71
"20211110","1783","1030","1030",土銀,4,48,44,-1,1.57
"20211110","1783","0039003800310072","9800",元大-屏南,20,0,20,1,0.71
"20211110","1783","9205","9200",凱基-三重,1,45,44,-1,1.57
"20211110","1783","7006","7000",兆豐-台南,19,0,19,1,0.68
"20211110","1783","1480","1480",美商高盛,7,37,30,-1,1.07
"20211110","1783","5603","5600",永興-台中,18,0,18,1,0.64
"20211110","1783","5264","5260",美好-高雄,0,30,30,-1,1.07
"20211111","1783","0039003800390047","9800",元大-大同,231,0,231,1,8.22
"20211111","1783","5854","5850",統一-城中,0,120,120,-1,4.27
"20211111","1783","8880","8880",國泰證券,200,0,200,1,7.12
"20211111","1783","1470","1470",台灣摩根士丹利,13,94,81,-1,2.88
"20211111","1783","9834","9800",元大-中壢,203,12,191,1,6.80
"20211111","1783","0035003800350055","5850",統一-南京,73,144,71,-1,2.53
"20211111","1783","9135","9100",群益金鼎-東大,115,0,115,1,4.09
"20211111","1783","9614","9600",富邦-基隆,0,57,57,-1,2.03
"20211111","1783","5850","5850",統一,86,1,85,1,3.03
"20211111","1783","0039003800390058","9800",元大-民生,1,57,56,-1,1.99
"20211111","1783","9204","9200",凱基-台中,73,5,68,1,2.42
"20211111","1783","0031003100310042","1110",台灣企銀-建成,0,42,42,-1,1.50
"20211111","1783","8560","8560",新光,68,27,41,1,1.46
"20211111","1783","9255","9200",凱基-和平,0,38,38,-1,1.35
"20211111","1783","9831","9800",元大-四維,39,4,35,1,1.25
"20211111","1783","9105","9100",群益金鼎-高盛,0,35,35,-1,1.25
"20211111","1783","0039003800390041","9800",元大-北投,51,16,35,1,1.25
"20211111","1783","6161","6160",中國信託-三重,0,30,30,-1,1.07
"20211111","1783","6162","6160",中國信託-忠孝,36,6,30,1,1.07
"20211111","1783","9319","9300",華南永昌-鶯歌,0,30,30,-1,1.07
"20211111","1783","0039004100390057","9A00",永豐金-市政,41,11,30,1,1.07
"20211111","1783","0039003600320056","9600",富邦-復興,5,30,25,-1,0.89
"20211111","1783","003100320036004c","1260",宏遠-台中,24,0,24,1,0.85
"20211111","1783","0039004100390037","9A00",永豐金-新竹,0,25,25,-1,0.89
"20211111","1783","1028","1020",合庫-彰化,29,8,21,1,0.75
"20211111","1783","6460","6460",大昌,14,38,24,-1,0.85
"20211111","1783","9838","9800",元大-豐原,20,0,20,1,0.71
"20211111","1783","5384","5380",第一金-台南,0,22,22,-1,0.78
"20211112","1783","5850","5850",統一,90,20,70,1,4.08
"20211112","1783","9268","9200",凱基-台北,98,235,137,-1,7.98
"20211112","1783","0039004100390043","9A00",永豐金-員林,51,8,43,1,2.50
"20211112","1783","1470","1470",台灣摩根士丹利,6,109,103,-1,6.00
"20211112","1783","0035003800350055","5850",統一-南京,49,16,33,1,1.92
"20211112","1783","8440","8440",摩根大通,58,152,94,-1,5.47
"20211112","1783","9854","9800",元大-文心興安,31,0,31,1,1.81
"20211112","1783","6162","6160",中國信託-忠孝,0,25,25,-1,1.46
"20211112","1783","0039003100380050","9100",群益金鼎-天母,29,0,29,1,1.69
"20211112","1783","1560","1560",港商野村,3,23,20,-1,1.16
"20211112","1783","0039003800390041","9800",元大-北投,21,0,21,1,1.22
"20211112","1783","9838","9800",元大-豐原,0,20,20,-1,1.16
"20211112","1783","0037003000300068","7000",兆豐-三民,20,0,20,1,1.16
"20211112","1783","9333","9300",華南永昌-長虹,7,26,19,-1,1.11
"20211112","1783","0035003900320045","5920",元富-城中,20,0,20,1,1.16
"20211112","1783","5854","5850",統一-城中,36,53,17,-1,0.99
"20211112","1783","0039004100390078","9A00",永豐金-桃園,19,1,18,1,1.05
"20211112","1783","003700300030004a","7000",兆豐-公益,0,15,15,-1,0.87
"20211112","1783","8560","8560",新光,25,9,16,1,0.93
"20211112","1783","0039003800390058","9800",元大-民生,1,15,14,-1,0.82
"20211112","1783","6380","6380",光和,15,0,15,1,0.87
"20211112","1783","1028","1020",合庫-彰化,4,15,11,-1,0.64
"20211112","1783","0039003600310043","9600",富邦-南京,21,6,15,1,0.87
"20211112","1783","1040","1040",臺銀,0,10,10,-1,0.58
"20211112","1783","9278","9200",凱基-永康,17,4,13,1,0.76
"20211112","1783","1440","1440",美林,9,19,10,-1,0.58
"20211112","1783","0035003900320071","5920",元富-屏東,11,0,11,1,0.64
"20211112","1783","5265","5260",美好-苗栗,1,9,8,-1,0.47
"20211115","1783","8888","8880",國泰-敦南,46,8,38,1,3.20
"20211115","1783","5850","5850",統一,10,66,56,-1,4.72
"20211115","1783","0037003000300048","7000",兆豐-東門,42,10,32,1,2.70
"20211115","1783","1650","1650",新加坡商瑞銀,2,51,49,-1,4.13
"20211115","1783","0039004100390043","9A00",永豐金-員林,43,17,26,1,2.19
"20211115","1783","5854","5850",統一-城中,0,37,37,-1,3.12
"20211115","1783","9874","9800",元大-雙和,22,0,22,1,1.85
"20211115","1783","1470","1470",台灣摩根士丹利,12,44,32,-1,2.70
"20211115","1783","0038003400350041","8450",康和-內湖,20,0,20,1,1.69
"20211115","1783","0036003000310064","6010",(牛牛牛)亞-鑫豐,2,34,32,-1,2.70
"20211115","1783","9359","9300",華南永昌-中正,20,0,20,1,1.69
"20211115","1783","0039004100390061","9A00",永豐金-苓雅,0,31,31,-1,2.61
"20211115","1783","0039004100360039","9A00",永豐金-屏東,19,0,19,1,1.60
"20211115","1783","8440","8440",摩根大通,11,37,26,-1,2.19
"20211115","1783","0039003100330059","9100",群益金鼎-館前,18,2,16,1,1.35
"20211115","1783","0037003700390058","7790",國票-中和,0,20,20,-1,1.69
"20211115","1783","5320","5320",高橋,12,0,12,1,1.01
"20211115","1783","9333","9300",華南永昌-長虹,5,21,16,-1,1.35
"20211115","1783","6460","6460",大昌,12,0,12,1,1.01
"20211115","1783","9813","9800",元大-八德,0,15,15,-1,1.26
"20211115","1783","9856","9800",元大-花蓮,11,0,11,1,0.93
"20211115","1783","1440","1440",美林,9,22,13,-1,1.10
"20211115","1783","8560","8560",新光,14,4,10,1,0.84
"20211115","1783","5603","5600",永興-台中,10,23,13,-1,1.10
"20211115","1783","1260","1260",宏遠證券,12,2,10,1,0.84
"20211115","1783","0039003200310053","9200",凱基-幸福,0,10,10,-1,0.84
"20211115","1783","7000","7000",兆豐證券,10,0,10,1,0.84
"20211115","1783","0039003800310052","9800",元大-竹山,0,10,10,-1,0.84
"20211021","1783","0039003800310053","9800",元大-崇德,34,0,34,1,10.33
"20211021","1783","0039003600310057","9600",富邦-東花蓮,0,22,22,-1,6.69
"20211021","1783","003700300030004e","7000",兆豐-埔墘,13,0,13,1,3.95
"20211021","1783","9331","9300",華南永昌-鳳山,1,22,21,-1,6.38
"20211021","1783","0035003900320055","5920",元富-宜蘭,10,0,10,1,3.04
"20211021","1783","5854","5850",統一-城中,1,20,19,-1,5.78
"20211021","1783","003900380039004a","9800",元大-彰化民生,10,0,10,1,3.04
"20211021","1783","0039003800330057","9800",元大-大里德芳,0,10,10,-1,3.04
"20211021","1783","1560","1560",港商野村,23,14,9,1,2.74
"20211021","1783","0039004100390043","9A00",永豐金-員林,1,8,7,-1,2.13
"20211021","1783","1480","1480",美商高盛,20,14,6,1,1.82
"20211021","1783","0035003900320064","5920",元富-延平(停),0,5,5,-1,1.52
"20211021","1783","6161","6160",中國信託-三重,6,0,6,1,1.82
"20211021","1783","8440","8440",摩根大通,13,18,5,-1,1.52
"20211021","1783","0031003000340043","1040",臺銀-高雄,5,0,5,1,1.52
"20211021","1783","9857","9800",元大-東蘆,0,5,5,-1,1.52
"20211021","1783","9319","9300",華南永昌-鶯歌,5,0,5,1,1.52
"20211021","1783","2180","2180",亞東,1,5,4,-1,1.22
"20211021","1783","9658","9600",富邦-建國,5,0,5,1,1.52
"20211021","1783","1115","1110",台灣企銀-太平,0,4,4,-1,1.22
"20211021","1783","9834","9800",元大-中壢,5,0,5,1,1.52
"20211021","1783","0035003900320044","5920",元富-大昌,0,4,4,-1,1.22
"20211021","1783","0039003800390058","9800",元大-民生,10,5,5,1,1.52
"20211021","1783","0036003000310064","6010",(牛牛牛)亞-鑫豐,1,5,4,-1,1.22
"20211021","1783","003900380030006c","9800",元大-虎尾,4,0,4,1,1.22
"20211021","1783","8380","8380",安泰,0,4,4,-1,1.22
"20211021","1783","6450","6450",永全證券,3,0,3,1,0.91
"20211021","1783","0039004100390048","9A00",永豐金-新莊,0,4,4,-1,1.22
"20211018","1783","1440","1440",美林,46,5,41,1,5.09
"20211018","1783","5857","5850",統一-新竹,2,42,40,-1,4.97
"20211018","1783","8440","8440",摩根大通,69,33,36,1,4.47
"20211018","1783","1520","1520",瑞士信貸,0,34,34,-1,4.22
"20211018","1783","9858","9800",元大-龍潭,30,0,30,1,3.73
"20211018","1783","5854","5850",統一-城中,20,52,32,-1,3.98
"20211018","1783","1650","1650",新加坡商瑞銀,22,0,22,1,2.73
"20211018","1783","0038003800340045","8840",玉山-城中,0,25,25,-1,3.11
"20211018","1783","8150","8150",台新證券,22,1,21,1,2.61
"20211018","1783","6460","6460",大昌,0,20,20,-1,2.48
"20211018","1783","9205","9200",凱基-三重,20,0,20,1,2.48
"20211018","1783","9308","9300",華南永昌-麻豆,0,14,14,-1,1.74
"20211018","1783","1480","1480",美商高盛,32,14,18,1,2.24
"20211018","1783","0039004100390043","9A00",永豐金-員林,0,14,14,-1,1.74
"20211018","1783","1470","1470",台灣摩根士丹利,27,11,16,1,1.99
"20211018","1783","0031003200360055","1260",宏遠-館前,0,10,10,-1,1.24
"20211018","1783","6915","6910",德信-和平,15,0,15,1,1.86
"20211018","1783","0035003800350046","5850",統一-彰化,0,10,10,-1,1.24
"20211018","1783","003900380039004a","9800",元大-彰化民生,13,0,13,1,1.61
"20211018","1783","0039003100380045","9100",群益金鼎-南京,0,10,10,-1,1.24
"20211018","1783","0035003800350055","5850",統一-南京,12,0,12,1,1.49
"20211018","1783","9238","9200",凱基-士林,12,22,10,-1,1.24
"20211018","1783","1040","1040",臺銀,10,0,10,1,1.24
"20211018","1783","9278","9200",凱基-永康,0,10,10,-1,1.24
"20211018","1783","9307","9300",華南永昌-大安,10,0,10,1,1.24
"20211018","1783","0039003800390058","9800",元大-民生,10,20,10,-1,1.24
"20211018","1783","003900380039005a","9800",元大-小港,10,0,10,1,1.24
"20211018","1783","9268","9200",凱基-台北,28,37,9,-1,1.12
"20211019","1783","0039004100390043","9A00",永豐金-員林,14,0,14,1,3.92
"20211019","1783","8440","8440",摩根大通,2,45,43,-1,12.04
"20211019","1783","6460","6460",大昌,13,0,13,1,3.64
"20211019","1783","1440","1440",美林,1,36,35,-1,9.80
"20211019","1783","6161","6160",中國信託-三重,12,1,11,1,3.08
"20211019","1783","1480","1480",美商高盛,4,24,20,-1,5.60
"20211019","1783","0035003800350046","5850",統一-彰化,10,0,10,1,2.80
"20211019","1783","9205","9200",凱基-三重,0,20,20,-1,5.60
"20211019","1783","0035003800350055","5850",統一-南京,10,0,10,1,2.80
"20211019","1783","9879","9800",元大-板橋三民,0,13,13,-1,3.64
"20211019","1783","9235","9200",凱基-永華,10,0,10,1,2.80
"20211019","1783","0039003800320042","9800",元大-博愛,3,15,12,-1,3.36
"20211019","1783","9813","9800",元大-八德,13,3,10,1,2.80
"20211019","1783","8157","8150",台新-左楠,0,7,7,-1,1.96
"20211019","1783","5854","5850",統一-城中,10,1,9,1,2.52
"20211019","1783","0038003100350042","8150",台新-台中,0,6,6,-1,1.68
"20211019","1783","9268","9200",凱基-台北,18,9,9,1,2.52
"20211019","1783","0037003000300077","7000",兆豐-新莊,0,5,5,-1,1.40
"20211019","1783","5603","5600",永興-台中,9,1,8,1,2.24
"20211019","1783","003900380030006c","9800",元大-虎尾,0,5,5,-1,1.40
"20211019","1783","0039003100380044","9100",群益金鼎-東門,6,0,6,1,1.68
"20211019","1783","0039004100300030","9A00",永豐金證券,0,4,4,-1,1.12
"20211019","1783","9297","9200",凱基-文心,6,0,6,1,1.68
"20211019","1783","1040","1040",臺銀,0,2,2,-1,0.56
"20211019","1783","9302","9300",華南永昌-台中,5,0,5,1,1.40
"20211019","1783","003500390032006e","5920",元富-西松,0,2,2,-1,0.56
"20211019","1783","0039003800390058","9800",元大-民生,5,0,5,1,1.40
"20211019","1783","8150","8150",台新證券,1,3,2,-1,0.56
"20211020","1783","6161","6160",中國信託-三重,12,0,12,1,7.74
"20211020","1783","7080","7080",石橋證券,0,15,15,-1,9.68
"20211020","1783","9686","9600",富邦-宜蘭,9,0,9,1,5.81
"20211020","1783","003900320030004e","9200",凱基-湖口,0,7,7,-1,4.52
"20211020","1783","9268","9200",凱基-台北,10,3,7,1,4.52
"20211020","1783","9329","9300",華南永昌-朴子,0,5,5,-1,3.23
"20211020","1783","1480","1480",美商高盛,8,3,5,1,3.23
"20211020","1783","0039003800390050","9800",元大-敦南,0,5,5,-1,3.23
"20211020","1783","9319","9300",華南永昌-鶯歌,5,0,5,1,3.23
"20211020","1783","0035003900320043","5920",元富-潮州,0,4,4,-1,2.58
"20211020","1783","0039003800320042","9800",元大-博愛,5,0,5,1,3.23
"20211020","1783","0039004100390050","9A00",永豐金-竹北,0,4,4,-1,2.58
"20211020","1783","003900380030006c","9800",元大-虎尾,4,0,4,1,2.58
"20211020","1783","1560","1560",港商野村,0,3,3,-1,1.94
"20211020","1783","1440","1440",美林,6,3,3,1,1.94
"20211020","1783","5921","5920",元富-高雄,0,3,3,-1,1.94
"20211020","1783","0031003000320041","1020",合庫-新竹,3,0,3,1,1.94
"20211020","1783","8157","8150",台新-左楠,0,3,3,-1,1.94
"20211020","1783","0037003000300058","7000",兆豐-永和,5,2,3,1,1.94
"20211020","1783","0039003800320041","9800",元大-羅東,0,3,3,-1,1.94
"20211020","1783","9215","9200",凱基-高美館,3,0,3,1,1.94
"20211020","1783","8560","8560",新光,1,3,2,-1,1.29
"20211020","1783","0039003800390043","9800",元大-板橋,3,0,3,1,1.94
"20211020","1783","5265","5260",美好-苗栗,0,2,2,-1,1.29
"20211020","1783","5381","5380",第一金-員林,2,0,2,1,1.29
"20211020","1783","1043","1040",臺銀-民權,0,2,2,-1,1.29
"20211020","1783","003600310036004b","6160",中國信託-高雄,2,0,2,1,1.29
"20211020","1783","0039003100330049","9100",群益金鼎-萬華,0,2,2,-1,1.29
"20211022","1783","5854","5850",統一-城中,25,0,25,1,5.24
"20211022","1783","9863","9800",元大-和平,0,24,24,-1,5.03
"20211022","1783","5921","5920",元富-高雄,20,0,20,1,4.19
"20211022","1783","8440","8440",摩根大通,0,22,22,-1,4.61
"20211022","1783","6168","6160",中國信託-嘉義,15,0,15,1,3.14
"20211022","1783","1440","1440",美林,3,24,21,-1,4.40
"20211022","1783","0039003800390058","9800",元大-民生,15,0,15,1,3.14
"20211022","1783","1520","1520",瑞士信貸,0,21,21,-1,4.40
"20211022","1783","9813","9800",元大-八德,14,1,13,1,2.73
"20211022","1783","5264","5260",美好-高雄,0,20,20,-1,4.19
"20211022","1783","6915","6910",德信-和平,10,0,10,1,2.10
"20211022","1783","1560","1560",港商野村,5,25,20,-1,4.19
"20211022","1783","0039003100380045","9100",群益金鼎-南京,10,0,10,1,2.10
"20211022","1783","0038003100350042","8150",台新-台中,0,20,20,-1,4.19
"20211022","1783","9316","9300",華南永昌-淡水,10,0,10,1,2.10
"20211022","1783","9266","9200",凱基-新豐,0,20,20,-1,4.19
"20211022","1783","003900380033004d","9800",元大-木柵,10,0,10,1,2.10
"20211022","1783","0035003800350055","5850",統一-南京,0,15,15,-1,3.14
"20211022","1783","0039004100390043","9A00",永豐金-員林,18,9,9,1,1.89
"20211022","1783","1470","1470",台灣摩根士丹利,12,23,11,-1,2.31
"20211022","1783","9238","9200",凱基-士林,10,2,8,1,1.68
"20211022","1783","8586","8580",聯邦-大業,0,10,10,-1,2.10
"20211022","1783","9852","9800",元大-永春,8,0,8,1,1.68
"20211022","1783","9307","9300",華南永昌-大安,0,10,10,-1,2.10
"20211022","1783","9215","9200",凱基-高美館,6,0,6,1,1.26
"20211022","1783","003900380039005a","9800",元大-小港,0,10,10,-1,2.10
"20211022","1783","9255","9200",凱基-和平,6,0,6,1,1.26
"20211022","1783","1480","1480",美商高盛,6,15,9,-1,1.89
"20211025","1783","9268","9200",凱基-台北,46,20,26,1,6.97
"20211025","1783","9858","9800",元大-龍潭,0,30,30,-1,8.04
"20211025","1783","9658","9600",富邦-建國,20,0,20,1,5.36
"20211025","1783","1030","1030",土銀,0,27,27,-1,7.24
"20211025","1783","1520","1520",瑞士信貸,17,0,17,1,4.56
"20211025","1783","9366","9300",華南永昌-豐原,0,20,20,-1,5.36
"20211025","1783","0039003800310053","9800",元大-崇德,16,0,16,1,4.29
"20211025","1783","0039003800300065","9800",元大-清水,0,20,20,-1,5.36
"20211025","1783","1480","1480",美商高盛,11,1,10,1,2.68
"20211025","1783","5660","5660",日進,0,10,10,-1,2.68
"20211025","1783","1560","1560",港商野村,13,3,10,1,2.68
"20211025","1783","0039004100390043","9A00",永豐金-員林,6,16,10,-1,2.68
"20211025","1783","1650","1650",新加坡商瑞銀,8,0,8,1,2.14
"20211025","1783","0039003800320041","9800",元大-羅東,0,7,7,-1,1.88
"20211025","1783","1440","1440",美林,12,5,7,1,1.88
"20211025","1783","0039003800310041","9800",元大-鶯歌,0,6,6,-1,1.61
"20211025","1783","9867","9800",元大-北成功,6,0,6,1,1.61
"20211025","1783","0035003300380050","5380",第一金-路竹,0,5,5,-1,1.34
"20211025","1783","5854","5850",統一-城中,10,5,5,1,1.34
"20211025","1783","0035003800350055","5850",統一-南京,0,5,5,-1,1.34
"20211025","1783","5920","5920",元富,5,0,5,1,1.34
"20211025","1783","0039004100380046","9A00",永豐金-敦南,0,5,5,-1,1.34
"20211025","1783","0039003600310043","9600",富邦-南京,5,0,5,1,1.34
"20211025","1783","0035003800350050","5850",統一-板橋,0,4,4,-1,1.07
"20211025","1783","9834","9800",元大-中壢,5,0,5,1,1.34
"20211025","1783","5928","5920",元富-新莊,0,4,4,-1,1.07
"20211025","1783","0039003800390058","9800",元大-民生,10,5,5,1,1.34
"20211025","1783","0039003600310048","9600",富邦-新板,0,4,4,-1,1.07
"20211026","1783","1480","1480",美商高盛,14,0,14,1,5.81
"20211026","1783","0031003000340043","1040",臺銀-高雄,0,13,13,-1,5.39
"20211026","1783","1560","1560",港商野村,17,4,13,1,5.39
"20211026","1783","9229","9200",凱基-中山,0,10,10,-1,4.15
"20211026","1783","1440","1440",美林,17,5,12,1,4.98
"20211026","1783","9875","9800",元大-土城永寧,0,10,10,-1,4.15
"20211026","1783","6163","6160",中國信託-永康,10,0,10,1,4.15
"20211026","1783","9300","9300",華南永昌,0,6,6,-1,2.49
"20211026","1783","0039003200300044","9200",凱基-市府,9,2,7,1,2.90
"20211026","1783","9363","9300",華南永昌-彰化,0,5,5,-1,2.07
"20211026","1783","9658","9600",富邦-建國,10,3,7,1,2.90
"20211026","1783","5854","5850",統一-城中,5,10,5,-1,2.07
"20211026","1783","1028","1020",合庫-彰化,5,0,5,1,2.07
"20211026","1783","0037003000300052","7000",兆豐-小港,0,5,5,-1,2.07
"20211026","1783","1520","1520",瑞士信貸,6,1,5,1,2.07
"20211026","1783","0039003800310072","9800",元大-屏南,0,5,5,-1,2.07
"20211026","1783","6114","6110",台中銀-員林,5,0,5,1,2.07
"20211026","1783","0039003800390058","9800",元大-民生,5,10,5,-1,2.07
"20211026","1783","003900380031006d","9800",元大-前金,5,0,5,1,2.07
"20211026","1783","0035003900320050","5920",元富-同大,1,5,4,-1,1.66
"20211026","1783","1590","1590",花旗環球,4,0,4,1,1.66
"20211026","1783","0039004100380039","9A00",永豐金-敦北,0,4,4,-1,1.66
"20211026","1783","9831","9800",元大-四維,4,0,4,1,1.66
"20211026","1783","1030","1030",土銀,0,3,3,-1,1.24
"20211026","1783","003900380039004a","9800",元大-彰化民生,4,0,4,1,1.66
"20211026","1783","8560","8560",新光,0,3,3,-1,1.24
"20211026","1783","0038003100350042","8150",台新-台中,3,0,3,1,1.24
"20211026","1783","9237","9200",凱基-敦北,0,3,3,-1,1.24
"20211027","1783","1470","1470",台灣摩根士丹利,17,0,17,1,5.67
"20211027","1783","9366","9300",華南永昌-豐原,0,20,20,-1,6.67
"20211027","1783","9268","9200",凱基-台北,36,24,12,1,4.00
"20211027","1783","0039004100390043","9A00",永豐金-員林,3,20,17,-1,5.67
"20211027","1783","5603","5600",永興-台中,10,0,10,1,3.33
"20211027","1783","0039003800390065","9800",元大-中和,0,15,15,-1,5.00
"20211027","1783","6380","6380",光和,9,0,9,1,3.00
"20211027","1783","1030","1030",土銀,0,14,14,-1,4.67
"20211027","1783","0039003200300044","9200",凱基-市府,9,0,9,1,3.00
"20211027","1783","9206","9200",凱基-高雄,0,11,11,-1,3.67
"20211027","1783","9889","9800",元大-員林,8,0,8,1,2.67
"20211027","1783","1520","1520",瑞士信貸,0,8,8,-1,2.67
"20211027","1783","1650","1650",新加坡商瑞銀,6,0,6,1,2.00
"20211027","1783","6168","6160",中國信託-嘉義,0,7,7,-1,2.33
"20211027","1783","0039003200300056","9200",凱基-新店,6,0,6,1,2.00
"20211027","1783","5265","5260",美好-苗栗,2,8,6,-1,2.00
"20211027","1783","1440","1440",美林,20,15,5,1,1.67
"20211027","1783","9814","9800",元大-大益,0,5,5,-1,1.67
"20211027","1783","5926","5920",元富-四維(停),5,0,5,1,1.67
"20211027","1783","0039003800320042","9800",元大-博愛,1,6,5,-1,1.67
"20211027","1783","6464","6460",大昌-新店,5,0,5,1,1.67
"20211027","1783","0039004100390047","9A00",永豐金-天母,0,4,4,-1,1.33
"20211027","1783","7006","7000",兆豐-台南,5,0,5,1,1.67
"20211027","1783","5262","5260",美好-楊梅,0,3,3,-1,1.00
"20211027","1783","9238","9200",凱基-士林,5,0,5,1,1.67
"20211027","1783","5320","5320",高橋,1,4,3,-1,1.00
"20211027","1783","9302","9300",華南永昌-台中,5,0,5,1,1.67
"20211027","1783","9331","9300",華南永昌-鳳山,0,3,3,-1,1.00
"20211028","1783","1480","1480",美商高盛,26,0,26,1,9.15
"20211028","1783","9268","9200",凱基-台北,3,22,19,-1,6.69
"20211028","1783","9319","9300",華南永昌-鶯歌,15,0,15,1,5.28
"20211028","1783","0035003800350055","5850",統一-南京,0,17,17,-1,5.99
"20211028","1783","1560","1560",港商野村,13,2,11,1,3.87
"20211028","1783","0039003100380057","9100",群益金鼎-忠孝,0,11,11,-1,3.87
"20211028","1783","7034","7030",致和-金華,10,0,10,1,3.52
"20211028","1783","1030","1030",土銀,0,10,10,-1,3.52
"20211028","1783","0039003600310043","9600",富邦-南京,8,0,8,1,2.82
"20211028","1783","6163","6160",中國信託-永康,0,10,10,-1,3.52
"20211028","1783","1440","1440",美林,10,3,7,1,2.46
"20211028","1783","5854","5850",統一-城中,5,10,5,-1,1.76
"20211028","1783","1470","1470",台灣摩根士丹利,15,9,6,1,2.11
"20211028","1783","0035003900320064","5920",元富-延平(停),0,5,5,-1,1.76
"20211028","1783","0031003200360055","1260",宏遠-館前,5,0,5,1,1.76
"20211028","1783","5962","5960",日茂-南投,0,5,5,-1,1.76
"20211028","1783","8380","8380",安泰,5,0,5,1,1.76
"20211028","1783","6464","6460",大昌-新店,0,5,5,-1,1.76
"20211028","1783","1520","1520",瑞士信貸,10,6,4,1,1.41
"20211028","1783","8847","8840",玉山-台南,0,5,5,-1,1.76
"20211028","1783","8440","8440",摩根大通,11,7,4,1,1.41
"20211028","1783","9884","9800",元大-斗信,0,5,5,-1,1.76
"20211028","1783","8563","8560",新光-新竹,5,1,4,1,1.41
"20211028","1783","1043","1040",臺銀-民權,0,4,4,-1,1.41
"20211028","1783","9238","9200",凱基-士林,14,10,4,1,1.41
"20211028","1783","5320","5320",高橋,1,5,4,-1,1.41
"20211028","1783","0039003800390043","9800",元大-板橋,4,0,4,1,1.41
"20211028","1783","003900310038004d","9100",群益金鼎-嘉義,0,4,4,-1,1.41
"20211029","1783","6163","6160",中國信託-永康,15,0,15,1,4.18
"20211029","1783","9268","9200",凱基-台北,4,44,40,-1,11.14
"20211029","1783","1650","1650",新加坡商瑞銀,13,0,13,1,3.62
"20211029","1783","1440","1440",美林,0,36,36,-1,10.03
"20211029","1783","9859","9800",元大-新竹經國,12,0,12,1,3.34
"20211029","1783","1470","1470",台灣摩根士丹利,1,35,34,-1,9.47
"20211029","1783","5854","5850",統一-城中,10,0,10,1,2.79
"20211029","1783","9206","9200",凱基-高雄,0,23,23,-1,6.41
"20211029","1783","6460","6460",大昌,10,0,10,1,2.79
"20211029","1783","1030","1030",土銀,0,20,20,-1,5.57
"20211029","1783","8440","8440",摩根大通,21,11,10,1,2.79
"20211029","1783","0038003100350059","8150",台新-新營,0,12,12,-1,3.34
"20211029","1783","9302","9300",華南永昌-台中,10,0,10,1,2.79
"20211029","1783","8888","8880",國泰-敦南,0,11,11,-1,3.06
"20211029","1783","0039003800310053","9800",元大-崇德,10,0,10,1,2.79
"20211029","1783","003500380035004d","5850",統一-士林,0,10,10,-1,2.79
"20211029","1783","0039003800390058","9800",元大-民生,10,0,10,1,2.79
"20211029","1783","9889","9800",元大-員林,0,8,8,-1,2.23
"20211029","1783","9237","9200",凱基-敦北,9,0,9,1,2.51
"20211029","1783","003900380039006a","9800",元大-樹林,0,8,8,-1,2.23
"20211029","1783","9867","9800",元大-北成功,8,0,8,1,2.23
"20211029","1783","0037003700390056","7790",國票-天祥,0,7,7,-1,1.95
"20211029","1783","0036003000310064","6010",(牛牛牛)亞-鑫豐,7,0,7,1,1.95
"20211029","1783","1480","1480",美商高盛,0,6,6,-1,1.67
"20211029","1783","0039003600310043","9600",富邦-南京,7,0,7,1,1.95
"20211029","1783","1040","1040",臺銀,0,5,5,-1,1.39
"20211029","1783","0031003000320045","1020",合庫-桃園,5,0,5,1,1.39
"20211029","1783","0035003800350059","5850",統一-土城,0,5,5,-1,1.39
"20211001","1783","9366","9300",華南永昌-豐原,90,0,90,1,7.15
"20211001","1783","7031","7030",致和-台北,0,80,80,-1,6.35
"20211001","1783","1480","1480",美商高盛,94,19,75,1,5.96
"20211001","1783","0035003800350055","5850",統一-南京,5,76,71,-1,5.64
"20211001","1783","9268","9200",凱基-台北,108,51,57,1,4.53
"20211001","1783","7003","7000",兆豐-台中,3,70,67,-1,5.32
"20211001","1783","0039003800390064","9800",元大-北屯,55,0,55,1,4.37
"20211001","1783","0039003100330044","9100",群益金鼎-潭子,0,67,67,-1,5.32
"20211001","1783","5854","5850",統一-城中,45,5,40,1,3.18
"20211001","1783","8849","8840",玉山-景美,0,40,40,-1,3.18
"20211001","1783","0039003800390058","9800",元大-民生,45,6,39,1,3.10
"20211001","1783","0039003100380050","9100",群益金鼎-天母,0,35,35,-1,2.78
"20211001","1783","1650","1650",新加坡商瑞銀,43,13,30,1,2.38
"20211001","1783","9131","9100",群益金鼎-民權,1,24,23,-1,1.83
"20211001","1783","0039003600320056","9600",富邦-復興,28,0,28,1,2.22
"20211001","1783","0039003800390050","9800",元大-敦南,0,17,17,-1,1.35
"20211001","1783","0039004100390043","9A00",永豐金-員林,22,0,22,1,1.75
"20211001","1783","0038003800380041","8880",國泰-館前,1,17,16,-1,1.27
"20211001","1783","9225","9200",凱基-內埔,11,0,11,1,0.87
"20211001","1783","9859","9800",元大-新竹經國,0,16,16,-1,1.27
"20211001","1783","1470","1470",台灣摩根士丹利,19,9,10,1,0.79
"20211001","1783","9276","9200",凱基-苗栗,9,23,14,-1,1.11
"20211001","1783","9352","9300",華南永昌-桃園,10,0,10,1,0.79
"20211001","1783","0037003700390065","7790",國票-南科,1,12,11,-1,0.87
"20211001","1783","1560","1560",港商野村,70,61,9,1,0.71
"20211001","1783","8560","8560",新光,7,18,11,-1,0.87
"20211001","1783","0039004100390037","9A00",永豐金-新竹,9,0,9,1,0.71
"20211001","1783","0039003600320059","9600",富邦-土城,0,11,11,-1,0.87
"20211004","1783","8440","8440",摩根大通,136,13,123,1,9.85
"20211004","1783","9884","9800",元大-斗信,0,57,57,-1,4.56
"20211004","1783","9268","9200",凱基-台北,134,40,94,1,7.53
"20211004","1783","1650","1650",新加坡商瑞銀,19,74,55,-1,4.40
"20211004","1783","1480","1480",美商高盛,95,5,90,1,7.21
"20211004","1783","1040","1040",臺銀,0,20,20,-1,1.60
"20211004","1783","0039003100330044","9100",群益金鼎-潭子,30,3,27,1,2.16
"20211004","1783","6912","6910",德信-中正,1,21,20,-1,1.60
"20211004","1783","9667","9600",富邦-台南,11,1,10,1,0.80
"20211004","1783","0039003200320048","9200",凱基-復興,0,18,18,-1,1.44
"20211004","1783","9276","9200",凱基-苗栗,13,5,8,1,0.64
"20211004","1783","9661","9600",富邦-新店,0,17,17,-1,1.36
"20211004","1783","9822","9800",元大-土城學府,10,4,6,1,0.48
"20211004","1783","1560","1560",港商野村,51,66,15,-1,1.20
"20211004","1783","9898","9800",元大-新莊,6,0,6,1,0.48
"20211004","1783","0039004100390043","9A00",永豐金-員林,11,26,15,-1,1.20
"20211004","1783","0039003800390057","9800",元大-豐原站前,5,0,5,1,0.40
"20211004","1783","9237","9200",凱基-敦北,5,17,12,-1,0.96
"20211004","1783","6385","6380",光和-花壇,4,0,4,1,0.32
"20211004","1783","9692","9600",富邦-嘉義,0,12,12,-1,0.96
"20211004","1783","0038003800340045","8840",玉山-城中,6,2,4,1,0.32
"20211004","1783","1440","1440",美林,13,24,11,-1,0.88
"20211004","1783","003800380038004b","8880",國泰-板橋,6,2,4,1,0.32
"20211004","1783","0031003200360055","1260",宏遠-館前,1,11,10,-1,0.80
"20211004","1783","0039004100390042","9A00",永豐金-中和,5,1,4,1,0.32
"20211004","1783","5854","5850",統一-城中,25,35,10,-1,0.80
"20211004","1783","003500380035004a","5850",統一-三重,3,0,3,1,0.24
"20211004","1783","0037003000300048","7000",兆豐-東門,15,25,10,-1,0.80
"20211005","1783","1470","1470",台灣摩根士丹利,88,7,81,1,11.64
"20211005","1783","1520","1520",瑞士信貸,20,45,25,-1,3.59
"20211005","1783","9255","9200",凱基-和平,42,6,36,1,5.17
"20211005","1783","1480","1480",美商高盛,0,23,23,-1,3.30
"20211005","1783","0035003800350055","5850",統一-南京,35,5,30,1,4.31
"20211005","1783","003900380033004d","9800",元大-木柵,0,21,21,-1,3.02
"20211005","1783","9604","9600",富邦-陽明,30,5,25,1,3.59
"20211005","1783","5854","5850",統一-城中,15,35,20,-1,2.87
"20211005","1783","0039003100330044","9100",群益金鼎-潭子,23,2,21,1,3.02
"20211005","1783","0039003800390058","9800",元大-民生,15,35,20,-1,2.87
"20211005","1783","0038003100350059","8150",台新-新營,15,0,15,1,2.16
"20211005","1783","1034","1030",土銀-嘉義,0,19,19,-1,2.73
"20211005","1783","9291","9200",凱基-大安,14,0,14,1,2.01
"20211005","1783","9362","9300",華南永昌-苗栗,0,18,18,-1,2.59
"20211005","1783","1650","1650",新加坡商瑞銀,10,0,10,1,1.44
"20211005","1783","9859","9800",元大-新竹經國,0,14,14,-1,2.01
"20211005","1783","0037003000300048","7000",兆豐-東門,10,0,10,1,1.44
"20211005","1783","0039003600320055","9600",富邦-縣政,0,12,12,-1,1.72
"20211005","1783","9333","9300",華南永昌-長虹,10,0,10,1,1.44
"20211005","1783","9238","9200",凱基-士林,0,11,11,-1,1.58
"20211005","1783","0039004100390062","9A00",永豐金-虎尾,10,0,10,1,1.44
"20211005","1783","0039003800390044","9800",元大-左營,0,11,11,-1,1.58
"20211005","1783","0039004100380046","9A00",永豐金-敦南,7,0,7,1,1.01
"20211005","1783","9225","9200",凱基-內埔,0,10,10,-1,1.44
"20211005","1783","1560","1560",港商野村,36,30,6,1,0.86
"20211005","1783","9893","9800",元大-大天母,0,10,10,-1,1.44
"20211005","1783","9616","9600",富邦-岡山,6,0,6,1,0.86
"20211005","1783","9303","9300",華南永昌-高雄,0,8,8,-1,1.15
"20211006","1783","9616","9600",富邦-岡山,27,0,27,1,3.00
"20211006","1783","8440","8440",摩根大通,23,105,82,-1,9.12
"20211006","1783","0039003600320056","9600",富邦-復興,25,0,25,1,2.78
"20211006","1783","0035003800350055","5850",統一-南京,0,81,81,-1,9.01
"20211006","1783","6460","6460",大昌,22,0,22,1,2.45
"20211006","1783","1480","1480",美商高盛,0,65,65,-1,7.23
"20211006","1783","9659","9600",富邦-高雄,19,0,19,1,2.11
"20211006","1783","0039003200300041","9200",凱基-板橋,0,33,33,-1,3.67
"20211006","1783","0035003300380044","5380",第一金-忠孝,18,0,18,1,2.00
"20211006","1783","1560","1560",港商野村,27,48,21,-1,2.34
"20211006","1783","0039004100390043","9A00",永豐金-員林,24,6,18,1,2.00
"20211006","1783","1650","1650",新加坡商瑞銀,0,20,20,-1,2.22
"20211006","1783","5854","5850",統一-城中,31,16,15,1,1.67
"20211006","1783","5850","5850",統一,1,20,19,-1,2.11
"20211006","1783","003500380035005a","5850",統一-松江,12,0,12,1,1.33
"20211006","1783","1440","1440",美林,0,18,18,-1,2.00
"20211006","1783","9813","9800",元大-八德,12,0,12,1,1.33
"20211006","1783","1470","1470",台灣摩根士丹利,8,20,12,-1,1.33
"20211006","1783","003900380033004b","9800",元大-學甲,12,0,12,1,1.33
"20211006","1783","7032","7030",致和-佳里,0,10,10,-1,1.11
"20211006","1783","9238","9200",凱基-士林,11,0,11,1,1.22
"20211006","1783","0038003100350059","8150",台新-新營,0,10,10,-1,1.11
"20211006","1783","0038003100350042","8150",台新-台中,10,0,10,1,1.11
"20211006","1783","0039004100390062","9A00",永豐金-虎尾,0,10,10,-1,1.11
"20211006","1783","9205","9200",凱基-三重,10,0,10,1,1.11
"20211006","1783","9800","9800",元大證券,2,8,6,-1,0.67
"20211006","1783","0039003800390058","9800",元大-民生,35,25,10,1,1.11
"20211006","1783","6950","6950",福勝,0,5,5,-1,0.56
"20211007","1783","0037003000300048","7000",兆豐-東門,83,0,83,1,13.34
"20211007","1783","0039004100390043","9A00",永豐金-員林,0,25,25,-1,4.02
"20211007","1783","8440","8440",摩根大通,42,3,39,1,6.27
"20211007","1783","0039003200300041","9200",凱基-板橋,0,24,24,-1,3.86
"20211007","1783","1470","1470",台灣摩根士丹利,26,1,25,1,4.02
"20211007","1783","0039003800390058","9800",元大-民生,0,20,20,-1,3.22
"20211007","1783","1520","1520",瑞士信貸,22,2,20,1,3.22
"20211007","1783","8848","8840",玉山-嘉義,0,13,13,-1,2.09
"20211007","1783","1480","1480",美商高盛,19,7,12,1,1.93
"20211007","1783","0039003800310047","9800",元大-彰化,0,13,13,-1,2.09
"20211007","1783","9212","9200",凱基-東港,10,0,10,1,1.61
"20211007","1783","9813","9800",元大-八德,2,14,12,-1,1.93
"20211007","1783","9604","9600",富邦-陽明,10,0,10,1,1.61
"20211007","1783","9105","9100",群益金鼎-高盛,0,11,11,-1,1.77
"20211007","1783","003900380039005a","9800",元大-小港,10,0,10,1,1.61
"20211007","1783","1040","1040",臺銀,0,10,10,-1,1.61
"20211007","1783","0039003100380057","9100",群益金鼎-忠孝,18,10,8,1,1.29
"20211007","1783","8150","8150",台新證券,0,10,10,-1,1.61
"20211007","1783","1440","1440",美林,17,10,7,1,1.13
"20211007","1783","0039003100330049","9100",群益金鼎-萬華,0,9,9,-1,1.45
"20211007","1783","1560","1560",港商野村,25,18,7,1,1.13
"20211007","1783","0039003800390051","9800",元大-汐止,0,9,9,-1,1.45
"20211007","1783","8840","8840",玉山證券,9,2,7,1,1.13
"20211007","1783","9616","9600",富邦-岡山,0,8,8,-1,1.29
"20211007","1783","2180","2180",亞東,7,1,6,1,0.96
"20211007","1783","8560","8560",新光,2,9,7,-1,1.13
"20211007","1783","9872","9800",元大-復北,6,0,6,1,0.96
"20211007","1783","9322","9300",華南永昌-公誠,0,7,7,-1,1.13
"20211008","1783","5854","5850",統一-城中,25,3,22,1,3.59
"20211008","1783","8440","8440",摩根大通,5,58,53,-1,8.65
"20211008","1783","003900410039004b","9A00",永豐金-三重,21,0,21,1,3.43
"20211008","1783","9268","9200",凱基-台北,20,65,45,-1,7.34
"20211008","1783","1040","1040",臺銀,20,0,20,1,3.26
"20211008","1783","0035003800350055","5850",統一-南京,0,44,44,-1,7.18
"20211008","1783","8880","8880",國泰證券,20,0,20,1,3.26
"20211008","1783","1440","1440",美林,0,31,31,-1,5.06
"20211008","1783","9285","9200",凱基-中壢,21,1,20,1,3.26
"20211008","1783","9276","9200",凱基-苗栗,0,31,31,-1,5.06
"20211008","1783","0031003200360044","1260",宏遠-台南,15,0,15,1,2.45
"20211008","1783","1650","1650",新加坡商瑞銀,0,27,27,-1,4.40
"20211008","1783","0039003800390051","9800",元大-汐止,15,0,15,1,2.45
"20211008","1783","9616","9600",富邦-岡山,1,25,24,-1,3.92
"20211008","1783","0039003800390058","9800",元大-民生,15,0,15,1,2.45
"20211008","1783","1470","1470",台灣摩根士丹利,0,14,14,-1,2.28
"20211008","1783","9322","9300",華南永昌-公誠,12,0,12,1,1.96
"20211008","1783","9291","9200",凱基-大安,0,14,14,-1,2.28
"20211008","1783","0039003800340043","9800",元大-新店中正,10,0,10,1,1.63
"20211008","1783","003900380033004b","9800",元大-學甲,0,12,12,-1,1.96
"20211008","1783","9872","9800",元大-復北,11,2,9,1,1.47
"20211008","1783","9212","9200",凱基-東港,0,10,10,-1,1.63
"20211008","1783","5850","5850",統一,9,1,8,1,1.31
"20211008","1783","0031003200360055","1260",宏遠-館前,0,8,8,-1,1.31
"20211008","1783","8560","8560",新光,9,1,8,1,1.31
"20211008","1783","0039003100380057","9100",群益金鼎-忠孝,10,18,8,-1,1.31
"20211008","1783","9813","9800",元大-八德,7,0,7,1,1.14
"20211008","1783","9229","9200",凱基-中山,2,10,8,-1,1.31
"20211012","1783","9331","9300",華南永昌-鳳山,81,0,81,1,3.30
"20211012","1783","9268","9200",凱基-台北,113,293,180,-1,7.33
"20211012","1783","5603","5600",永興-台中,52,2,50,1,2.04
"20211012","1783","0037003000300048","7000",兆豐-東門,30,170,140,-1,5.70
"20211012","1783","5857","5850",統一-新竹,41,0,41,1,1.67
"20211012","1783","1650","1650",新加坡商瑞銀,19,88,69,-1,2.81
"20211012","1783","9276","9200",凱基-苗栗,31,0,31,1,1.26
"20211012","1783","1480","1480",美商高盛,25,70,45,-1,1.83
"20211012","1783","0039003800300065","9800",元大-清水,36,11,25,1,1.02
"20211012","1783","1560","1560",港商野村,86,122,36,-1,1.47
"20211012","1783","0039003600310057","9600",富邦-東花蓮,23,0,23,1,0.94
"20211012","1783","1440","1440",美林,24,51,27,-1,1.10
"20211012","1783","0039004100390037","9A00",永豐金-新竹,22,0,22,1,0.90
"20211012","1783","9255","9200",凱基-和平,8,34,26,-1,1.06
"20211012","1783","6110","6110",台中銀,20,0,20,1,0.81
"20211012","1783","6460","6460",大昌,8,31,23,-1,0.94
"20211012","1783","9363","9300",華南永昌-彰化,19,0,19,1,0.77
"20211012","1783","1470","1470",台灣摩根士丹利,30,50,20,-1,0.81
"20211012","1783","003700370039005a","7790",國票-安和,20,1,19,1,0.77
"20211012","1783","0031003200360044","1260",宏遠-台南,2,16,14,-1,0.57
"20211012","1783","9604","9600",富邦-陽明,20,1,19,1,0.77
"20211012","1783","9872","9800",元大-復北,1,14,13,-1,0.53
"20211012","1783","0038003100350042","8150",台新-台中,19,3,16,1,0.65
"20211012","1783","9884","9800",元大-斗信,5,18,13,-1,0.53
"20211012","1783","0039003600390043","9600",富邦-北港,15,0,15,1,0.61
"20211012","1783","0031003000320043","1020",合庫-自強,1,13,12,-1,0.49
"20211012","1783","9287","9200",凱基-內湖,15,0,15,1,0.61
"20211012","1783","0039003800390051","9800",元大-汐止,5,16,11,-1,0.45
"20211013","1783","9331","9300",華南永昌-鳳山,35,0,35,1,3.84
"20211013","1783","0035003800350055","5850",統一-南京,0,51,51,-1,5.60
"20211013","1783","003900410039004b","9A00",永豐金-三重,32,0,32,1,3.51
"20211013","1783","1470","1470",台灣摩根士丹利,17,51,34,-1,3.73
"20211013","1783","6160","6160",中國信託,30,0,30,1,3.29
"20211013","1783","9268","9200",凱基-台北,61,95,34,-1,3.73
"20211013","1783","6460","6460",大昌,30,0,30,1,3.29
"20211013","1783","0039003800390047","9800",元大-大同,0,30,30,-1,3.29
"20211013","1783","5854","5850",統一-城中,43,26,17,1,1.87
"20211013","1783","1650","1650",新加坡商瑞銀,0,24,24,-1,2.63
"20211013","1783","0039003800390058","9800",元大-民生,30,15,15,1,1.65
"20211013","1783","9884","9800",元大-斗信,2,23,21,-1,2.31
"20211013","1783","0035003300380057","5380",第一金-華江,12,0,12,1,1.32
"20211013","1783","6110","6110",台中銀,0,20,20,-1,2.20
"20211013","1783","0035003800350046","5850",統一-彰化,10,0,10,1,1.10
"20211013","1783","003700370039005a","7790",國票-安和,0,20,20,-1,2.20
"20211013","1783","6161","6160",中國信託-三重,10,0,10,1,1.10
"20211013","1783","9285","9200",凱基-中壢,0,20,20,-1,2.20
"20211013","1783","0037003700390050","7790",國票-九鼎,10,0,10,1,1.10
"20211013","1783","1560","1560",港商野村,12,31,19,-1,2.09
"20211013","1783","9189","9100",群益金鼎-桃園,10,0,10,1,1.10
"20211013","1783","1440","1440",美林,0,16,16,-1,1.76
"20211013","1783","0039003100380045","9100",群益金鼎-南京,10,0,10,1,1.10
"20211013","1783","9287","9200",凱基-內湖,0,15,15,-1,1.65
"20211013","1783","0039003100330044","9100",群益金鼎-潭子,8,0,8,1,0.88
"20211013","1783","6382","6380",光和-田中,0,10,10,-1,1.10
"20211013","1783","9308","9300",華南永昌-麻豆,8,0,8,1,0.88
"20211013","1783","003900380030006c","9800",元大-虎尾,0,9,9,-1,0.99
"20211014","1783","9268","9200",凱基-台北,47,23,24,1,5.77
"20211014","1783","003900410039004b","9A00",永豐金-三重,0,32,32,-1,7.69
"20211014","1783","1470","1470",台灣摩根士丹利,21,0,21,1,5.05
"20211014","1783","0039004100300030","9A00",永豐金證券,0,24,24,-1,5.77
"20211014","1783","1440","1440",美林,20,4,16,1,3.85
"20211014","1783","9105","9100",群益金鼎-高盛,0,20,20,-1,4.81
"20211014","1783","1520","1520",瑞士信貸,13,0,13,1,3.13
"20211014","1783","9306","9300",華南永昌-台南,0,13,13,-1,3.13
"20211014","1783","9205","9200",凱基-三重,10,0,10,1,2.40
"20211014","1783","5851","5850",統一-高雄,0,8,8,-1,1.92
"20211014","1783","9837","9800",元大-北港,10,0,10,1,2.40
"20211014","1783","0031003200360055","1260",宏遠-館前,0,5,5,-1,1.20
"20211014","1783","1480","1480",美商高盛,9,1,8,1,1.92
"20211014","1783","8450","8450",康和,0,5,5,-1,1.20
"20211014","1783","0035003900320050","5920",元富-同大,8,0,8,1,1.92
"20211014","1783","0039003600310043","9600",富邦-南京,1,6,5,-1,1.20
"20211014","1783","6460","6460",大昌,6,0,6,1,1.44
"20211014","1783","0039003600310048","9600",富邦-新板,0,5,5,-1,1.20
"20211014","1783","1040","1040",臺銀,5,0,5,1,1.20
"20211014","1783","9833","9800",元大-敦化,0,5,5,-1,1.20
"20211014","1783","8560","8560",新光,8,3,5,1,1.20
"20211014","1783","9834","9800",元大-中壢,1,6,5,-1,1.20
"20211014","1783","003900380030006c","9800",元大-虎尾,5,0,5,1,1.20
"20211014","1783","0039004100390064","9A00",永豐金-古亭,0,5,5,-1,1.20
"20211014","1783","9878","9800",元大-金華,5,0,5,1,1.20
"20211014","1783","5854","5850",統一-城中,11,15,4,-1,0.96
"20211014","1783","0039003800390043","9800",元大-板橋,5,0,5,1,1.20
"20211014","1783","003500390032005a","5920",元富-安南,0,4,4,-1,0.96
"20211015","1783","1520","1520",瑞士信貸,38,10,28,1,5.51
"20211015","1783","9331","9300",華南永昌-鳳山,1,29,28,-1,5.51
"20211015","1783","1440","1440",美林,43,19,24,1,4.72
"20211015","1783","9268","9200",凱基-台北,20,45,25,-1,4.92
"20211015","1783","1470","1470",台灣摩根士丹利,21,0,21,1,4.13
"20211015","1783","003900410039004b","9A00",永豐金-三重,0,23,23,-1,4.53
"20211015","1783","5854","5850",統一-城中,49,38,11,1,2.17
"20211015","1783","5264","5260",美好-高雄,0,20,20,-1,3.94
"20211015","1783","9817","9800",元大-東泰,11,0,11,1,2.17
"20211015","1783","1380","1380",台灣匯立證券,0,15,15,-1,2.95
"20211015","1783","0035003300380044","5380",第一金-忠孝,10,0,10,1,1.97
"20211015","1783","9878","9800",元大-金華,0,14,14,-1,2.76
"20211015","1783","1480","1480",美商高盛,14,6,8,1,1.57
"20211015","1783","0037003000300048","7000",兆豐-東門,0,9,9,-1,1.77
"20211015","1783","1560","1560",港商野村,12,4,8,1,1.57
"20211015","1783","8440","8440",摩根大通,5,14,9,-1,1.77
"20211015","1783","0031003200360055","1260",宏遠-館前,10,3,7,1,1.38
"20211015","1783","8560","8560",新光,4,11,7,-1,1.38
"20211015","1783","0039003800320042","9800",元大-博愛,7,0,7,1,1.38
"20211015","1783","003500390032005a","5920",元富-安南,0,6,6,-1,1.18
"20211015","1783","5603","5600",永興-台中,6,0,6,1,1.18
"20211015","1783","9255","9200",凱基-和平,0,6,6,-1,1.18
"20211015","1783","1040","1040",臺銀,5,0,5,1,0.98
"20211015","1783","0035003900320041","5920",元富-緯城,0,5,5,-1,0.98
"20211015","1783","9837","9800",元大-北港,5,0,5,1,0.98
"20211015","1783","0039003600310044","9600",富邦-忠孝,0,5,5,-1,0.98
"20211015","1783","6161","6160",中國信託-三重,5,1,4,1,0.79
"20211015","1783","9831","9800",元大-四維,0,5,5,-1,0.98
"20210916","1783","1480","1480",美商高盛,48,5,43,1,9.73
"20210916","1783","1440","1440",美林,1,22,21,-1,4.75
"20210916","1783","1470","1470",台灣摩根士丹利,43,4,39,1,8.82
"20210916","1783","6460","6460",大昌,0,20,20,-1,4.52
"20210916","1783","8440","8440",摩根大通,43,20,23,1,5.20
"20210916","1783","0039003800390064","9800",元大-北屯,0,19,19,-1,4.30
"20210916","1783","0039003800310053","9800",元大-崇德,23,0,23,1,5.20
"20210916","1783","9185","9100",群益金鼎-台南,0,14,14,-1,3.17
"20210916","1783","0039004100390043","9A00",永豐金-員林,15,0,15,1,3.39
"20210916","1783","0039003100330044","9100",群益金鼎-潭子,0,13,13,-1,2.94
"20210916","1783","1650","1650",新加坡商瑞銀,12,0,12,1,2.71
"20210916","1783","9238","9200",凱基-士林,7,19,12,-1,2.71
"20210916","1783","1560","1560",港商野村,15,5,10,1,2.26
"20210916","1783","003900380031004e","9800",元大-金門,11,22,11,-1,2.49
"20210916","1783","9308","9300",華南永昌-麻豆,6,0,6,1,1.36
"20210916","1783","9105","9100",群益金鼎-高盛,0,10,10,-1,2.26
"20210916","1783","5854","5850",統一-城中,15,10,5,1,1.13
"20210916","1783","9300","9300",華南永昌,0,10,10,-1,2.26
"20210916","1783","0039003800390058","9800",元大-民生,15,10,5,1,1.13
"20210916","1783","6912","6910",德信-中正,1,10,9,-1,2.04
"20210916","1783","003900410039006a","9A00",永豐金-嘉義,5,0,5,1,1.13
"20210916","1783","5267","5260",美好-基隆,0,5,5,-1,1.13
"20210916","1783","003900380039006b","9800",元大-古亭,4,0,4,1,0.90
"20210916","1783","0039003800300052","9800",元大-南海,0,5,5,-1,1.13
"20210916","1783","9686","9600",富邦-宜蘭,3,0,3,1,0.68
"20210916","1783","0039003800310069","9800",元大-西螺,0,5,5,-1,1.13
"20210916","1783","003900380039004a","9800",元大-彰化民生,3,0,3,1,0.68
"20210916","1783","003900380031005a","9800",元大-潮州,0,5,5,-1,1.13
"20210917","1783","003900380033006a","9800",元大-仁愛,22,0,22,1,7.31
"20210917","1783","1440","1440",美林,0,33,33,-1,10.96
"20210917","1783","9327","9300",華南永昌-斗六,15,0,15,1,4.98
"20210917","1783","5850","5850",統一,0,30,30,-1,9.97
"20210917","1783","8440","8440",摩根大通,15,2,13,1,4.32
"20210917","1783","9319","9300",華南永昌-鶯歌,0,10,10,-1,3.32
"20210917","1783","0037003000300048","7000",兆豐-東門,11,0,11,1,3.65
"20210917","1783","9278","9200",凱基-永康,0,10,10,-1,3.32
"20210917","1783","1480","1480",美商高盛,28,21,7,1,2.33
"20210917","1783","003900380031006d","9800",元大-前金,0,8,8,-1,2.66
"20210917","1783","0039003800390064","9800",元大-北屯,8,1,7,1,2.33
"20210917","1783","6210","6210",新百王,1,7,6,-1,1.99
"20210917","1783","0039004100390042","9A00",永豐金-中和,6,0,6,1,1.99
"20210917","1783","8848","8840",玉山-嘉義,0,5,5,-1,1.66
"20210917","1783","5854","5850",統一-城中,5,0,5,1,1.66
"20210917","1783","9300","9300",華南永昌,0,5,5,-1,1.66
"20210917","1783","9268","9200",凱基-台北,25,20,5,1,1.66
"20210917","1783","0039004100360031","9A00",永豐金-鳳山,0,5,5,-1,1.66
"20210917","1783","0039003600320056","9600",富邦-復興,5,0,5,1,1.66
"20210917","1783","1033","1030",土銀-高雄,0,3,3,-1,1.00
"20210917","1783","003900380031005a","9800",元大-潮州,5,0,5,1,1.66
"20210917","1783","0039003600310053","9600",富邦-景美,0,3,3,-1,1.00
"20210917","1783","0039003800390058","9800",元大-民生,5,0,5,1,1.66
"20210917","1783","0039003800300061","9800",元大-承德,0,3,3,-1,1.00
"20210917","1783","0039003800310041","9800",元大-鶯歌,4,0,4,1,1.33
"20210917","1783","0039003800300077","9800",元大-西屯,0,3,3,-1,1.00
"20210917","1783","5261","5260",美好-蘆洲,3,0,3,1,1.00
"20210917","1783","8881","8880",國泰-高雄,0,2,2,-1,0.66
"20210922","1783","1480","1480",美商高盛,77,1,76,1,14.79
"20210922","1783","9665","9600",富邦-桃園,0,27,27,-1,5.25
"20210922","1783","0039003800390064","9800",元大-北屯,52,0,52,1,10.12
"20210922","1783","9875","9800",元大-土城永寧,0,25,25,-1,4.86
"20210922","1783","1650","1650",新加坡商瑞銀,20,3,17,1,3.31
"20210922","1783","9322","9300",華南永昌-公誠,0,14,14,-1,2.72
"20210922","1783","1470","1470",台灣摩根士丹利,16,1,15,1,2.92
"20210922","1783","8560","8560",新光,2,13,11,-1,2.14
"20210922","1783","5854","5850",統一-城中,20,5,15,1,2.92
"20210922","1783","6164","6160",中國信託-文心,0,11,11,-1,2.14
"20210922","1783","0039003800390058","9800",元大-民生,20,5,15,1,2.92
"20210922","1783","9300","9300",華南永昌,1,12,11,-1,2.14
"20210922","1783","9276","9200",凱基-苗栗,20,8,12,1,2.33
"20210922","1783","0035003900320045","5920",元富-城中,0,10,10,-1,1.95
"20210922","1783","0036003000310064","6010",(牛牛牛)亞-鑫豐,10,0,10,1,1.95
"20210922","1783","1440","1440",美林,1,11,10,-1,1.95
"20210922","1783","9859","9800",元大-新竹經國,10,0,10,1,1.95
"20210922","1783","0039003200310053","9200",凱基-幸福,0,10,10,-1,1.95
"20210922","1783","9853","9800",元大-南屯,6,0,6,1,1.17
"20210922","1783","9238","9200",凱基-士林,0,10,10,-1,1.95
"20210922","1783","1040","1040",臺銀,5,0,5,1,0.97
"20210922","1783","0039003600320041","9600",富邦-信義,0,10,10,-1,1.95
"20210922","1783","9105","9100",群益金鼎-高盛,5,0,5,1,0.97
"20210922","1783","9817","9800",元大-東泰,0,10,10,-1,1.95
"20210922","1783","0039003600320056","9600",富邦-復興,5,0,5,1,0.97
"20210922","1783","1110","1110",台灣企銀,0,7,7,-1,1.36
"20210922","1783","0039003600320059","9600",富邦-土城,5,0,5,1,0.97
"20210922","1783","6912","6910",德信-中正,3,10,7,-1,1.36
"20210923","1783","5384","5380",第一金-台南,26,0,26,1,2.49
"20210923","1783","9268","9200",凱基-台北,57,100,43,-1,4.12
"20210923","1783","0035003800350055","5850",統一-南京,25,0,25,1,2.39
"20210923","1783","8440","8440",摩根大通,61,93,32,-1,3.07
"20210923","1783","003700370039007a","7790",國票-博愛,20,0,20,1,1.92
"20210923","1783","1520","1520",瑞士信貸,30,59,29,-1,2.78
"20210923","1783","8849","8840",玉山-景美,20,0,20,1,1.92
"20210923","1783","1440","1440",美林,1,23,22,-1,2.11
"20210923","1783","9327","9300",華南永昌-斗六,20,0,20,1,1.92
"20210923","1783","1470","1470",台灣摩根士丹利,34,47,13,-1,1.25
"20210923","1783","9315","9300",華南永昌-苑裡,20,1,19,1,1.82
"20210923","1783","9853","9800",元大-南屯,1,13,12,-1,1.15
"20210923","1783","9234","9200",凱基-竹北,13,0,13,1,1.25
"20210923","1783","1560","1560",港商野村,34,45,11,-1,1.05
"20210923","1783","0039003800390044","9800",元大-左營,13,0,13,1,1.25
"20210923","1783","9238","9200",凱基-士林,9,20,11,-1,1.05
"20210923","1783","0039003800310046","9800",元大-福營,11,0,11,1,1.05
"20210923","1783","9800","9800",元大證券,0,10,10,-1,0.96
"20210923","1783","6912","6910",德信-中正,16,6,10,1,0.96
"20210923","1783","0039003800390064","9800",元大-北屯,1,10,9,-1,0.86
"20210923","1783","9329","9300",華南永昌-朴子,10,0,10,1,0.96
"20210923","1783","0035003900320055","5920",元富-宜蘭,1,8,7,-1,0.67
"20210923","1783","9833","9800",元大-敦化,10,0,10,1,0.96
"20210923","1783","0035003900320069","5920",元富-中港,0,6,6,-1,0.57
"20210923","1783","9859","9800",元大-新竹經國,9,0,9,1,0.86
"20210923","1783","9852","9800",元大-永春,0,6,6,-1,0.57
"20210923","1783","0039004100390037","9A00",永豐金-新竹,13,4,9,1,0.86
"20210923","1783","6460","6460",大昌,1,6,5,-1,0.48
"20210924","1783","1520","1520",瑞士信貸,17,0,17,1,5.21
"20210924","1783","9327","9300",華南永昌-斗六,0,21,21,-1,6.44
"20210924","1783","9315","9300",華南永昌-苑裡,16,0,16,1,4.91
"20210924","1783","003700370039007a","7790",國票-博愛,0,20,20,-1,6.13
"20210924","1783","1470","1470",台灣摩根士丹利,13,3,10,1,3.07
"20210924","1783","8440","8440",摩根大通,14,27,13,-1,3.99
"20210924","1783","0037003000300049","7000",兆豐-北高雄,10,0,10,1,3.07
"20210924","1783","9234","9200",凱基-竹北,0,13,13,-1,3.99
"20210924","1783","9302","9300",華南永昌-台中,10,0,10,1,3.07
"20210924","1783","0037003000300073","7000",兆豐-岡山,0,10,10,-1,3.07
"20210924","1783","9833","9800",元大-敦化,10,0,10,1,3.07
"20210924","1783","0039003800390064","9800",元大-北屯,0,10,10,-1,3.07
"20210924","1783","8580","8580",聯邦商銀,8,0,8,1,2.45
"20210924","1783","0039004100390037","9A00",永豐金-新竹,0,9,9,-1,2.76
"20210924","1783","9268","9200",凱基-台北,15,7,8,1,2.45
"20210924","1783","1040","1040",臺銀,0,5,5,-1,1.53
"20210924","1783","9208","9200",凱基-桃園,5,0,5,1,1.53
"20210924","1783","5854","5850",統一-城中,0,5,5,-1,1.53
"20210924","1783","0035003900320055","5920",元富-宜蘭,5,0,5,1,1.53
"20210924","1783","003900360031004b","9600",富邦-七賢,0,5,5,-1,1.53
"20210924","1783","1650","1650",新加坡商瑞銀,4,0,4,1,1.23
"20210924","1783","0039003800390058","9800",元大-民生,0,5,5,-1,1.53
"20210924","1783","0039003200320048","9200",凱基-復興,9,5,4,1,1.23
"20210924","1783","003500390032006c","5920",元富-大裕,0,4,4,-1,1.23
"20210924","1783","0039003600320042","9600",富邦-二林,3,0,3,1,0.92
"20210924","1783","003700370039006a","7790",國票-和平,2,5,3,-1,0.92
"20210924","1783","8560","8560",新光,3,1,2,1,0.61
"20210924","1783","9239","9200",凱基-市政,0,3,3,-1,0.92
"20210901","1783","0037003700390058","7790",國票-中和,25,0,25,1,1.68
"20210901","1783","1470","1470",台灣摩根士丹利,1,105,104,-1,6.99
"20210901","1783","5927","5920",元富-林園,23,0,23,1,1.55
"20210901","1783","1560","1560",港商野村,56,122,66,-1,4.44
"20210901","1783","0039003800390047","9800",元大-大同,21,0,21,1,1.41
"20210901","1783","6162","6160",中國信託-忠孝,0,60,60,-1,4.03
"20210901","1783","0039003100380042","9100",群益金鼎-板橋,17,0,17,1,1.14
"20210901","1783","1480","1480",美商高盛,3,52,49,-1,3.29
"20210901","1783","0039003800310058","9800",元大-新生,17,0,17,1,1.14
"20210901","1783","8440","8440",摩根大通,39,84,45,-1,3.02
"20210901","1783","0039003800390064","9800",元大-北屯,18,1,17,1,1.14
"20210901","1783","7080","7080",石橋證券,15,55,40,-1,2.69
"20210901","1783","9186","9100",群益金鼎-新竹,15,0,15,1,1.01
"20210901","1783","1440","1440",美林,7,45,38,-1,2.55
"20210901","1783","0039003800390058","9800",元大-民生,45,30,15,1,1.01
"20210901","1783","8563","8560",新光-新竹,1,29,28,-1,1.88
"20210901","1783","0038003800340042","8840",玉山-台中,13,0,13,1,0.87
"20210901","1783","1650","1650",新加坡商瑞銀,7,22,15,-1,1.01
"20210901","1783","0039003600320043","9600",富邦-東門,12,0,12,1,0.81
"20210901","1783","5268","5260",美好-台南,0,12,12,-1,0.81
"20210901","1783","0039004100390043","9A00",永豐金-員林,12,0,12,1,0.81
"20210901","1783","7001","7000",兆豐-嘉義,0,10,10,-1,0.67
"20210901","1783","0039003200300046","9200",凱基-站前,11,0,11,1,0.74
"20210901","1783","7032","7030",致和-佳里,1,10,9,-1,0.60
"20210901","1783","1029","1020",合庫-鳳山,10,0,10,1,0.67
"20210901","1783","003800380038004b","8880",國泰-板橋,7,15,8,-1,0.54
"20210901","1783","9238","9200",凱基-士林,30,20,10,1,0.67
"20210901","1783","9332","9300",華南永昌-楠梓,0,6,6,-1,0.40
"20210902","1783","1480","1480",美商高盛,74,3,71,1,6.28
"20210902","1783","0037003000300046","7000",兆豐-虎尾,0,27,27,-1,2.39
"20210902","1783","9366","9300",華南永昌-豐原,46,0,46,1,4.07
"20210902","1783","9692","9600",富邦-嘉義,4,30,26,-1,2.30
"20210902","1783","1560","1560",港商野村,71,27,44,1,3.89
"20210902","1783","9329","9300",華南永昌-朴子,5,28,23,-1,2.03
"20210902","1783","9268","9200",凱基-台北,74,44,30,1,2.65
"20210902","1783","9105","9100",群益金鼎-高盛,0,20,20,-1,1.77
"20210902","1783","6460","6460",大昌,25,0,25,1,2.21
"20210902","1783","8150","8150",台新證券,10,28,18,-1,1.59
"20210902","1783","6162","6160",中國信託-忠孝,24,0,24,1,2.12
"20210902","1783","9185","9100",群益金鼎-台南,0,18,18,-1,1.59
"20210902","1783","1470","1470",台灣摩根士丹利,52,29,23,1,2.03
"20210902","1783","8564","8560",新光-台南,5,21,16,-1,1.41
"20210902","1783","0031003000330046","1030",土銀-南港,20,0,20,1,1.77
"20210902","1783","9186","9100",群益金鼎-新竹,0,15,15,-1,1.33
"20210902","1783","1440","1440",美林,19,4,15,1,1.33
"20210902","1783","0035003900320055","5920",元富-宜蘭,5,18,13,-1,1.15
"20210902","1783","0039003200320043","9200",凱基-屏東,14,0,14,1,1.24
"20210902","1783","5852","5850",統一-敦南,0,12,12,-1,1.06
"20210902","1783","1020","1020",合庫證券,10,0,10,1,0.88
"20210902","1783","8561","8560",新光-台中,3,15,12,-1,1.06
"20210902","1783","9227","9200",凱基-城中,10,0,10,1,0.88
"20210902","1783","0039003600330042","9600",富邦-北宜蘭(停),0,12,12,-1,1.06
"20210902","1783","9303","9300",華南永昌-高雄,8,0,8,1,0.71
"20210902","1783","9654","9600",富邦-永和,0,11,11,-1,0.97
"20210902","1783","0039004100390043","9A00",永豐金-員林,18,10,8,1,0.71
"20210902","1783","0039003200300046","9200",凱基-站前,0,10,10,-1,0.88
"20210903","1783","1470","1470",台灣摩根士丹利,66,23,43,1,5.00
"20210903","1783","9211","9200",凱基-台南,0,30,30,-1,3.49
"20210903","1783","9268","9200",凱基-台北,56,18,38,1,4.42
"20210903","1783","0039003800390058","9800",元大-民生,0,25,25,-1,2.91
"20210903","1783","1650","1650",新加坡商瑞銀,39,16,23,1,2.67
"20210903","1783","003900310033004e","9100",群益金鼎-土城,0,18,18,-1,2.09
"20210903","1783","0031003000330046","1030",土銀-南港,20,0,20,1,2.33
"20210903","1783","1520","1520",瑞士信貸,3,20,17,-1,1.98
"20210903","1783","9614","9600",富邦-基隆,20,0,20,1,2.33
"20210903","1783","8848","8840",玉山-嘉義,0,15,15,-1,1.74
"20210903","1783","1560","1560",港商野村,67,48,19,1,2.21
"20210903","1783","8150","8150",台新證券,5,16,11,-1,1.28
"20210903","1783","1440","1440",美林,21,8,13,1,1.51
"20210903","1783","8159","8150",台新-台南,0,11,11,-1,1.28
"20210903","1783","8560","8560",新光,26,18,8,1,0.93
"20210903","1783","0039003200300046","9200",凱基-站前,0,11,11,-1,1.28
"20210903","1783","003900380031004e","9800",元大-金門,8,0,8,1,0.93
"20210903","1783","5854","5850",統一-城中,0,10,10,-1,1.16
"20210903","1783","8440","8440",摩根大通,8,1,7,1,0.81
"20210903","1783","0035003900320071","5920",元富-屏東,0,10,10,-1,1.16
"20210903","1783","9853","9800",元大-南屯,12,5,7,1,0.81
"20210903","1783","0035003900320057","5920",元富-吉利,0,10,10,-1,1.16
"20210903","1783","5927","5920",元富-林園,6,0,6,1,0.70
"20210903","1783","6165","6160",中國信託-新竹,0,10,10,-1,1.16
"20210903","1783","9296","9200",凱基-頭份,6,0,6,1,0.70
"20210903","1783","0039003100380050","9100",群益金鼎-天母,0,10,10,-1,1.16
"20210903","1783","9105","9100",群益金鼎-高盛,5,0,5,1,0.58
"20210903","1783","9888","9800",元大-鑫永和,0,10,10,-1,1.16
"20210906","1783","1440","1440",美林,153,24,129,1,8.00
"20210906","1783","0039003800390044","9800",元大-左營,0,101,101,-1,6.27
"20210906","1783","1480","1480",美商高盛,111,6,105,1,6.51
"20210906","1783","5927","5920",元富-林園,0,60,60,-1,3.72
"20210906","1783","1650","1650",新加坡商瑞銀,105,2,103,1,6.39
"20210906","1783","9333","9300",華南永昌-長虹,5,60,55,-1,3.41
"20210906","1783","9268","9200",凱基-台北,142,48,94,1,5.83
"20210906","1783","0035003800350048","5850",統一-桃園,0,43,43,-1,2.67
"20210906","1783","1470","1470",台灣摩根士丹利,90,27,63,1,3.91
"20210906","1783","0037003700390045","7790",國票-南崁,24,55,31,-1,1.92
"20210906","1783","1520","1520",瑞士信貸,43,12,31,1,1.92
"20210906","1783","9105","9100",群益金鼎-高盛,11,42,31,-1,1.92
"20210906","1783","0039003800390058","9800",元大-民生,35,5,30,1,1.86
"20210906","1783","6464","6460",大昌-新店,0,25,25,-1,1.55
"20210906","1783","5854","5850",統一-城中,30,5,25,1,1.55
"20210906","1783","8158","8150",台新-松江,0,20,20,-1,1.24
"20210906","1783","0038003800340041","8840",玉山-士林,20,0,20,1,1.24
"20210906","1783","8586","8580",聯邦-大業,0,20,20,-1,1.24
"20210906","1783","9327","9300",華南永昌-斗六,15,0,15,1,0.93
"20210906","1783","9672","9600",富邦-員林,0,20,20,-1,1.24
"20210906","1783","9814","9800",元大-大益,15,2,13,1,0.81
"20210906","1783","6162","6160",中國信託-忠孝,0,19,19,-1,1.18
"20210906","1783","5850","5850",統一,12,0,12,1,0.74
"20210906","1783","1560","1560",港商野村,59,75,16,-1,0.99
"20210906","1783","6380","6380",光和,13,1,12,1,0.74
"20210906","1783","9857","9800",元大-東蘆,2,15,13,-1,0.81
"20210906","1783","003900380031004b","9800",元大-林園,11,0,11,1,0.68
"20210906","1783","5603","5600",永興-台中,0,13,13,-1,0.81
"20210907","1783","1440","1440",美林,261,72,189,1,8.84
"20210907","1783","9366","9300",華南永昌-豐原,0,140,140,-1,6.55
"20210907","1783","1470","1470",台灣摩根士丹利,124,7,117,1,5.47
"20210907","1783","0037003700390072","7790",國票-桃園,0,92,92,-1,4.30
"20210907","1783","5850","5850",統一,91,0,91,1,4.26
"20210907","1783","0039004100380046","9A00",永豐金-敦南,0,34,34,-1,1.59
"20210907","1783","1520","1520",瑞士信貸,122,40,82,1,3.84
"20210907","1783","8560","8560",新光,20,47,27,-1,1.26
"20210907","1783","8440","8440",摩根大通,149,69,80,1,3.74
"20210907","1783","0039003800390058","9800",元大-民生,12,35,23,-1,1.08
"20210907","1783","7080","7080",石橋證券,55,1,54,1,2.53
"20210907","1783","0039003800390047","9800",元大-大同,0,22,22,-1,1.03
"20210907","1783","1650","1650",新加坡商瑞銀,53,0,53,1,2.48
"20210907","1783","5854","5850",統一-城中,15,35,20,-1,0.94
"20210907","1783","8151","8150",台新-建北,24,5,19,1,0.89
"20210907","1783","9333","9300",華南永昌-長虹,8,28,20,-1,0.94
"20210907","1783","8561","8560",新光-台中,19,2,17,1,0.80
"20210907","1783","0039004100360039","9A00",永豐金-屏東,0,20,20,-1,0.94
"20210907","1783","0039003800310069","9800",元大-西螺,15,0,15,1,0.70
"20210907","1783","5923","5920",元富-三重,0,15,15,-1,0.70
"20210907","1783","2180","2180",亞東,13,0,13,1,0.61
"20210907","1783","0039003100380047","9100",群益金鼎-新莊,3,15,12,-1,0.56
"20210907","1783","9329","9300",華南永昌-朴子,17,5,12,1,0.56
"20210907","1783","9322","9300",華南永昌-公誠,3,14,11,-1,0.51
"20210907","1783","9185","9100",群益金鼎-台南,11,0,11,1,0.51
"20210907","1783","9268","9200",凱基-台北,88,99,11,-1,0.51
"20210907","1783","9324","9300",華南永昌-岡山,12,1,11,1,0.51
"20210907","1783","5320","5320",高橋,3,13,10,-1,0.47
"20210908","1783","1520","1520",瑞士信貸,42,10,32,1,2.19
"20210908","1783","5852","5850",統一-敦南,0,74,74,-1,5.06
"20210908","1783","9884","9800",元大-斗信,26,0,26,1,1.78
"20210908","1783","1440","1440",美林,0,69,69,-1,4.72
"20210908","1783","0039003800390058","9800",元大-民生,37,11,26,1,1.78
"20210908","1783","1480","1480",美商高盛,14,78,64,-1,4.37
"20210908","1783","5854","5850",統一-城中,35,15,20,1,1.37
"20210908","1783","1470","1470",台灣摩根士丹利,0,56,56,-1,3.83
"20210908","1783","003900380033004d","9800",元大-木柵,20,0,20,1,1.37
"20210908","1783","0039003800350043","9800",元大-鳳中,1,50,49,-1,3.35
"20210908","1783","0035003900320055","5920",元富-宜蘭,17,0,17,1,1.16
"20210908","1783","9333","9300",華南永昌-長虹,5,30,25,-1,1.71
"20210908","1783","8888","8880",國泰-敦南,24,10,14,1,0.96
"20210908","1783","9268","9200",凱基-台北,79,100,21,-1,1.44
"20210908","1783","9659","9600",富邦-高雄,13,1,12,1,0.82
"20210908","1783","8151","8150",台新-建北,0,20,20,-1,1.37
"20210908","1783","9322","9300",華南永昌-公誠,13,1,12,1,0.82
"20210908","1783","0037003000300049","7000",兆豐-北高雄,0,18,18,-1,1.23
"20210908","1783","1041","1040",臺銀-鳳山,10,0,10,1,0.68
"20210908","1783","1560","1560",港商野村,73,89,16,-1,1.09
"20210908","1783","1040","1040",臺銀,10,0,10,1,0.68
"20210908","1783","0038003800340042","8840",玉山-台中,2,17,15,-1,1.03
"20210908","1783","6910","6910",德信,10,0,10,1,0.68
"20210908","1783","0039003600320046","9600",富邦-北桃園(停),0,13,13,-1,0.89
"20210908","1783","0037003000300045","7000",兆豐-斗南(停),10,0,10,1,0.68
"20210908","1783","8560","8560",新光,29,39,10,-1,0.68
"20210908","1783","0039003100330052","9100",群益金鼎-北高雄,10,0,10,1,0.68
"20210908","1783","0039003100330045","9100",群益金鼎-基隆,1,11,10,-1,0.68
"20210909","1783","1470","1470",台灣摩根士丹利,87,5,82,1,11.22
"20210909","1783","0035003900320055","5920",元富-宜蘭,0,23,23,-1,3.15
"20210909","1783","1480","1480",美商高盛,58,4,54,1,7.39
"20210909","1783","0039003800390058","9800",元大-民生,0,22,22,-1,3.01
"20210909","1783","9268","9200",凱基-台北,47,15,32,1,4.38
"20210909","1783","5854","5850",統一-城中,0,20,20,-1,2.74
"20210909","1783","1560","1560",港商野村,61,30,31,1,4.24
"20210909","1783","0039003800390051","9800",元大-汐止,6,26,20,-1,2.74
"20210909","1783","1650","1650",新加坡商瑞銀,20,0,20,1,2.74
"20210909","1783","8150","8150",台新證券,0,16,16,-1,2.19
"20210909","1783","9814","9800",元大-大益,20,1,19,1,2.60
"20210909","1783","1041","1040",臺銀-鳳山,0,12,12,-1,1.64
"20210909","1783","1520","1520",瑞士信貸,32,14,18,1,2.46
"20210909","1783","9659","9600",富邦-高雄,3,15,12,-1,1.64
"20210909","1783","1440","1440",美林,16,2,14,1,1.92
"20210909","1783","1029","1020",合庫-鳳山,0,11,11,-1,1.50
"20210909","1783","9329","9300",華南永昌-朴子,15,2,13,1,1.78
"20210909","1783","8520","8520",中農,0,10,10,-1,1.37
"20210909","1783","0037003000300048","7000",兆豐-東門,11,0,11,1,1.50
"20210909","1783","9204","9200",凱基-台中,0,10,10,-1,1.37
"20210909","1783","9324","9300",華南永昌-岡山,10,0,10,1,1.37
"20210909","1783","9884","9800",元大-斗信,0,10,10,-1,1.37
"20210909","1783","9665","9600",富邦-桃園,8,0,8,1,1.09
"20210909","1783","9853","9800",元大-南屯,0,10,10,-1,1.37
"20210909","1783","9229","9200",凱基-中山,7,0,7,1,0.96
"20210909","1783","8561","8560",新光-台中,0,9,9,-1,1.23
"20210909","1783","5603","5600",永興-台中,6,0,6,1,0.82
"20210909","1783","0039003100330052","9100",群益金鼎-北高雄,0,9,9,-1,1.23
"20210910","1783","1520","1520",瑞士信貸,38,0,38,1,4.74
"20210910","1783","9268","9200",凱基-台北,10,85,75,-1,9.35
"20210910","1783","0037003000300066","7000",兆豐-鹿港,31,0,31,1,3.87
"20210910","1783","1440","1440",美林,7,53,46,-1,5.74
"20210910","1783","9229","9200",凱基-中山,25,2,23,1,2.87
"20210910","1783","1560","1560",港商野村,28,62,34,-1,4.24
"20210910","1783","9237","9200",凱基-敦北,15,0,15,1,1.87
"20210910","1783","9871","9800",元大-忠孝,0,30,30,-1,3.74
"20210910","1783","9853","9800",元大-南屯,15,0,15,1,1.87
"20210910","1783","1020","1020",合庫證券,0,20,20,-1,2.49
"20210910","1783","0039003800390058","9800",元大-民生,20,7,13,1,1.62
"20210910","1783","8561","8560",新光-台中,0,19,19,-1,2.37
"20210910","1783","6912","6910",德信-中正,11,0,11,1,1.37
"20210910","1783","1590","1590",花旗環球,0,16,16,-1,2.00
"20210910","1783","9377","9300",華南永昌-虎尾,16,5,11,1,1.37
"20210910","1783","1480","1480",美商高盛,11,26,15,-1,1.87
"20210910","1783","9898","9800",元大-新莊,11,0,11,1,1.37
"20210910","1783","9329","9300",華南永昌-朴子,1,15,14,-1,1.75
"20210910","1783","1029","1020",合庫-鳳山,10,0,10,1,1.25
"20210910","1783","0037003000300048","7000",兆豐-東門,0,10,10,-1,1.25
"20210910","1783","1041","1040",臺銀-鳳山,11,1,10,1,1.25
"20210910","1783","9324","9300",華南永昌-岡山,0,10,10,-1,1.25
"20210910","1783","5854","5850",統一-城中,20,10,10,1,1.25
"20210910","1783","1650","1650",新加坡商瑞銀,0,8,8,-1,1.00
"20210910","1783","9204","9200",凱基-台中,10,0,10,1,1.25
"20210910","1783","9857","9800",元大-東蘆,2,10,8,-1,1.00
"20210910","1783","9319","9300",華南永昌-鶯歌,10,0,10,1,1.25
"20210910","1783","9665","9600",富邦-桃園,1,8,7,-1,0.87
"20210913","1783","1480","1480",美商高盛,60,1,59,1,14.05
"20210913","1783","5603","5600",永興-台中,0,28,28,-1,6.67
"20210913","1783","1470","1470",台灣摩根士丹利,52,6,46,1,10.95
"20210913","1783","0039003800390058","9800",元大-民生,0,15,15,-1,3.57
"20210913","1783","8440","8440",摩根大通,55,9,46,1,10.95
"20210913","1783","9898","9800",元大-新莊,0,11,11,-1,2.62
"20210913","1783","1440","1440",美林,16,0,16,1,3.81
"20210913","1783","5854","5850",統一-城中,0,10,10,-1,2.38
"20210913","1783","1560","1560",港商野村,20,5,15,1,3.57
"20210913","1783","0037003700390050","7790",國票-九鼎,0,10,10,-1,2.38
"20210913","1783","1650","1650",新加坡商瑞銀,12,0,12,1,2.86
"20210913","1783","9319","9300",華南永昌-鶯歌,0,10,10,-1,2.38
"20210913","1783","0039004100380046","9A00",永豐金-敦南,7,0,7,1,1.67
"20210913","1783","8560","8560",新光,0,9,9,-1,2.14
"20210913","1783","9859","9800",元大-新竹經國,6,0,6,1,1.43
"20210913","1783","9215","9200",凱基-高美館,0,7,7,-1,1.67
"20210913","1783","1520","1520",瑞士信貸,5,0,5,1,1.19
"20210913","1783","9237","9200",凱基-敦北,0,6,6,-1,1.43
"20210913","1783","0038003100350059","8150",台新-新營,5,0,5,1,1.19
"20210913","1783","9184","9100",群益金鼎-台中,0,5,5,-1,1.19
"20210913","1783","8565","8560",新光-桃園,6,1,5,1,1.19
"20210913","1783","1029","1020",合庫-鳳山,5,10,5,-1,1.19
"20210913","1783","9229","9200",凱基-中山,5,0,5,1,1.19
"20210913","1783","0035003900320049","5920",元富-嘉義,0,5,5,-1,1.19
"20210913","1783","8159","8150",台新-台南,6,2,4,1,0.95
"20210913","1783","8887","8880",國泰-忠孝,0,5,5,-1,1.19
"20210913","1783","9377","9300",華南永昌-虎尾,3,0,3,1,0.71
"20210913","1783","9623","9600",富邦-台北,0,5,5,-1,1.19
"20210914","1783","003900380039004c","9800",元大-成功,20,0,20,1,6.17
"20210914","1783","9853","9800",元大-南屯,0,10,10,-1,3.09
"20210914","1783","1440","1440",美林,25,14,11,1,3.40
"20210914","1783","0039003100380050","9100",群益金鼎-天母,0,10,10,-1,3.09
"20210914","1783","9319","9300",華南永昌-鶯歌,10,0,10,1,3.09
"20210914","1783","9204","9200",凱基-台中,0,10,10,-1,3.09
"20210914","1783","0039003600320059","9600",富邦-土城,10,0,10,1,3.09
"20210914","1783","0039003800390047","9800",元大-大同,0,10,10,-1,3.09
"20210914","1783","0039003200320048","9200",凱基-復興,8,0,8,1,2.47
"20210914","1783","5384","5380",第一金-台南,1,6,5,-1,1.54
"20210914","1783","1520","1520",瑞士信貸,20,13,7,1,2.16
"20210914","1783","5851","5850",統一-高雄,0,5,5,-1,1.54
"20210914","1783","1480","1480",美商高盛,22,15,7,1,2.16
"20210914","1783","0039003100330044","9100",群益金鼎-潭子,0,5,5,-1,1.54
"20210914","1783","003900380030004b","9800",元大-竹科,7,0,7,1,2.16
"20210914","1783","9258","9200",凱基-羅東,0,5,5,-1,1.54
"20210914","1783","9897","9800",元大-土城,7,0,7,1,2.16
"20210914","1783","9623","9600",富邦-台北,0,5,5,-1,1.54
"20210914","1783","9852","9800",元大-永春,6,0,6,1,1.85
"20210914","1783","0031003200360069","1260",宏遠-光隆,1,5,4,-1,1.23
"20210914","1783","1029","1020",合庫-鳳山,5,1,4,1,1.23
"20210914","1783","0035003300380057","5380",第一金-華江,0,4,4,-1,1.23
"20210914","1783","0038003800380041","8880",國泰-館前,4,0,4,1,1.23
"20210914","1783","8159","8150",台新-台南,0,4,4,-1,1.23
"20210914","1783","0035003300380050","5380",第一金-路竹,2,0,2,1,0.62
"20210914","1783","0039004100390066","9A00",永豐金-中盛,0,4,4,-1,1.23
"20210914","1783","0031003000320043","1020",合庫-自強,2,0,2,1,0.62
"20210914","1783","1650","1650",新加坡商瑞銀,0,3,3,-1,0.93
"20210915","1783","1480","1480",美商高盛,32,6,26,1,7.37
"20210915","1783","1440","1440",美林,0,31,31,-1,8.78
"20210915","1783","1520","1520",瑞士信貸,18,0,18,1,5.10
"20210915","1783","8440","8440",摩根大通,1,27,26,-1,7.37
"20210915","1783","5854","5850",統一-城中,15,0,15,1,4.25
"20210915","1783","0039004100390061","9A00",永豐金-苓雅,0,12,12,-1,3.40
"20210915","1783","9204","9200",凱基-台中,10,0,10,1,2.83
"20210915","1783","8150","8150",台新證券,0,9,9,-1,2.55
"20210915","1783","0039003800390058","9800",元大-民生,10,0,10,1,2.83
"20210915","1783","003900380039006d","9800",元大-信義,0,9,9,-1,2.55
"20210915","1783","1650","1650",新加坡商瑞銀,9,0,9,1,2.55
"20210915","1783","9658","9600",富邦-建國,0,8,8,-1,2.27
"20210915","1783","0037003700390050","7790",國票-九鼎,9,0,9,1,2.55
"20210915","1783","9800","9800",元大證券,3,10,7,-1,1.98
"20210915","1783","0031003200360069","1260",宏遠-光隆,8,0,8,1,2.27
"20210915","1783","003500380035004a","5850",統一-三重,0,6,6,-1,1.70
"20210915","1783","9853","9800",元大-南屯,7,0,7,1,1.98
"20210915","1783","0039003200300047","9200",凱基-彰化,0,6,6,-1,1.70
"20210915","1783","0035003900320055","5920",元富-宜蘭,5,0,5,1,1.42
"20210915","1783","0039003600320046","9600",富邦-北桃園(停),0,6,6,-1,1.70
"20210915","1783","6461","6460",大昌-樹林,5,0,5,1,1.42
"20210915","1783","0039004100390047","9A00",永豐金-天母,0,6,6,-1,1.70
"20210915","1783","9105","9100",群益金鼎-高盛,5,0,5,1,1.42
"20210915","1783","003900360032004b","9600",富邦-中和,0,5,5,-1,1.42
"20210915","1783","0039003100380047","9100",群益金鼎-新莊,4,0,4,1,1.13
"20210915","1783","9838","9800",元大-豐原,0,5,5,-1,1.42
"20210915","1783","9255","9200",凱基-和平,4,0,4,1,1.13
"20210915","1783","0038003800340046","8840",玉山-桃園,0,5,5,-1,1.42
"20210927","1783","9333","9300",華南永昌-長虹,108,7,101,1,7.17
"20210927","1783","5854","5850",統一-城中,0,50,50,-1,3.55
"20210927","1783","1480","1480",美商高盛,70,11,59,1,4.19
"20210927","1783","0039003800390058","9800",元大-民生,0,50,50,-1,3.55
"20210927","1783","9105","9100",群益金鼎-高盛,40,0,40,1,2.84
"20210927","1783","0039004100390041","9A00",永豐金-羅東,0,50,50,-1,3.55
"20210927","1783","1560","1560",港商野村,54,19,35,1,2.49
"20210927","1783","1470","1470",台灣摩根士丹利,28,76,48,-1,3.41
"20210927","1783","0037003000300048","7000",兆豐-東門,31,4,27,1,1.92
"20210927","1783","8440","8440",摩根大通,51,89,38,-1,2.70
"20210927","1783","0035003300380044","5380",第一金-忠孝,23,0,23,1,1.63
"20210927","1783","1115","1110",台灣企銀-太平,0,30,30,-1,2.13
"20210927","1783","0039003800310053","9800",元大-崇德,19,1,18,1,1.28
"20210927","1783","9327","9300",華南永昌-斗六,0,25,25,-1,1.78
"20210927","1783","9661","9600",富邦-新店,17,0,17,1,1.21
"20210927","1783","8560","8560",新光,5,29,24,-1,1.70
"20210927","1783","003800380038004b","8880",國泰-板橋,19,2,17,1,1.21
"20210927","1783","8848","8840",玉山-嘉義,0,23,23,-1,1.63
"20210927","1783","8884","8880",國泰-台南,20,5,15,1,1.07
"20210927","1783","6460","6460",大昌,15,37,22,-1,1.56
"20210927","1783","9234","9200",凱基-竹北,22,10,12,1,0.85
"20210927","1783","0039004100390043","9A00",永豐金-員林,0,22,22,-1,1.56
"20210927","1783","1520","1520",瑞士信貸,11,0,11,1,0.78
"20210927","1783","5264","5260",美好-高雄,0,20,20,-1,1.42
"20210927","1783","0037003700390058","7790",國票-中和,11,0,11,1,0.78
"20210927","1783","0036003000310064","6010",(牛牛牛)亞-鑫豐,1,21,20,-1,1.42
"20210927","1783","9324","9300",華南永昌-岡山,10,0,10,1,0.71
"20210927","1783","0039003800390064","9800",元大-北屯,0,20,20,-1,1.42
"20210928","1783","9800","9800",元大證券,40,0,40,1,3.39
"20210928","1783","1440","1440",美林,3,127,124,-1,10.52
"20210928","1783","0039003100380050","9100",群益金鼎-天母,35,0,35,1,2.97
"20210928","1783","9268","9200",凱基-台北,49,160,111,-1,9.41
"20210928","1783","8580","8580",聯邦商銀,37,3,34,1,2.88
"20210928","1783","1480","1480",美商高盛,2,95,93,-1,7.89
"20210928","1783","5850","5850",統一,32,2,30,1,2.54
"20210928","1783","1520","1520",瑞士信貸,0,71,71,-1,6.02
"20210928","1783","5854","5850",統一-城中,35,5,30,1,2.54
"20210928","1783","8440","8440",摩根大通,8,70,62,-1,5.26
"20210928","1783","0039003800390058","9800",元大-民生,30,0,30,1,2.54
"20210928","1783","1650","1650",新加坡商瑞銀,0,24,24,-1,2.04
"20210928","1783","5384","5380",第一金-台南,27,2,25,1,2.12
"20210928","1783","6461","6460",大昌-樹林,0,16,16,-1,1.36
"20210928","1783","0036003000310064","6010",(牛牛牛)亞-鑫豐,35,13,22,1,1.87
"20210928","1783","9661","9600",富邦-新店,1,14,13,-1,1.10
"20210928","1783","6464","6460",大昌-新店,20,1,19,1,1.61
"20210928","1783","9234","9200",凱基-竹北,0,12,12,-1,1.02
"20210928","1783","0039004100390037","9A00",永豐金-新竹,17,0,17,1,1.44
"20210928","1783","6912","6910",德信-中正,12,23,11,-1,0.93
"20210928","1783","9238","9200",凱基-士林,16,1,15,1,1.27
"20210928","1783","0037003700390058","7790",國票-中和,0,11,11,-1,0.93
"20210928","1783","9302","9300",華南永昌-台中,15,0,15,1,1.27
"20210928","1783","8884","8880",國泰-台南,2,12,10,-1,0.85
"20210928","1783","5261","5260",美好-蘆洲,14,0,14,1,1.19
"20210928","1783","9319","9300",華南永昌-鶯歌,0,10,10,-1,0.85
"20210928","1783","003900380039004a","9800",元大-彰化民生,14,0,14,1,1.19
"20210928","1783","0039004100390062","9A00",永豐金-虎尾,0,10,10,-1,0.85
"20210929","1783","0039003800390047","9800",元大-大同,30,0,30,1,3.21
"20210929","1783","1480","1480",美商高盛,4,82,78,-1,8.34
"20210929","1783","0039003800390058","9800",元大-民生,30,0,30,1,3.21
"20210929","1783","1650","1650",新加坡商瑞銀,0,63,63,-1,6.74
"20210929","1783","0039003600320056","9600",富邦-復興,20,0,20,1,2.14
"20210929","1783","1470","1470",台灣摩根士丹利,0,50,50,-1,5.35
"20210929","1783","5603","5600",永興-台中,19,0,19,1,2.03
"20210929","1783","1036","1030",土銀-玉里,0,35,35,-1,3.74
"20210929","1783","5384","5380",第一金-台南,16,0,16,1,1.71
"20210929","1783","0035003800350055","5850",統一-南京,60,94,34,-1,3.64
"20210929","1783","0039004100300030","9A00",永豐金證券,24,9,15,1,1.60
"20210929","1783","5850","5850",統一,0,24,24,-1,2.57
"20210929","1783","0031003000330046","1030",土銀-南港,14,0,14,1,1.50
"20210929","1783","0035003300380044","5380",第一金-忠孝,0,23,23,-1,2.46
"20210929","1783","9238","9200",凱基-士林,14,0,14,1,1.50
"20210929","1783","6464","6460",大昌-新店,0,20,20,-1,2.14
"20210929","1783","9692","9600",富邦-嘉義,18,5,13,1,1.39
"20210929","1783","003800380038004b","8880",國泰-板橋,2,19,17,-1,1.82
"20210929","1783","8848","8840",玉山-嘉義,12,0,12,1,1.28
"20210929","1783","6460","6460",大昌,0,15,15,-1,1.60
"20210929","1783","9204","9200",凱基-台中,11,0,11,1,1.18
"20210929","1783","2180","2180",亞東,10,20,10,-1,1.07
"20210929","1783","0039003600320059","9600",富邦-土城,11,0,11,1,1.18
"20210929","1783","0037003000300048","7000",兆豐-東門,0,10,10,-1,1.07
"20210929","1783","1232","1230",彰銀-七賢,10,0,10,1,1.07
"20210929","1783","9227","9200",凱基-城中,0,10,10,-1,1.07
"20210929","1783","5922","5920",元富-新店,10,0,10,1,1.07
"20210929","1783","9319","9300",華南永昌-鶯歌,0,10,10,-1,1.07
"20210930","1783","9614","9600",富邦-基隆,20,0,20,1,5.05
"20210930","1783","9268","9200",凱基-台北,24,56,32,-1,8.08
"20210930","1783","9189","9100",群益金鼎-桃園,20,1,19,1,4.80
"20210930","1783","1560","1560",港商野村,17,38,21,-1,5.30
"20210930","1783","0039004100390043","9A00",永豐金-員林,19,4,15,1,3.79
"20210930","1783","1650","1650",新加坡商瑞銀,0,19,19,-1,4.80
"20210930","1783","0031003000320043","1020",合庫-自強,12,0,12,1,3.03
"20210930","1783","1440","1440",美林,0,17,17,-1,4.29
"20210930","1783","0031003000330046","1030",土銀-南港,10,0,10,1,2.53
"20210930","1783","003900310038007a","9100",群益金鼎-宜蘭,0,10,10,-1,2.53
"20210930","1783","5921","5920",元富-高雄,10,0,10,1,2.53
"20210930","1783","0039003600330041","9600",富邦-八德,0,10,10,-1,2.53
"20210930","1783","6620","6620",口袋證券,6,0,6,1,1.52
"20210930","1783","9661","9600",富邦-新店,2,7,5,-1,1.26
"20210930","1783","8156","8150",台新-三民,6,0,6,1,1.52
"20210930","1783","5261","5260",美好-蘆洲,0,5,5,-1,1.26
"20210930","1783","9208","9200",凱基-桃園,6,0,6,1,1.52
"20210930","1783","0035003900320064","5920",元富-延平(停),0,5,5,-1,1.26
"20210930","1783","9315","9300",華南永昌-苑裡,6,0,6,1,1.52
"20210930","1783","0038003100350059","8150",台新-新營,0,5,5,-1,1.26
"20210930","1783","2180","2180",亞東,5,0,5,1,1.26
"20210930","1783","9135","9100",群益金鼎-東大,0,5,5,-1,1.26
"20210930","1783","5854","5850",統一-城中,10,5,5,1,1.26
"20210930","1783","9188","9100",群益金鼎-三民,0,5,5,-1,1.26
"20210930","1783","0039003800390058","9800",元大-民生,10,5,5,1,1.26
"20210930","1783","0039003800300044","9800",元大-北府,0,4,4,-1,1.01
"20210930","1783","6168","6160",中國信託-嘉義,4,0,4,1,1.01
"20210930","1783","1470","1470",台灣摩根士丹利,0,3,3,-1,0.76
"20210802","1783","8440","8440",摩根大通,424,168,256,1,6.24
"20210802","1783","9208","9200",凱基-桃園,40,136,96,-1,2.34
"20210802","1783","1520","1520",瑞士信貸,138,18,120,1,2.92
"20210802","1783","1260","1260",宏遠證券,15,86,71,-1,1.73
"20210802","1783","1650","1650",新加坡商瑞銀,118,3,115,1,2.80
"20210802","1783","9317","9300",華南永昌-林口,3,63,60,-1,1.46
"20210802","1783","0035003900320047","5920",元富-新竹,108,0,108,1,2.63
"20210802","1783","0031003000320045","1020",合庫-桃園,0,52,52,-1,1.27
"20210802","1783","1440","1440",美林,81,29,52,1,1.27
"20210802","1783","9834","9800",元大-中壢,3,55,52,-1,1.27
"20210802","1783","6910","6910",德信,40,1,39,1,0.95
"20210802","1783","9285","9200",凱基-中壢,23,72,49,-1,1.19
"20210802","1783","9215","9200",凱基-高美館,30,3,27,1,0.66
"20210802","1783","9319","9300",華南永昌-鶯歌,0,44,44,-1,1.07
"20210802","1783","5850","5850",統一,24,1,23,1,0.56
"20210802","1783","5320","5320",高橋,0,44,44,-1,1.07
"20210802","1783","0039003200300041","9200",凱基-板橋,20,0,20,1,0.49
"20210802","1783","003500390032004c","5920",元富-中壢,0,36,36,-1,0.88
"20210802","1783","0039003600310043","9600",富邦-南京,21,3,18,1,0.44
"20210802","1783","9636","9600",富邦-中壢,28,58,30,-1,0.73
"20210802","1783","5854","5850",統一-城中,50,35,15,1,0.37
"20210802","1783","0037003700390045","7790",國票-南崁,2,31,29,-1,0.71
"20210802","1783","9817","9800",元大-東泰,60,45,15,1,0.37
"20210802","1783","9362","9300",華南永昌-苗栗,0,23,23,-1,0.56
"20210802","1783","8560","8560",新光,61,46,15,1,0.37
"20210802","1783","5603","5600",永興-台中,0,22,22,-1,0.54
"20210802","1783","9692","9600",富邦-嘉義,57,43,14,1,0.34
"20210802","1783","9308","9300",華南永昌-麻豆,0,21,21,-1,0.51
"20210803","1783","1650","1650",新加坡商瑞銀,166,14,152,1,3.65
"20210803","1783","5852","5850",統一-敦南,0,94,94,-1,2.26
"20210803","1783","9319","9300",華南永昌-鶯歌,130,14,116,1,2.79
"20210803","1783","1520","1520",瑞士信貸,3,96,93,-1,2.24
"20210803","1783","9666","9600",富邦-南屯,50,0,50,1,1.20
"20210803","1783","0037003000300048","7000",兆豐-東門,0,90,90,-1,2.16
"20210803","1783","1560","1560",港商野村,169,127,42,1,1.01
"20210803","1783","0035003900320048","5920",元富-信義,0,80,80,-1,1.92
"20210803","1783","003900380039004a","9800",元大-彰化民生,46,6,40,1,0.96
"20210803","1783","0037003700390072","7790",國票-桃園,0,79,79,-1,1.90
"20210803","1783","9834","9800",元大-中壢,46,7,39,1,0.94
"20210803","1783","9331","9300",華南永昌-鳳山,4,81,77,-1,1.85
"20210803","1783","9623","9600",富邦-台北,44,7,37,1,0.89
"20210803","1783","5854","5850",統一-城中,15,66,51,-1,1.23
"20210803","1783","1440","1440",美林,81,46,35,1,0.84
"20210803","1783","9307","9300",華南永昌-大安,0,51,51,-1,1.23
"20210803","1783","0037003700390045","7790",國票-南崁,30,0,30,1,0.72
"20210803","1783","003500380035005a","5850",統一-松江,0,30,30,-1,0.72
"20210803","1783","9105","9100",群益金鼎-高盛,30,0,30,1,0.72
"20210803","1783","9100","9100",群益金鼎,2,32,30,-1,0.72
"20210803","1783","5850","5850",統一,32,3,29,1,0.70
"20210803","1783","9333","9300",華南永昌-長虹,2,32,30,-1,0.72
"20210803","1783","0039003600310057","9600",富邦-東花蓮,29,0,29,1,0.70
"20210803","1783","003900380039004c","9800",元大-成功,2,31,29,-1,0.70
"20210803","1783","003800380038004b","8880",國泰-板橋,38,12,26,1,0.63
"20210803","1783","0039003800340043","9800",元大-新店中正,1,30,29,-1,0.70
"20210803","1783","9636","9600",富邦-中壢,51,26,25,1,0.60
"20210803","1783","0039003200300046","9200",凱基-站前,9,37,28,-1,0.67
"20210804","1783","5852","5850",統一-敦南,66,0,66,1,2.80
"20210804","1783","9278","9200",凱基-永康,1,78,77,-1,3.27
"20210804","1783","9331","9300",華南永昌-鳳山,51,15,36,1,1.53
"20210804","1783","9666","9600",富邦-南屯,3,56,53,-1,2.25
"20210804","1783","0037003700390072","7790",國票-桃園,31,0,31,1,1.32
"20210804","1783","9623","9600",富邦-台北,21,68,47,-1,2.00
"20210804","1783","9204","9200",凱基-台中,31,0,31,1,1.32
"20210804","1783","003900380031005a","9800",元大-潮州,5,45,40,-1,1.70
"20210804","1783","5920","5920",元富,30,0,30,1,1.27
"20210804","1783","0039003800310067","9800",元大-大里,3,32,29,-1,1.23
"20210804","1783","5854","5850",統一-城中,30,1,29,1,1.23
"20210804","1783","0037003700390045","7790",國票-南崁,2,30,28,-1,1.19
"20210804","1783","9105","9100",群益金鼎-高盛,30,2,28,1,1.19
"20210804","1783","6461","6460",大昌-樹林,0,26,26,-1,1.10
"20210804","1783","0039003800390064","9800",元大-北屯,29,2,27,1,1.15
"20210804","1783","003800380038004b","8880",國泰-板橋,8,34,26,-1,1.10
"20210804","1783","5850","5850",統一,42,16,26,1,1.10
"20210804","1783","9634","9600",富邦-羅東,2,23,21,-1,0.89
"20210804","1783","0037003700390050","7790",國票-九鼎,52,27,25,1,1.06
"20210804","1783","9333","9300",華南永昌-長虹,0,20,20,-1,0.85
"20210804","1783","9878","9800",元大-金華,23,0,23,1,0.98
"20210804","1783","7006","7000",兆豐-台南,5,23,18,-1,0.76
"20210804","1783","1110","1110",台灣企銀,20,0,20,1,0.85
"20210804","1783","0035003900320067","5920",元富-中原,3,19,16,-1,0.68
"20210804","1783","0039003200300046","9200",凱基-站前,27,7,20,1,0.85
"20210804","1783","9362","9300",華南永昌-苗栗,25,41,16,-1,0.68
"20210804","1783","003900380036004b","9800",元大-基隆孝二,22,2,20,1,0.85
"20210804","1783","9838","9800",元大-豐原,0,16,16,-1,0.68
"20210805","1783","0039003800390058","9800",元大-民生,101,0,101,1,4.21
"20210805","1783","5923","5920",元富-三重,0,55,55,-1,2.29
"20210805","1783","9268","9200",凱基-台北,69,5,64,1,2.67
"20210805","1783","9319","9300",華南永昌-鶯歌,0,50,50,-1,2.08
"20210805","1783","1470","1470",台灣摩根士丹利,60,0,60,1,2.50
"20210805","1783","6465","6460",大昌-桃園,0,49,49,-1,2.04
"20210805","1783","5850","5850",統一,47,4,43,1,1.79
"20210805","1783","9189","9100",群益金鼎-桃園,1,36,35,-1,1.46
"20210805","1783","0037003700390057","7790",國票-彰化,36,0,36,1,1.50
"20210805","1783","9208","9200",凱基-桃園,0,34,34,-1,1.42
"20210805","1783","9326","9300",華南永昌-南京,87,53,34,1,1.42
"20210805","1783","0039003800310046","9800",元大-福營,0,34,34,-1,1.42
"20210805","1783","5852","5850",統一-敦南,30,0,30,1,1.25
"20210805","1783","5854","5850",統一-城中,0,32,32,-1,1.33
"20210805","1783","9101","9100",群益金鼎-敦南,29,5,24,1,1.00
"20210805","1783","9636","9600",富邦-中壢,0,31,31,-1,1.29
"20210805","1783","0035003900320067","5920",元富-中原,27,4,23,1,0.96
"20210805","1783","9204","9200",凱基-台中,3,29,26,-1,1.08
"20210805","1783","9323","9300",華南永昌-小港,31,9,22,1,0.92
"20210805","1783","0037003700390050","7790",國票-九鼎,0,25,25,-1,1.04
"20210805","1783","9835","9800",元大-員林中山,86,64,22,1,0.92
"20210805","1783","0039003200300046","9200",凱基-站前,1,23,22,-1,0.92
"20210805","1783","8564","8560",新光-台南,22,0,22,1,0.92
"20210805","1783","9331","9300",華南永昌-鳳山,3,25,22,-1,0.92
"20210805","1783","5926","5920",元富-四維(停),18,0,18,1,0.75
"20210805","1783","0037003700390072","7790",國票-桃園,0,20,20,-1,0.83
"20210805","1783","9333","9300",華南永昌-長虹,18,1,17,1,0.71
"20210805","1783","0039003200300043","9200",凱基-雙和,0,18,18,-1,0.75
"20210806","1783","1261","1260",宏遠-民生,49,9,40,1,1.69
"20210806","1783","6452","6450",永全-八德,0,51,51,-1,2.15
"20210806","1783","9105","9100",群益金鼎-高盛,40,0,40,1,1.69
"20210806","1783","8560","8560",新光,32,76,44,-1,1.86
"20210806","1783","1470","1470",台灣摩根士丹利,39,0,39,1,1.65
"20210806","1783","8886","8880",國泰-新莊,0,41,41,-1,1.73
"20210806","1783","9278","9200",凱基-永康,38,0,38,1,1.60
"20210806","1783","9835","9800",元大-員林中山,3,41,38,-1,1.60
"20210806","1783","9893","9800",元大-大天母,36,3,33,1,1.39
"20210806","1783","5850","5850",統一,31,68,37,-1,1.56
"20210806","1783","0036003300380041","6380",光和-嘉義,31,0,31,1,1.31
"20210806","1783","0037003700390057","7790",國票-彰化,0,36,36,-1,1.52
"20210806","1783","0037003700390045","7790",國票-南崁,30,0,30,1,1.27
"20210806","1783","9319","9300",華南永昌-鶯歌,2,35,33,-1,1.39
"20210806","1783","6168","6160",中國信託-嘉義,31,1,30,1,1.27
"20210806","1783","0039004100370039","9A00",永豐金-埔里,0,32,32,-1,1.35
"20210806","1783","0037003700390072","7790",國票-桃園,29,0,29,1,1.22
"20210806","1783","9101","9100",群益金鼎-敦南,15,44,29,-1,1.22
"20210806","1783","9287","9200",凱基-內湖,29,0,29,1,1.22
"20210806","1783","0039003800310061","9800",元大-歸仁,1,27,26,-1,1.10
"20210806","1783","0037003700390076","7790",國票-台中,63,37,26,1,1.10
"20210806","1783","9307","9300",華南永昌-大安,0,24,24,-1,1.01
"20210806","1783","6461","6460",大昌-樹林,24,0,24,1,1.01
"20210806","1783","0039003200300047","9200",凱基-彰化,0,23,23,-1,0.97
"20210806","1783","9871","9800",元大-忠孝,37,13,24,1,1.01
"20210806","1783","6114","6110",台中銀-員林,4,26,22,-1,0.93
"20210806","1783","0039003200300046","9200",凱基-站前,25,2,23,1,0.97
"20210806","1783","003500380035004d","5850",統一-士林,10,30,20,-1,0.84
"20210809","1783","0038003100350042","8150",台新-台中,95,55,40,1,1.18
"20210809","1783","1650","1650",新加坡商瑞銀,0,80,80,-1,2.36
"20210809","1783","8150","8150",台新證券,60,23,37,1,1.09
"20210809","1783","9326","9300",華南永昌-南京,0,64,64,-1,1.89
"20210809","1783","8440","8440",摩根大通,38,4,34,1,1.00
"20210809","1783","1261","1260",宏遠-民生,9,49,40,-1,1.18
"20210809","1783","0037003700390072","7790",國票-桃園,31,0,31,1,0.91
"20210809","1783","5852","5850",統一-敦南,9,39,30,-1,0.88
"20210809","1783","9215","9200",凱基-高美館,31,0,31,1,0.91
"20210809","1783","003900380031004b","9800",元大-林園,0,30,30,-1,0.88
"20210809","1783","9223","9200",凱基-豐中,39,8,31,1,0.91
"20210809","1783","0037003700390045","7790",國票-南崁,1,30,29,-1,0.85
"20210809","1783","6162","6160",中國信託-忠孝,30,0,30,1,0.88
"20210809","1783","003900310033004e","9100",群益金鼎-土城,1,29,28,-1,0.82
"20210809","1783","0039004100390063","9A00",永豐金-永康,32,3,29,1,0.85
"20210809","1783","9287","9200",凱基-內湖,1,29,28,-1,0.82
"20210809","1783","1470","1470",台灣摩根士丹利,49,22,27,1,0.80
"20210809","1783","003800380038004b","8880",國泰-板橋,9,36,27,-1,0.80
"20210809","1783","9255","9200",凱基-和平,36,10,26,1,0.77
"20210809","1783","9307","9300",華南永昌-大安,0,25,25,-1,0.74
"20210809","1783","0039003800390058","9800",元大-民生,112,87,25,1,0.74
"20210809","1783","9278","9200",凱基-永康,0,24,24,-1,0.71
"20210809","1783","1110","1110",台灣企銀,22,0,22,1,0.65
"20210809","1783","0035003300380042","5380",第一金-新竹,0,22,22,-1,0.65
"20210809","1783","1030","1030",土銀,21,0,21,1,0.62
"20210809","1783","9871","9800",元大-忠孝,11,33,22,-1,0.65
"20210809","1783","8843","8840",玉山-高雄,22,1,21,1,0.62
"20210809","1783","0037003700390058","7790",國票-中和,12,33,21,-1,0.62
"20210810","1783","1470","1470",台灣摩根士丹利,142,0,142,1,4.99
"20210810","1783","8560","8560",新光,25,110,85,-1,2.99
"20210810","1783","5857","5850",統一-新竹,165,46,119,1,4.18
"20210810","1783","1650","1650",新加坡商瑞銀,0,57,57,-1,2.00
"20210810","1783","0039003600320058","9600",富邦-文化,70,3,67,1,2.35
"20210810","1783","1233","1230",彰銀-台中,2,53,51,-1,1.79
"20210810","1783","0039003800390058","9800",元大-民生,77,12,65,1,2.28
"20210810","1783","9893","9800",元大-大天母,12,60,48,-1,1.69
"20210810","1783","6165","6160",中國信託-新竹,48,6,42,1,1.48
"20210810","1783","0037003700390050","7790",國票-九鼎,2,45,43,-1,1.51
"20210810","1783","0037003700390076","7790",國票-台中,63,23,40,1,1.40
"20210810","1783","7798","7790",國票-內壢,3,44,41,-1,1.44
"20210810","1783","6460","6460",大昌,45,7,38,1,1.33
"20210810","1783","9834","9800",元大-中壢,0,36,36,-1,1.26
"20210810","1783","0037003700390045","7790",國票-南崁,33,1,32,1,1.12
"20210810","1783","0035003300380045","5380",第一金-自由,1,32,31,-1,1.09
"20210810","1783","9223","9200",凱基-豐中,32,1,31,1,1.09
"20210810","1783","6168","6160",中國信託-嘉義,0,31,31,-1,1.09
"20210810","1783","0037003700390072","7790",國票-桃園,30,0,30,1,1.05
"20210810","1783","0038003100350059","8150",台新-新營,0,30,30,-1,1.05
"20210810","1783","8156","8150",台新-三民,31,2,29,1,1.02
"20210810","1783","0039003200300046","9200",凱基-站前,2,32,30,-1,1.05
"20210810","1783","0035003900320047","5920",元富-新竹,28,0,28,1,0.98
"20210810","1783","9875","9800",元大-土城永寧,0,30,30,-1,1.05
"20210810","1783","003700300030004a","7000",兆豐-公益,30,8,22,1,0.77
"20210810","1783","0039003800390047","9800",元大-大同,0,30,30,-1,1.05
"20210810","1783","0038003400350046","8450",康和-仁愛,22,1,21,1,0.74
"20210810","1783","9623","9600",富邦-台北,8,37,29,-1,1.02
"20210811","1783","0037003000300048","7000",兆豐-東門,120,0,120,1,5.12
"20210811","1783","5852","5850",統一-敦南,0,101,101,-1,4.31
"20210811","1783","1470","1470",台灣摩根士丹利,100,0,100,1,4.27
"20210811","1783","9278","9200",凱基-永康,1,72,71,-1,3.03
"20210811","1783","5850","5850",統一,150,90,60,1,2.56
"20210811","1783","5384","5380",第一金-台南,40,101,61,-1,2.60
"20210811","1783","0038003100350042","8150",台新-台中,52,1,51,1,2.18
"20210811","1783","5853","5850",統一-中壢,0,60,60,-1,2.56
"20210811","1783","003700300030006a","7000",兆豐-大安,47,5,42,1,1.79
"20210811","1783","8563","8560",新光-新竹,2,62,60,-1,2.56
"20210811","1783","0037003700390076","7790",國票-台中,55,23,32,1,1.37
"20210811","1783","9859","9800",元大-新竹經國,0,50,50,-1,2.13
"20210811","1783","5857","5850",統一-新竹,61,34,27,1,1.15
"20210811","1783","0039003600310057","9600",富邦-東花蓮,0,33,33,-1,1.41
"20210811","1783","9239","9200",凱基-市政,34,11,23,1,0.98
"20210811","1783","7798","7790",國票-內壢,2,30,28,-1,1.20
"20210811","1783","9326","9300",華南永昌-南京,24,2,22,1,0.94
"20210811","1783","8156","8150",台新-三民,3,30,27,-1,1.15
"20210811","1783","0039003800390067","9800",元大-嘉義,23,2,21,1,0.90
"20210811","1783","7003","7000",兆豐-台中,0,21,21,-1,0.90
"20210811","1783","1110","1110",台灣企銀,20,0,20,1,0.85
"20210811","1783","0039003800390045","9800",元大-草屯,2,21,19,-1,0.81
"20210811","1783","0037003000300063","7000",兆豐-民生,20,0,20,1,0.85
"20210811","1783","8560","8560",新光,17,36,19,-1,0.81
"20210811","1783","9188","9100",群益金鼎-三民,20,0,20,1,0.85
"20210811","1783","5927","5920",元富-林園,1,19,18,-1,0.77
"20210811","1783","0039003100380064","9100",群益金鼎-內湖,20,0,20,1,0.85
"20210811","1783","0038003400350046","8450",康和-仁愛,4,22,18,-1,0.77
"20210812","1783","7031","7030",致和-台北,79,0,79,1,2.99
"20210812","1783","0037003000300048","7000",兆豐-東門,0,120,120,-1,4.55
"20210812","1783","0035003800350059","5850",統一-土城,34,0,34,1,1.29
"20210812","1783","0039003800390058","9800",元大-民生,5,96,91,-1,3.45
"20210812","1783","7038","7030",致和-南京,34,0,34,1,1.29
"20210812","1783","9319","9300",華南永昌-鶯歌,0,88,88,-1,3.33
"20210812","1783","003900310033004e","9100",群益金鼎-土城,34,0,34,1,1.29
"20210812","1783","8560","8560",新光,28,112,84,-1,3.18
"20210812","1783","9326","9300",華南永昌-南京,88,54,34,1,1.29
"20210812","1783","9658","9600",富邦-建國,0,73,73,-1,2.77
"20210812","1783","9873","9800",元大-西門,30,0,30,1,1.14
"20210812","1783","5384","5380",第一金-台南,1,42,41,-1,1.55
"20210812","1783","003700370039006e","7790",國票-南京,29,0,29,1,1.10
"20210812","1783","6165","6160",中國信託-新竹,9,49,40,-1,1.52
"20210812","1783","5852","5850",統一-敦南,29,0,29,1,1.10
"20210812","1783","0037003700390045","7790",國票-南崁,0,38,38,-1,1.44
"20210812","1783","5854","5850",統一-城中,29,0,29,1,1.10
"20210812","1783","9307","9300",華南永昌-大安,0,36,36,-1,1.36
"20210812","1783","0035003800350063","5850",統一-仁愛,29,0,29,1,1.10
"20210812","1783","6460","6460",大昌,0,33,33,-1,1.25
"20210812","1783","0036003300380041","6380",光和-嘉義,29,0,29,1,1.10
"20210812","1783","0038003100350042","8150",台新-台中,25,55,30,-1,1.14
"20210812","1783","9333","9300",華南永昌-長虹,29,0,29,1,1.10
"20210812","1783","0039004100390063","9A00",永豐金-永康,5,30,25,-1,0.95
"20210812","1783","9278","9200",凱基-永康,29,1,28,1,1.06
"20210812","1783","003700300030004a","7000",兆豐-公益,4,25,21,-1,0.80
"20210812","1783","0037003700390057","7790",國票-彰化,27,4,23,1,0.87
"20210812","1783","7034","7030",致和-金華,1,22,21,-1,0.80
"20210813","1783","8580","8580",聯邦商銀,55,0,55,1,2.45
"20210813","1783","8560","8560",新光,8,71,63,-1,2.81
"20210813","1783","5384","5380",第一金-台南,54,1,53,1,2.37
"20210813","1783","0037003700390076","7790",國票-台中,35,97,62,-1,2.77
"20210813","1783","8150","8150",台新證券,56,5,51,1,2.28
"20210813","1783","6915","6910",德信-和平,0,56,56,-1,2.50
"20210813","1783","9623","9600",富邦-台北,56,6,50,1,2.23
"20210813","1783","9297","9200",凱基-文心,0,55,55,-1,2.45
"20210813","1783","9268","9200",凱基-台北,84,37,47,1,2.10
"20210813","1783","0039003800390058","9800",元大-民生,40,84,44,-1,1.96
"20210813","1783","8563","8560",新光-新竹,46,1,45,1,2.01
"20210813","1783","9300","9300",華南永昌,2,38,36,-1,1.61
"20210813","1783","0037003700390045","7790",國票-南崁,36,0,36,1,1.61
"20210813","1783","0035003800350059","5850",統一-土城,0,34,34,-1,1.52
"20210813","1783","9893","9800",元大-大天母,36,0,36,1,1.61
"20210813","1783","0038003100350042","8150",台新-台中,47,81,34,-1,1.52
"20210813","1783","0039003800310053","9800",元大-崇德,36,1,35,1,1.56
"20210813","1783","0037003000300048","7000",兆豐-東門,0,30,30,-1,1.34
"20210813","1783","9875","9800",元大-土城永寧,35,0,35,1,1.56
"20210813","1783","9326","9300",華南永昌-南京,3,33,30,-1,1.34
"20210813","1783","9834","9800",元大-中壢,33,2,31,1,1.38
"20210813","1783","5854","5850",統一-城中,0,29,29,-1,1.29
"20210813","1783","0036003300380041","6380",光和-嘉義,29,0,29,1,1.29
"20210813","1783","003700370039006e","7790",國票-南京,0,29,29,-1,1.29
"20210813","1783","9871","9800",元大-忠孝,30,2,28,1,1.25
"20210813","1783","9333","9300",華南永昌-長虹,0,29,29,-1,1.29
"20210813","1783","7080","7080",石橋證券,27,0,27,1,1.20
"20210813","1783","0035003800350063","5850",統一-仁愛,1,29,28,-1,1.25
"20210816","1783","9614","9600",富邦-基隆,108,0,108,1,5.72
"20210816","1783","9268","9200",凱基-台北,19,104,85,-1,4.50
"20210816","1783","0039003800390058","9800",元大-民生,88,33,55,1,2.91
"20210816","1783","0038003400350046","8450",康和-仁愛,0,65,65,-1,3.44
"20210816","1783","8157","8150",台新-左楠,44,2,42,1,2.22
"20210816","1783","9623","9600",富邦-台北,10,72,62,-1,3.28
"20210816","1783","9871","9800",元大-忠孝,32,1,31,1,1.64
"20210816","1783","9215","9200",凱基-高美館,0,48,48,-1,2.54
"20210816","1783","003900380039004a","9800",元大-彰化民生,31,0,31,1,1.64
"20210816","1783","9658","9600",富邦-建國,2,49,47,-1,2.49
"20210816","1783","1036","1030",土銀-玉里,29,0,29,1,1.54
"20210816","1783","0038003100350042","8150",台新-台中,11,52,41,-1,2.17
"20210816","1783","0035003900320047","5920",元富-新竹,26,3,23,1,1.22
"20210816","1783","9105","9100",群益金鼎-高盛,5,38,33,-1,1.75
"20210816","1783","7080","7080",石橋證券,27,4,23,1,1.22
"20210816","1783","8158","8150",台新-松江,0,30,30,-1,1.59
"20210816","1783","9256","9200",凱基-南崁,21,0,21,1,1.11
"20210816","1783","8561","8560",新光-台中,2,32,30,-1,1.59
"20210816","1783","1110","1110",台灣企銀,20,0,20,1,1.06
"20210816","1783","0039004100390068","9A00",永豐金-台南,4,28,24,-1,1.27
"20210816","1783","9834","9800",元大-中壢,23,3,20,1,1.06
"20210816","1783","9893","9800",元大-大天母,11,34,23,-1,1.22
"20210816","1783","9800","9800",元大證券,20,1,19,1,1.01
"20210816","1783","003900380039006a","9800",元大-樹林,0,21,21,-1,1.11
"20210816","1783","1030","1030",土銀,17,0,17,1,0.90
"20210816","1783","8150","8150",台新證券,5,25,20,-1,1.06
"20210816","1783","0039003800350043","9800",元大-鳳中,19,2,17,1,0.90
"20210816","1783","0039003200310059","9200",凱基-東勢,0,20,20,-1,1.06
"20210817","1783","9614","9600",富邦-基隆,149,10,139,1,10.64
"20210817","1783","8157","8150",台新-左楠,0,50,50,-1,3.83
"20210817","1783","0037003700390076","7790",國票-台中,60,10,50,1,3.83
"20210817","1783","9268","9200",凱基-台北,0,43,43,-1,3.29
"20210817","1783","0038003100350042","8150",台新-台中,40,7,33,1,2.52
"20210817","1783","0039003600310043","9600",富邦-南京,0,40,40,-1,3.06
"20210817","1783","5384","5380",第一金-台南,27,0,27,1,2.07
"20210817","1783","9834","9800",元大-中壢,1,40,39,-1,2.98
"20210817","1783","9131","9100",群益金鼎-民權,21,0,21,1,1.61
"20210817","1783","9307","9300",華南永昌-大安,2,36,34,-1,2.60
"20210817","1783","9223","9200",凱基-豐中,21,0,21,1,1.61
"20210817","1783","003700300030006a","7000",兆豐-大安,0,33,33,-1,2.52
"20210817","1783","9800","9800",元大證券,23,2,21,1,1.61
"20210817","1783","5852","5850",統一-敦南,0,32,32,-1,2.45
"20210817","1783","8150","8150",台新證券,25,4,21,1,1.61
"20210817","1783","5857","5850",統一-新竹,1,30,29,-1,2.22
"20210817","1783","1110","1110",台灣企銀,20,0,20,1,1.53
"20210817","1783","0039003100380041","9100",群益金鼎-中壢,0,29,29,-1,2.22
"20210817","1783","9815","9800",元大-大灣,20,0,20,1,1.53
"20210817","1783","8560","8560",新光,8,31,23,-1,1.76
"20210817","1783","0039003800350043","9800",元大-鳳中,19,0,19,1,1.45
"20210817","1783","003500330038004e","5380",第一金-豐原,0,23,23,-1,1.76
"20210817","1783","9692","9600",富邦-嘉義,30,13,17,1,1.30
"20210817","1783","9308","9300",華南永昌-麻豆,0,15,15,-1,1.15
"20210817","1783","1023","1020",合庫-高雄,16,1,15,1,1.15
"20210817","1783","0039003800380042","9800",元大-桃園,0,15,15,-1,1.15
"20210817","1783","003900380031005a","9800",元大-潮州,15,1,14,1,1.07
"20210817","1783","0037003000300048","7000",兆豐-東門,16,30,14,-1,1.07
"20210818","1783","6460","6460",大昌,105,0,105,1,2.48
"20210818","1783","5852","5850",統一-敦南,2,121,119,-1,2.81
"20210818","1783","5854","5850",統一-城中,102,20,82,1,1.94
"20210818","1783","9307","9300",華南永昌-大安,0,88,88,-1,2.08
"20210818","1783","8440","8440",摩根大通,184,107,77,1,1.82
"20210818","1783","9867","9800",元大-北成功,1,53,52,-1,1.23
"20210818","1783","9256","9200",凱基-南崁,63,3,60,1,1.42
"20210818","1783","6910","6910",德信,0,44,44,-1,1.04
"20210818","1783","1520","1520",瑞士信貸,58,0,58,1,1.37
"20210818","1783","0037003000300057","7000",兆豐-城中,0,39,39,-1,0.92
"20210818","1783","9871","9800",元大-忠孝,61,3,58,1,1.37
"20210818","1783","9692","9600",富邦-嘉義,14,45,31,-1,0.73
"20210818","1783","0039003800310053","9800",元大-崇德,57,6,51,1,1.20
"20210818","1783","9815","9800",元大-大灣,0,30,30,-1,0.71
"20210818","1783","0039003600320043","9600",富邦-東門,50,1,49,1,1.16
"20210818","1783","9362","9300",華南永昌-苗栗,0,29,29,-1,0.68
"20210818","1783","0037003000300056","7000",兆豐-新竹,50,12,38,1,0.90
"20210818","1783","9215","9200",凱基-高美館,1,29,28,-1,0.66
"20210818","1783","0036003300380041","6380",光和-嘉義,35,0,35,1,0.83
"20210818","1783","1043","1040",臺銀-民權,1,28,27,-1,0.64
"20210818","1783","9614","9600",富邦-基隆,34,4,30,1,0.71
"20210818","1783","0037003000300063","7000",兆豐-民生,1,28,27,-1,0.64
"20210818","1783","9185","9100",群益金鼎-台南,25,0,25,1,0.59
"20210818","1783","0039004100300030","9A00",永豐金證券,7,33,26,-1,0.61
"20210818","1783","1110","1110",台灣企銀,24,2,22,1,0.52
"20210818","1783","9623","9600",富邦-台北,46,71,25,-1,0.59
"20210818","1783","1560","1560",港商野村,244,222,22,1,0.52
"20210818","1783","003900380039004a","9800",元大-彰化民生,3,28,25,-1,0.59
"20210819","1783","1470","1470",台灣摩根士丹利,428,2,426,1,8.01
"20210819","1783","0039003800390047","9800",元大-大同,0,142,142,-1,2.67
"20210819","1783","9268","9200",凱基-台北,423,87,336,1,6.32
"20210819","1783","9871","9800",元大-忠孝,0,131,131,-1,2.46
"20210819","1783","8440","8440",摩根大通,327,107,220,1,4.14
"20210819","1783","6460","6460",大昌,12,111,99,-1,1.86
"20210819","1783","9834","9800",元大-中壢,158,14,144,1,2.71
"20210819","1783","8560","8560",新光,10,102,92,-1,1.73
"20210819","1783","9692","9600",富邦-嘉義,146,6,140,1,2.63
"20210819","1783","0039003800310053","9800",元大-崇德,0,85,85,-1,1.60
"20210819","1783","1440","1440",美林,92,2,90,1,1.69
"20210819","1783","0038003100350042","8150",台新-台中,6,63,57,-1,1.07
"20210819","1783","9333","9300",華南永昌-長虹,80,2,78,1,1.47
"20210819","1783","9859","9800",元大-新竹經國,0,51,51,-1,0.96
"20210819","1783","1480","1480",美商高盛,78,18,60,1,1.13
"20210819","1783","1520","1520",瑞士信貸,8,58,50,-1,0.94
"20210819","1783","0035003800350055","5850",統一-南京,73,20,53,1,1.00
"20210819","1783","0037003000300056","7000",兆豐-新竹,3,51,48,-1,0.90
"20210819","1783","5380","5380",第一金,64,11,53,1,1.00
"20210819","1783","0039003200300046","9200",凱基-站前,1,47,46,-1,0.87
"20210819","1783","9218","9200",凱基-大直,41,0,41,1,0.77
"20210819","1783","0039003600320043","9600",富邦-東門,8,51,43,-1,0.81
"20210819","1783","9223","9200",凱基-豐中,35,2,33,1,0.62
"20210819","1783","0037003700390072","7790",國票-桃園,0,43,43,-1,0.81
"20210819","1783","9816","9800",元大-新竹,81,50,31,1,0.58
"20210819","1783","8158","8150",台新-松江,0,41,41,-1,0.77
"20210819","1783","5850","5850",統一,63,33,30,1,0.56
"20210819","1783","7038","7030",致和-南京,0,33,33,-1,0.62
"20210820","1783","6162","6160",中國信託-忠孝,125,10,115,1,1.76
"20210820","1783","8440","8440",摩根大通,71,617,546,-1,8.34
"20210820","1783","0039003600320043","9600",富邦-東門,110,2,108,1,1.65
"20210820","1783","1470","1470",台灣摩根士丹利,80,449,369,-1,5.64
"20210820","1783","8560","8560",新光,136,47,89,1,1.36
"20210820","1783","9834","9800",元大-中壢,5,155,150,-1,2.29
"20210820","1783","9223","9200",凱基-豐中,103,18,85,1,1.30
"20210820","1783","9692","9600",富邦-嘉義,18,150,132,-1,2.02
"20210820","1783","0039003800390047","9800",元大-大同,73,1,72,1,1.10
"20210820","1783","1520","1520",瑞士信貸,0,109,109,-1,1.67
"20210820","1783","6460","6460",大昌,76,13,63,1,0.96
"20210820","1783","1440","1440",美林,62,156,94,-1,1.44
"20210820","1783","0035003300380046","5380",第一金-大稻埕,66,4,62,1,0.95
"20210820","1783","1480","1480",美商高盛,18,106,88,-1,1.34
"20210820","1783","6167","6160",中國信託-松江,55,1,54,1,0.83
"20210820","1783","0039003200300047","9200",凱基-彰化,14,91,77,-1,1.18
"20210820","1783","0039003200300046","9200",凱基-站前,54,5,49,1,0.75
"20210820","1783","5380","5380",第一金,0,56,56,-1,0.86
"20210820","1783","0039003800390058","9800",元大-民生,105,59,46,1,0.70
"20210820","1783","0035003800350055","5850",統一-南京,1,50,49,-1,0.75
"20210820","1783","8888","8880",國泰-敦南,133,93,40,1,0.61
"20210820","1783","1560","1560",港商野村,169,216,47,-1,0.72
"20210820","1783","8561","8560",新光-台中,42,2,40,1,0.61
"20210820","1783","9218","9200",凱基-大直,0,41,41,-1,0.63
"20210820","1783","0037003700390072","7790",國票-桃園,35,0,35,1,0.53
"20210820","1783","0039003800390045","9800",元大-草屯,11,43,32,-1,0.49
"20210820","1783","0037003700390076","7790",國票-台中,98,63,35,1,0.53
"20210820","1783","9816","9800",元大-新竹,1,32,31,-1,0.47
"20210823","1783","1520","1520",瑞士信貸,77,4,73,1,2.79
"20210823","1783","6162","6160",中國信託-忠孝,4,96,92,-1,3.52
"20210823","1783","1480","1480",美商高盛,78,6,72,1,2.75
"20210823","1783","9131","9100",群益金鼎-民權,5,91,86,-1,3.29
"20210823","1783","8440","8440",摩根大通,74,5,69,1,2.64
"20210823","1783","8150","8150",台新證券,14,69,55,-1,2.10
"20210823","1783","1470","1470",台灣摩根士丹利,108,42,66,1,2.52
"20210823","1783","7080","7080",石橋證券,1,50,49,-1,1.87
"20210823","1783","1440","1440",美林,82,21,61,1,2.33
"20210823","1783","6167","6160",中國信託-松江,4,50,46,-1,1.76
"20210823","1783","1560","1560",港商野村,216,159,57,1,2.18
"20210823","1783","0039003800330055","9800",元大-頭份,1,46,45,-1,1.72
"20210823","1783","6460","6460",大昌,61,13,48,1,1.83
"20210823","1783","0031003200360044","1260",宏遠-台南,3,34,31,-1,1.19
"20210823","1783","0039003600310053","9600",富邦-景美,50,9,41,1,1.57
"20210823","1783","003900380033004b","9800",元大-學甲,2,24,22,-1,0.84
"20210823","1783","5603","5600",永興-台中,33,0,33,1,1.26
"20210823","1783","0039003800390058","9800",元大-民生,10,32,22,-1,0.84
"20210823","1783","1650","1650",新加坡商瑞銀,31,8,23,1,0.88
"20210823","1783","1260","1260",宏遠證券,0,21,21,-1,0.80
"20210823","1783","0039004100390043","9A00",永豐金-員林,24,1,23,1,0.88
"20210823","1783","003900380033006a","9800",元大-仁愛,0,20,20,-1,0.76
"20210823","1783","8560","8560",新光,60,45,15,1,0.57
"20210823","1783","9800","9800",元大證券,23,42,19,-1,0.73
"20210823","1783","9665","9600",富邦-桃園,15,0,15,1,0.57
"20210823","1783","1261","1260",宏遠-民生,0,16,16,-1,0.61
"20210823","1783","9202","9200",凱基-中港,15,3,12,1,0.46
"20210823","1783","8888","8880",國泰-敦南,13,29,16,-1,0.61
"20210824","1783","1470","1470",台灣摩根士丹利,86,21,65,1,2.57
"20210824","1783","0036003100360041","6160",中國信託-中壢,0,114,114,-1,4.50
"20210824","1783","8888","8880",國泰-敦南,63,24,39,1,1.54
"20210824","1783","1480","1480",美商高盛,5,73,68,-1,2.69
"20210824","1783","9276","9200",凱基-苗栗,38,1,37,1,1.46
"20210824","1783","1560","1560",港商野村,108,168,60,-1,2.37
"20210824","1783","0039003800390058","9800",元大-民生,60,25,35,1,1.38
"20210824","1783","0039003600310053","9600",富邦-景美,2,48,46,-1,1.82
"20210824","1783","5854","5850",統一-城中,65,31,34,1,1.34
"20210824","1783","1650","1650",新加坡商瑞銀,14,43,29,-1,1.15
"20210824","1783","5850","5850",統一,30,1,29,1,1.15
"20210824","1783","9661","9600",富邦-新店,12,40,28,-1,1.11
"20210824","1783","6162","6160",中國信託-忠孝,29,1,28,1,1.11
"20210824","1783","8561","8560",新光-台中,7,30,23,-1,0.91
"20210824","1783","9333","9300",華南永昌-長虹,22,0,22,1,0.87
"20210824","1783","9108","9100",群益金鼎-海山,0,21,21,-1,0.83
"20210824","1783","8150","8150",台新證券,23,6,17,1,0.67
"20210824","1783","003900410039006a","9A00",永豐金-嘉義,0,20,20,-1,0.79
"20210824","1783","9105","9100",群益金鼎-高盛,19,2,17,1,0.67
"20210824","1783","6460","6460",大昌,2,19,17,-1,0.67
"20210824","1783","9285","9200",凱基-中壢,22,6,16,1,0.63
"20210824","1783","0035003300380044","5380",第一金-忠孝,0,16,16,-1,0.63
"20210824","1783","8848","8840",玉山-嘉義,16,0,16,1,0.63
"20210824","1783","003900320031004d","9200",凱基-八德,0,12,12,-1,0.47
"20210824","1783","1033","1030",土銀-高雄,14,0,14,1,0.55
"20210824","1783","2180","2180",亞東,4,15,11,-1,0.43
"20210824","1783","8440","8440",摩根大通,78,64,14,1,0.55
"20210824","1783","7001","7000",兆豐-嘉義,0,10,10,-1,0.39
"20210825","1783","0037003000300048","7000",兆豐-東門,248,1,247,1,9.39
"20210825","1783","9131","9100",群益金鼎-民權,2,110,108,-1,4.10
"20210825","1783","1480","1480",美商高盛,198,9,189,1,7.18
"20210825","1783","003800380038004b","8880",國泰-板橋,3,56,53,-1,2.01
"20210825","1783","1650","1650",新加坡商瑞銀,121,11,110,1,4.18
"20210825","1783","6460","6460",大昌,0,53,53,-1,2.01
"20210825","1783","1560","1560",港商野村,218,149,69,1,2.62
"20210825","1783","8560","8560",新光,16,68,52,-1,1.98
"20210825","1783","1440","1440",美林,57,4,53,1,2.01
"20210825","1783","8440","8440",摩根大通,69,108,39,-1,1.48
"20210825","1783","1520","1520",瑞士信貸,71,27,44,1,1.67
"20210825","1783","0036003100360041","6160",中國信託-中壢,0,35,35,-1,1.33
"20210825","1783","0039004100390061","9A00",永豐金-苓雅,25,0,25,1,0.95
"20210825","1783","5850","5850",統一,0,30,30,-1,1.14
"20210825","1783","9101","9100",群益金鼎-敦南,23,0,23,1,0.87
"20210825","1783","0038003800340045","8840",玉山-城中,1,28,27,-1,1.03
"20210825","1783","1470","1470",台灣摩根士丹利,38,21,17,1,0.65
"20210825","1783","9322","9300",華南永昌-公誠,3,30,27,-1,1.03
"20210825","1783","0039004100390062","9A00",永豐金-虎尾,14,0,14,1,0.53
"20210825","1783","5854","5850",統一-城中,21,46,25,-1,0.95
"20210825","1783","0038003100350041","8150",台新-高雄,12,1,11,1,0.42
"20210825","1783","0039003800390058","9800",元大-民生,20,45,25,-1,0.95
"20210825","1783","8561","8560",新光-台中,17,6,11,1,0.42
"20210825","1783","8562","8560",新光-高雄,0,21,21,-1,0.80
"20210825","1783","9686","9600",富邦-宜蘭,14,3,11,1,0.42
"20210825","1783","003900310038004d","9100",群益金鼎-嘉義,1,18,17,-1,0.65
"20210825","1783","9324","9300",華南永昌-岡山,10,0,10,1,0.38
"20210825","1783","8888","8880",國泰-敦南,6,22,16,-1,0.61
"20210826","1783","5850","5850",統一,60,0,60,1,3.41
"20210826","1783","1470","1470",台灣摩根士丹利,0,162,162,-1,9.21
"20210826","1783","9814","9800",元大-大益,62,3,59,1,3.35
"20210826","1783","1480","1480",美商高盛,7,157,150,-1,8.53
"20210826","1783","0037003000300048","7000",兆豐-東門,52,5,47,1,2.67
"20210826","1783","0037003700390076","7790",國票-台中,0,97,97,-1,5.51
"20210826","1783","0039004100390061","9A00",永豐金-苓雅,41,0,41,1,2.33
"20210826","1783","9223","9200",凱基-豐中,2,93,91,-1,5.17
"20210826","1783","0039003800390058","9800",元大-民生,35,10,25,1,1.42
"20210826","1783","8440","8440",摩根大通,12,97,85,-1,4.83
"20210826","1783","5854","5850",統一-城中,35,11,24,1,1.36
"20210826","1783","1560","1560",港商野村,71,141,70,-1,3.98
"20210826","1783","0039003600320046","9600",富邦-北桃園(停),24,0,24,1,1.36
"20210826","1783","1440","1440",美林,5,43,38,-1,2.16
"20210826","1783","8158","8150",台新-松江,20,0,20,1,1.14
"20210826","1783","1650","1650",新加坡商瑞銀,0,38,38,-1,2.16
"20210826","1783","9863","9800",元大-和平,20,0,20,1,1.14
"20210826","1783","9101","9100",群益金鼎-敦南,0,23,23,-1,1.31
"20210826","1783","003900310038004d","9100",群益金鼎-嘉義,19,0,19,1,1.08
"20210826","1783","003900410039004b","9A00",永豐金-三重,0,23,23,-1,1.31
"20210826","1783","0035003900320077","5920",元富-佳里,14,0,14,1,0.80
"20210826","1783","0039003200300047","9200",凱基-彰化,0,15,15,-1,0.85
"20210826","1783","9322","9300",華南永昌-公誠,15,1,14,1,0.80
"20210826","1783","0039004100390062","9A00",永豐金-虎尾,0,14,14,-1,0.80
"20210826","1783","9661","9600",富邦-新店,15,1,14,1,0.80
"20210826","1783","0035003900320062","5920",元富-板橋,0,11,11,-1,0.63
"20210826","1783","0039003800320041","9800",元大-羅東,15,1,14,1,0.80
"20210826","1783","003500390032004d","5920",元富-彰化,0,11,11,-1,0.63
"20210827","1783","5850","5850",統一,40,0,40,1,5.47
"20210827","1783","1118","1110",台灣企銀-豐原,0,30,30,-1,4.10
"20210827","1783","9268","9200",凱基-台北,27,11,16,1,2.19
"20210827","1783","0039003100380041","9100",群益金鼎-中壢,0,25,25,-1,3.42
"20210827","1783","1560","1560",港商野村,66,51,15,1,2.05
"20210827","1783","1470","1470",台灣摩根士丹利,3,26,23,-1,3.15
"20210827","1783","1520","1520",瑞士信貸,14,0,14,1,1.92
"20210827","1783","8888","8880",國泰-敦南,2,20,18,-1,2.46
"20210827","1783","9817","9800",元大-東泰,11,0,11,1,1.50
"20210827","1783","1480","1480",美商高盛,5,21,16,-1,2.19
"20210827","1783","6382","6380",光和-田中,10,0,10,1,1.37
"20210827","1783","1650","1650",新加坡商瑞銀,0,13,13,-1,1.78
"20210827","1783","9308","9300",華南永昌-麻豆,10,0,10,1,1.37
"20210827","1783","9343","9300",華南永昌-頭份,0,13,13,-1,1.78
"20210827","1783","9897","9800",元大-土城,10,0,10,1,1.37
"20210827","1783","003900380031006d","9800",元大-前金,0,13,13,-1,1.78
"20210827","1783","0037003000300049","7000",兆豐-北高雄,8,0,8,1,1.09
"20210827","1783","9317","9300",華南永昌-林口,0,10,10,-1,1.37
"20210827","1783","8841","8840",玉山-雙和,8,0,8,1,1.09
"20210827","1783","0037003000300048","7000",兆豐-東門,1,10,9,-1,1.23
"20210827","1783","0039004100390043","9A00",永豐金-員林,11,3,8,1,1.09
"20210827","1783","003900380033004e","9800",元大-大安,0,9,9,-1,1.23
"20210827","1783","8560","8560",新光,9,3,6,1,0.82
"20210827","1783","0039003800390067","9800",元大-嘉義,0,7,7,-1,0.96
"20210827","1783","9303","9300",華南永昌-高雄,6,0,6,1,0.82
"20210827","1783","9258","9200",凱基-羅東,5,12,7,-1,0.96
"20210827","1783","9322","9300",華南永昌-公誠,7,1,6,1,0.82
"20210827","1783","003900380039004c","9800",元大-成功,0,7,7,-1,0.96
"20210830","1783","1520","1520",瑞士信貸,56,0,56,1,5.34
"20210830","1783","8440","8440",摩根大通,9,48,39,-1,3.72
"20210830","1783","1560","1560",港商野村,83,35,48,1,4.58
"20210830","1783","9343","9300",華南永昌-頭份,0,31,31,-1,2.96
"20210830","1783","5850","5850",統一,47,0,47,1,4.48
"20210830","1783","9131","9100",群益金鼎-民權,0,26,26,-1,2.48
"20210830","1783","0039003200300041","9200",凱基-板橋,57,10,47,1,4.48
"20210830","1783","5320","5320",高橋,1,25,24,-1,2.29
"20210830","1783","1470","1470",台灣摩根士丹利,64,27,37,1,3.53
"20210830","1783","0039004100300030","9A00",永豐金證券,0,23,23,-1,2.19
"20210830","1783","9692","9600",富邦-嘉義,34,0,34,1,3.24
"20210830","1783","0039003200320048","9200",凱基-復興,0,22,22,-1,2.10
"20210830","1783","7080","7080",石橋證券,35,5,30,1,2.86
"20210830","1783","0039003800390058","9800",元大-民生,10,30,20,-1,1.91
"20210830","1783","1440","1440",美林,35,14,21,1,2.00
"20210830","1783","0039004100390061","9A00",永豐金-苓雅,0,15,15,-1,1.43
"20210830","1783","0039003600310056","9600",富邦-板橋中山,15,0,15,1,1.43
"20210830","1783","9296","9200",凱基-頭份,6,18,12,-1,1.15
"20210830","1783","6460","6460",大昌,12,0,12,1,1.15
"20210830","1783","5854","5850",統一-城中,4,15,11,-1,1.05
"20210830","1783","8564","8560",新光-台南,16,5,11,1,1.05
"20210830","1783","0038003800340045","8840",玉山-城中,1,12,11,-1,1.05
"20210830","1783","003900410039004b","9A00",永豐金-三重,11,0,11,1,1.05
"20210830","1783","9661","9600",富邦-新店,3,14,11,-1,1.05
"20210830","1783","9814","9800",元大-大益,11,1,10,1,0.95
"20210830","1783","0038003100350059","8150",台新-新營,0,10,10,-1,0.95
"20210830","1783","003900380031007a","9800",元大-大統,10,0,10,1,0.95
"20210830","1783","9898","9800",元大-新莊,0,10,10,-1,0.95
"20210831","1783","9108","9100",群益金鼎-海山,20,0,20,1,4.20
"20210831","1783","0039003800390064","9800",元大-北屯,1,29,28,-1,5.88
"20210831","1783","9268","9200",凱基-台北,28,8,20,1,4.20
"20210831","1783","0039003800390047","9800",元大-大同,0,20,20,-1,4.20
"20210831","1783","5850","5850",統一,19,0,19,1,3.99
"20210831","1783","8150","8150",台新證券,2,17,15,-1,3.15
"20210831","1783","9276","9200",凱基-苗栗,18,0,18,1,3.78
"20210831","1783","1560","1560",港商野村,10,22,12,-1,2.52
"20210831","1783","7080","7080",石橋證券,10,0,10,1,2.10
"20210831","1783","8563","8560",新光-新竹,0,11,11,-1,2.31
"20210831","1783","0039003200300041","9200",凱基-板橋,10,0,10,1,2.10
"20210831","1783","8564","8560",新光-台南,2,13,11,-1,2.31
"20210831","1783","003900360032004b","9600",富邦-中和,11,1,10,1,2.10
"20210831","1783","1260","1260",宏遠證券,0,10,10,-1,2.10
"20210831","1783","9296","9200",凱基-頭份,10,4,6,1,1.26
"20210831","1783","003900380031007a","9800",元大-大統,0,10,10,-1,2.10
"20210831","1783","9647","9600",富邦-新竹,6,0,6,1,1.26
"20210831","1783","0037003000300049","7000",兆豐-北高雄,0,8,8,-1,1.68
"20210831","1783","0039003600310053","9600",富邦-景美,5,0,5,1,1.05
"20210831","1783","0031003000340041","1040",臺銀-臺中,0,6,6,-1,1.26
"20210831","1783","9661","9600",富邦-新店,5,0,5,1,1.05
"20210831","1783","5320","5320",高橋,2,8,6,-1,1.26
"20210831","1783","0039003800320041","9800",元大-羅東,5,0,5,1,1.05
"20210831","1783","0039004100390063","9A00",永豐金-永康,0,6,6,-1,1.26
"20210831","1783","1030","1030",土銀,4,0,4,1,0.84
"20210831","1783","5854","5850",統一-城中,0,5,5,-1,1.05
"20210831","1783","0035003800350046","5850",統一-彰化,6,2,4,1,0.84
"20210831","1783","0035003800350044","5850",統一-新台中,0,5,5,-1,1.05
"20210701","1783","8883","8880",國泰-松江,43,0,43,1,5.48
"20210701","1783","5389","5380",第一金-中山,0,30,30,-1,3.83
"20210701","1783","5852","5850",統一-敦南,42,0,42,1,5.36
"20210701","1783","9208","9200",凱基-桃園,1,31,30,-1,3.83
"20210701","1783","7006","7000",兆豐-台南,30,0,30,1,3.83
"20210701","1783","0037003700390058","7790",國票-中和,0,29,29,-1,3.70
"20210701","1783","9268","9200",凱基-台北,44,17,27,1,3.44
"20210701","1783","8440","8440",摩根大通,35,61,26,-1,3.32
"20210701","1783","0037003700390072","7790",國票-桃園,20,0,20,1,2.55
"20210701","1783","8560","8560",新光,1,27,26,-1,3.32
"20210701","1783","1480","1480",美商高盛,19,3,16,1,2.04
"20210701","1783","0039003600310052","9600",富邦-南員林,0,25,25,-1,3.19
"20210701","1783","9366","9300",華南永昌-豐原,16,0,16,1,2.04
"20210701","1783","0039003200300041","9200",凱基-板橋,0,20,20,-1,2.55
"20210701","1783","1650","1650",新加坡商瑞銀,15,0,15,1,1.91
"20210701","1783","0039003800320046","9800",元大-忠孝鼎富,0,20,20,-1,2.55
"20210701","1783","9322","9300",華南永昌-公誠,15,0,15,1,1.91
"20210701","1783","6460","6460",大昌,0,17,17,-1,2.17
"20210701","1783","9817","9800",元大-東泰,17,2,15,1,1.91
"20210701","1783","0037003000300042","7000",兆豐-板橋,0,16,16,-1,2.04
"20210701","1783","0039003800390043","9800",元大-板橋,15,1,14,1,1.79
"20210701","1783","7791","7790",國票-台東,0,16,16,-1,2.04
"20210701","1783","0039003800310049","9800",元大-天母,11,0,11,1,1.40
"20210701","1783","9306","9300",華南永昌-台南,0,15,15,-1,1.91
"20210701","1783","0039003800340043","9800",元大-新店中正,10,0,10,1,1.28
"20210701","1783","9363","9300",華南永昌-彰化,1,16,15,-1,1.91
"20210701","1783","9863","9800",元大-和平,10,0,10,1,1.28
"20210701","1783","1115","1110",台灣企銀-太平,0,12,12,-1,1.53
"20210702","1783","0037003700390058","7790",國票-中和,25,0,25,1,10.73
"20210702","1783","9667","9600",富邦-台南,0,10,10,-1,4.29
"20210702","1783","9268","9200",凱基-台北,33,9,24,1,10.30
"20210702","1783","6012","6010",(牛牛牛)亞-網路,0,8,8,-1,3.43
"20210702","1783","6210","6210",新百王,10,0,10,1,4.29
"20210702","1783","0039003800390067","9800",元大-嘉義,1,9,8,-1,3.43
"20210702","1783","7003","7000",兆豐-台中,10,0,10,1,4.29
"20210702","1783","0039003600310058","9600",富邦-大墩,3,10,7,-1,3.00
"20210702","1783","8440","8440",摩根大通,21,11,10,1,4.29
"20210702","1783","003900380039006d","9800",元大-信義,0,7,7,-1,3.00
"20210702","1783","1650","1650",新加坡商瑞銀,7,0,7,1,3.00
"20210702","1783","0039003800300077","9800",元大-西屯,0,5,5,-1,2.15
"20210702","1783","0039003800390064","9800",元大-北屯,7,0,7,1,3.00
"20210702","1783","0035003900320075","5920",元富-世貿,1,6,5,-1,2.15
"20210702","1783","1520","1520",瑞士信貸,7,2,5,1,2.15
"20210702","1783","1480","1480",美商高盛,5,10,5,-1,2.15
"20210702","1783","0039003200300056","9200",凱基-新店,5,1,4,1,1.72
"20210702","1783","003700370039004a","7790",國票-北高雄,0,5,5,-1,2.15
"20210702","1783","0035003800350052","5850",統一-汐止,3,0,3,1,1.29
"20210702","1783","0038003400350055","8450",康和-台北,0,5,5,-1,2.15
"20210702","1783","9322","9300",華南永昌-公誠,3,0,3,1,1.29
"20210702","1783","9326","9300",華南永昌-南京,0,5,5,-1,2.15
"20210702","1783","1560","1560",港商野村,2,0,2,1,0.86
"20210702","1783","0039003800390051","9800",元大-汐止,0,5,5,-1,2.15
"20210702","1783","6460","6460",大昌,2,0,2,1,0.86
"20210702","1783","0039003800310067","9800",元大-大里,0,4,4,-1,1.72
"20210702","1783","9647","9600",富邦-新竹,2,0,2,1,0.86
"20210702","1783","9634","9600",富邦-羅東,0,3,3,-1,1.29
"20210705","1783","9268","9200",凱基-台北,22,0,22,1,9.95
"20210705","1783","1470","1470",台灣摩根士丹利,0,21,21,-1,9.50
"20210705","1783","1520","1520",瑞士信貸,13,0,13,1,5.88
"20210705","1783","8883","8880",國泰-松江,0,15,15,-1,6.79
"20210705","1783","6210","6210",新百王,12,0,12,1,5.43
"20210705","1783","0035003900320041","5920",元富-緯城,0,11,11,-1,4.98
"20210705","1783","8440","8440",摩根大通,14,3,11,1,4.98
"20210705","1783","0039003800310053","9800",元大-崇德,0,10,10,-1,4.52
"20210705","1783","7003","7000",兆豐-台中,10,0,10,1,4.52
"20210705","1783","0039003800310079","9800",元大-善化,0,9,9,-1,4.07
"20210705","1783","9324","9300",華南永昌-岡山,10,0,10,1,4.52
"20210705","1783","0035003800350055","5850",統一-南京,0,8,8,-1,3.62
"20210705","1783","9623","9600",富邦-台北,7,0,7,1,3.17
"20210705","1783","6012","6010",(牛牛牛)亞-網路,0,7,7,-1,3.17
"20210705","1783","1480","1480",美商高盛,5,0,5,1,2.26
"20210705","1783","9211","9200",凱基-台南,0,7,7,-1,3.17
"20210705","1783","0035003900320072","5920",元富-城東,5,0,5,1,2.26
"20210705","1783","5320","5320",高橋,0,5,5,-1,2.26
"20210705","1783","0038003100350059","8150",台新-新營,5,0,5,1,2.26
"20210705","1783","0035003900320044","5920",元富-大昌,0,5,5,-1,2.26
"20210705","1783","1440","1440",美林,4,0,4,1,1.81
"20210705","1783","7006","7000",兆豐-台南,0,5,5,-1,2.26
"20210705","1783","9334","9300",華南永昌-世貿,4,0,4,1,1.81
"20210705","1783","0039003800300077","9800",元大-西屯,0,5,5,-1,2.26
"20210705","1783","0037003000300045","7000",兆豐-斗南(停),2,0,2,1,0.90
"20210705","1783","0039003200300056","9200",凱基-新店,1,5,4,-1,1.81
"20210705","1783","0037003700390058","7790",國票-中和,2,0,2,1,0.90
"20210705","1783","0039003800390067","9800",元大-嘉義,0,4,4,-1,1.81
"20210706","1783","0038003800380041","8880",國泰-館前,30,0,30,1,11.86
"20210706","1783","9291","9200",凱基-大安,0,22,22,-1,8.70
"20210706","1783","6210","6210",新百王,25,0,25,1,9.88
"20210706","1783","8883","8880",國泰-松江,0,17,17,-1,6.72
"20210706","1783","8440","8440",摩根大通,17,0,17,1,6.72
"20210706","1783","9366","9300",華南永昌-豐原,0,16,16,-1,6.32
"20210706","1783","9268","9200",凱基-台北,19,2,17,1,6.72
"20210706","1783","1470","1470",台灣摩根士丹利,4,16,12,-1,4.74
"20210706","1783","9307","9300",華南永昌-大安,10,0,10,1,3.95
"20210706","1783","6168","6160",中國信託-嘉義,0,12,12,-1,4.74
"20210706","1783","003900380031004e","9800",元大-金門,8,0,8,1,3.16
"20210706","1783","8563","8560",新光-新竹,0,10,10,-1,3.95
"20210706","1783","1520","1520",瑞士信貸,7,0,7,1,2.77
"20210706","1783","0039003100380045","9100",群益金鼎-南京,0,10,10,-1,3.95
"20210706","1783","1650","1650",新加坡商瑞銀,6,0,6,1,2.37
"20210706","1783","9217","9200",凱基-松山,0,10,10,-1,3.95
"20210706","1783","9215","9200",凱基-高美館,5,0,5,1,1.98
"20210706","1783","5660","5660",日進,0,8,8,-1,3.16
"20210706","1783","0039003200310059","9200",凱基-東勢,5,0,5,1,1.98
"20210706","1783","0035003800350050","5850",統一-板橋,0,6,6,-1,2.37
"20210706","1783","0039003800310049","9800",元大-天母,5,0,5,1,1.98
"20210706","1783","0039003600310047","9600",富邦-成功,0,6,6,-1,2.37
"20210706","1783","9891","9800",元大-永和,5,0,5,1,1.98
"20210706","1783","5265","5260",美好-苗栗,0,5,5,-1,1.98
"20210706","1783","0039004100380039","9A00",永豐金-敦北,5,0,5,1,1.98
"20210706","1783","0038003400350045","8450",康和-澎湖,0,5,5,-1,1.98
"20210706","1783","0039003600310043","9600",富邦-南京,4,0,4,1,1.58
"20210706","1783","0039003600320050","9600",富邦-頭份,0,5,5,-1,1.98
"20210707","1783","0038003800380041","8880",國泰-館前,29,6,23,1,7.57
"20210707","1783","7791","7790",國票-台東,0,14,14,-1,4.61
"20210707","1783","5603","5600",永興-台中,19,0,19,1,6.25
"20210707","1783","0031003200360048","1260",宏遠-中和,0,10,10,-1,3.29
"20210707","1783","7797","7790",國票-中正,18,0,18,1,5.92
"20210707","1783","0035003900320041","5920",元富-緯城,0,10,10,-1,3.29
"20210707","1783","9324","9300",華南永昌-岡山,10,0,10,1,3.29
"20210707","1783","6165","6160",中國信託-新竹,0,10,10,-1,3.29
"20210707","1783","1650","1650",新加坡商瑞銀,8,0,8,1,2.63
"20210707","1783","9205","9200",凱基-三重,0,10,10,-1,3.29
"20210707","1783","1470","1470",台灣摩根士丹利,27,20,7,1,2.30
"20210707","1783","0039003600310048","9600",富邦-新板,0,10,10,-1,3.29
"20210707","1783","8440","8440",摩根大通,13,6,7,1,2.30
"20210707","1783","0039003800330057","9800",元大-大里德芳,0,10,10,-1,3.29
"20210707","1783","1520","1520",瑞士信貸,5,0,5,1,1.64
"20210707","1783","0039004100390058","9A00",永豐金-竹科,0,10,10,-1,3.29
"20210707","1783","6210","6210",新百王,5,0,5,1,1.64
"20210707","1783","9814","9800",元大-大益,0,7,7,-1,2.30
"20210707","1783","9268","9200",凱基-台北,9,5,4,1,1.32
"20210707","1783","9817","9800",元大-東泰,0,6,6,-1,1.97
"20210707","1783","0039003800390050","9800",元大-敦南,4,0,4,1,1.32
"20210707","1783","9835","9800",元大-員林中山,0,6,6,-1,1.97
"20210707","1783","1021","1020",合庫-台中,3,0,3,1,0.99
"20210707","1783","0039004100390048","9A00",永豐金-新莊,0,5,5,-1,1.64
"20210707","1783","9322","9300",華南永昌-公誠,3,0,3,1,0.99
"20210707","1783","9208","9200",凱基-桃園,0,5,5,-1,1.64
"20210707","1783","9654","9600",富邦-永和,3,0,3,1,0.99
"20210707","1783","9215","9200",凱基-高美館,0,5,5,-1,1.64
"20210708","1783","8440","8440",摩根大通,93,9,84,1,11.24
"20210708","1783","003700300030005a","7000",兆豐-高雄,2,23,21,-1,2.81
"20210708","1783","1650","1650",新加坡商瑞銀,79,3,76,1,10.17
"20210708","1783","9291","9200",凱基-大安,0,18,18,-1,2.41
"20210708","1783","9268","9200",凱基-台北,75,7,68,1,9.10
"20210708","1783","9187","9100",群益金鼎-彰化,0,12,12,-1,1.61
"20210708","1783","0039003100330044","9100",群益金鼎-潭子,61,0,61,1,8.17
"20210708","1783","0039003800310046","9800",元大-福營,2,14,12,-1,1.61
"20210708","1783","1470","1470",台灣摩根士丹利,57,21,36,1,4.82
"20210708","1783","9205","9200",凱基-三重,0,11,11,-1,1.47
"20210708","1783","1119","1110",台灣企銀-岡山,30,0,30,1,4.02
"20210708","1783","0035003300380042","5380",第一金-新竹,0,10,10,-1,1.34
"20210708","1783","1560","1560",港商野村,19,4,15,1,2.01
"20210708","1783","0035003300380057","5380",第一金-華江,0,10,10,-1,1.34
"20210708","1783","1440","1440",美林,12,0,12,1,1.61
"20210708","1783","5853","5850",統一-中壢,0,10,10,-1,1.34
"20210708","1783","9884","9800",元大-斗信,12,0,12,1,1.61
"20210708","1783","5922","5920",元富-新店,0,10,10,-1,1.34
"20210708","1783","5389","5380",第一金-中山,10,0,10,1,1.34
"20210708","1783","9322","9300",華南永昌-公誠,0,10,10,-1,1.34
"20210708","1783","0039003200300046","9200",凱基-站前,10,0,10,1,1.34
"20210708","1783","0039003600320041","9600",富邦-信義,0,10,10,-1,1.34
"20210708","1783","9858","9800",元大-龍潭,9,0,9,1,1.20
"20210708","1783","0039004100390058","9A00",永豐金-竹科,0,10,10,-1,1.34
"20210708","1783","1520","1520",瑞士信貸,8,0,8,1,1.07
"20210708","1783","0035003800350048","5850",統一-桃園,0,8,8,-1,1.07
"20210708","1783","0039003800390050","9800",元大-敦南,10,3,7,1,0.94
"20210708","1783","8150","8150",台新證券,1,9,8,-1,1.07
"20210709","1783","8440","8440",摩根大通,145,39,106,1,7.71
"20210709","1783","5852","5850",統一-敦南,0,42,42,-1,3.06
"20210709","1783","6160","6160",中國信託,82,0,82,1,5.97
"20210709","1783","9322","9300",華南永昌-公誠,4,32,28,-1,2.04
"20210709","1783","0031003000330046","1030",土銀-南港,55,0,55,1,4.00
"20210709","1783","0039003800390041","9800",元大-北投,0,25,25,-1,1.82
"20210709","1783","9366","9300",華南永昌-豐原,47,0,47,1,3.42
"20210709","1783","0035003300380057","5380",第一金-華江,0,22,22,-1,1.60
"20210709","1783","1650","1650",新加坡商瑞銀,47,2,45,1,3.28
"20210709","1783","5603","5600",永興-台中,0,21,21,-1,1.53
"20210709","1783","0039003100330044","9100",群益金鼎-潭子,40,0,40,1,2.91
"20210709","1783","6114","6110",台中銀-員林,0,20,20,-1,1.46
"20210709","1783","0039003800390050","9800",元大-敦南,40,3,37,1,2.69
"20210709","1783","0037003700390072","7790",國票-桃園,0,20,20,-1,1.46
"20210709","1783","9692","9600",富邦-嘉義,32,1,31,1,2.26
"20210709","1783","0039003200300047","9200",凱基-彰化,0,17,17,-1,1.24
"20210709","1783","1119","1110",台灣企銀-岡山,30,0,30,1,2.18
"20210709","1783","9238","9200",凱基-士林,1,18,17,-1,1.24
"20210709","1783","1520","1520",瑞士信貸,31,1,30,1,2.18
"20210709","1783","0035003800350055","5850",統一-南京,5,21,16,-1,1.16
"20210709","1783","0039003600310044","9600",富邦-忠孝,30,0,30,1,2.18
"20210709","1783","9291","9200",凱基-大安,0,16,16,-1,1.16
"20210709","1783","8150","8150",台新證券,36,9,27,1,1.97
"20210709","1783","2180","2180",亞東,0,15,15,-1,1.09
"20210709","1783","9268","9200",凱基-台北,60,35,25,1,1.82
"20210709","1783","0039003600310043","9600",富邦-南京,2,17,15,-1,1.09
"20210709","1783","0039004100390062","9A00",永豐金-虎尾,20,0,20,1,1.46
"20210709","1783","0039003600320044","9600",富邦-新莊,0,15,15,-1,1.09
"20210712","1783","7006","7000",兆豐-台南,43,5,38,1,3.60
"20210712","1783","1470","1470",台灣摩根士丹利,17,87,70,-1,6.64
"20210712","1783","7792","7790",國票-北投,30,0,30,1,2.84
"20210712","1783","0038003800380041","8880",國泰-館前,16,74,58,-1,5.50
"20210712","1783","0039003100330055","9100",群益金鼎-崇德,20,1,19,1,1.80
"20210712","1783","9268","9200",凱基-台北,0,41,41,-1,3.89
"20210712","1783","9322","9300",華南永昌-公誠,16,0,16,1,1.52
"20210712","1783","1650","1650",新加坡商瑞銀,1,40,39,-1,3.70
"20210712","1783","003900310033004e","9100",群益金鼎-土城,16,1,15,1,1.42
"20210712","1783","1520","1520",瑞士信貸,5,34,29,-1,2.75
"20210712","1783","6210","6210",新百王,14,1,13,1,1.23
"20210712","1783","8150","8150",台新證券,3,31,28,-1,2.65
"20210712","1783","003700300030005a","7000",兆豐-高雄,15,2,13,1,1.23
"20210712","1783","5389","5380",第一金-中山,0,22,22,-1,2.09
"20210712","1783","7003","7000",兆豐-台中,12,0,12,1,1.14
"20210712","1783","0039004100390062","9A00",永豐金-虎尾,0,20,20,-1,1.90
"20210712","1783","0039003800390050","9800",元大-敦南,12,0,12,1,1.14
"20210712","1783","0038003100350059","8150",台新-新營,1,20,19,-1,1.80
"20210712","1783","003800380034004a","8840",玉山-大里,11,0,11,1,1.04
"20210712","1783","003600310036004b","6160",中國信託-高雄,0,18,18,-1,1.71
"20210712","1783","9604","9600",富邦-陽明,11,0,11,1,1.04
"20210712","1783","9858","9800",元大-龍潭,0,14,14,-1,1.33
"20210712","1783","0031003200360048","1260",宏遠-中和,10,0,10,1,0.95
"20210712","1783","1041","1040",臺銀-鳳山,0,10,10,-1,0.95
"20210712","1783","6114","6110",台中銀-員林,10,0,10,1,0.95
"20210712","1783","1028","1020",合庫-彰化,0,10,10,-1,0.95
"20210712","1783","0039003100330044","9100",群益金鼎-潭子,10,0,10,1,0.95
"20210712","1783","8564","8560",新光-台南,0,10,10,-1,0.95
"20210713","1783","6160","6160",中國信託,60,0,60,1,3.45
"20210713","1783","0035003300380057","5380",第一金-華江,1,51,50,-1,2.88
"20210713","1783","0039003800390045","9800",元大-草屯,43,1,42,1,2.42
"20210713","1783","9692","9600",富邦-嘉義,0,33,33,-1,1.90
"20210713","1783","0039003800390050","9800",元大-敦南,49,7,42,1,2.42
"20210713","1783","9215","9200",凱基-高美館,3,28,25,-1,1.44
"20210713","1783","9329","9300",華南永昌-朴子,34,4,30,1,1.73
"20210713","1783","0035003800350048","5850",統一-桃園,0,21,21,-1,1.21
"20210713","1783","1650","1650",新加坡商瑞銀,32,7,25,1,1.44
"20210713","1783","0039003600320056","9600",富邦-復興,0,20,20,-1,1.15
"20210713","1783","9366","9300",華南永昌-豐原,23,0,23,1,1.32
"20210713","1783","6210","6210",新百王,0,19,19,-1,1.09
"20210713","1783","1119","1110",台灣企銀-岡山,20,0,20,1,1.15
"20210713","1783","003900310033004e","9100",群益金鼎-土城,0,19,19,-1,1.09
"20210713","1783","5960","5960",日茂,20,0,20,1,1.15
"20210713","1783","1440","1440",美林,9,27,18,-1,1.04
"20210713","1783","9324","9300",華南永昌-岡山,20,0,20,1,1.15
"20210713","1783","9205","9200",凱基-三重,7,24,17,-1,0.98
"20210713","1783","0039003100330055","9100",群益金鼎-崇德,20,0,20,1,1.15
"20210713","1783","9278","9200",凱基-永康,0,16,16,-1,0.92
"20210713","1783","6168","6160",中國信託-嘉義,18,0,18,1,1.04
"20210713","1783","6110","6110",台中銀,2,16,14,-1,0.81
"20210713","1783","8560","8560",新光,35,19,16,1,0.92
"20210713","1783","7792","7790",國票-北投,0,13,13,-1,0.75
"20210713","1783","003500390032004e","5920",元富-虎尾,15,0,15,1,0.86
"20210713","1783","0039003600320043","9600",富邦-東門,2,14,12,-1,0.69
"20210713","1783","003900380031004e","9800",元大-金門,14,0,14,1,0.81
"20210713","1783","9654","9600",富邦-永和,1,12,11,-1,0.63
"20210714","1783","8440","8440",摩根大通,453,118,335,1,7.47
"20210714","1783","5603","5600",永興-台中,38,258,220,-1,4.91
"20210714","1783","9329","9300",華南永昌-朴子,250,33,217,1,4.84
"20210714","1783","9874","9800",元大-雙和,6,209,203,-1,4.53
"20210714","1783","5850","5850",統一,194,7,187,1,4.17
"20210714","1783","0039003600320056","9600",富邦-復興,5,130,125,-1,2.79
"20210714","1783","9268","9200",凱基-台北,114,19,95,1,2.12
"20210714","1783","0039003800350043","9800",元大-鳳中,1,100,99,-1,2.21
"20210714","1783","9307","9300",華南永昌-大安,96,3,93,1,2.07
"20210714","1783","8847","8840",玉山-台南,0,92,92,-1,2.05
"20210714","1783","0039003600310047","9600",富邦-成功,74,0,74,1,1.65
"20210714","1783","003900380039004a","9800",元大-彰化民生,3,87,84,-1,1.87
"20210714","1783","1440","1440",美林,94,25,69,1,1.54
"20210714","1783","5389","5380",第一金-中山,0,70,70,-1,1.56
"20210714","1783","0039003200300041","9200",凱基-板橋,69,4,65,1,1.45
"20210714","1783","5853","5850",統一-中壢,6,76,70,-1,1.56
"20210714","1783","9333","9300",華南永昌-長虹,70,5,65,1,1.45
"20210714","1783","6452","6450",永全-八德,0,61,61,-1,1.36
"20210714","1783","1520","1520",瑞士信貸,63,0,63,1,1.41
"20210714","1783","6910","6910",德信,1,50,49,-1,1.09
"20210714","1783","8587","8580",聯邦-興中,60,0,60,1,1.34
"20210714","1783","9208","9200",凱基-桃園,7,54,47,-1,1.05
"20210714","1783","8561","8560",新光-台中,55,2,53,1,1.18
"20210714","1783","9105","9100",群益金鼎-高盛,1,45,44,-1,0.98
"20210714","1783","6161","6160",中國信託-三重,51,0,51,1,1.14
"20210714","1783","0039003600310056","9600",富邦-板橋中山,22,64,42,-1,0.94
"20210714","1783","003900310038004a","9100",群益金鼎-永和,80,31,49,1,1.09
"20210714","1783","0038003800380041","8880",國泰-館前,3,41,38,-1,0.85
"20210715","1783","9874","9800",元大-雙和,104,1,103,1,3.58
"20210715","1783","5850","5850",統一,0,162,162,-1,5.62
"20210715","1783","1470","1470",台灣摩根士丹利,127,37,90,1,3.12
"20210715","1783","0039003600310047","9600",富邦-成功,0,74,74,-1,2.57
"20210715","1783","0038003400350046","8450",康和-仁愛,66,0,66,1,2.29
"20210715","1783","8561","8560",新光-台中,3,56,53,-1,1.84
"20210715","1783","9307","9300",華南永昌-大安,66,2,64,1,2.22
"20210715","1783","003900310038004a","9100",群益金鼎-永和,1,50,49,-1,1.70
"20210715","1783","0039003800390064","9800",元大-北屯,57,0,57,1,1.98
"20210715","1783","1560","1560",港商野村,10,54,44,-1,1.53
"20210715","1783","9333","9300",華南永昌-長虹,51,1,50,1,1.74
"20210715","1783","9266","9200",凱基-新豐,0,42,42,-1,1.46
"20210715","1783","0037003700390072","7790",國票-桃園,47,0,47,1,1.63
"20210715","1783","0035003800350055","5850",統一-南京,0,40,40,-1,1.39
"20210715","1783","003900380031004e","9800",元大-金門,41,3,38,1,1.32
"20210715","1783","1440","1440",美林,24,61,37,-1,1.28
"20210715","1783","8564","8560",新光-台南,39,3,36,1,1.25
"20210715","1783","0039003100380048","9100",群益金鼎-中山,2,35,33,-1,1.15
"20210715","1783","0031003000340041","1040",臺銀-臺中,35,0,35,1,1.21
"20210715","1783","5859","5850",統一-屏東,0,30,30,-1,1.04
"20210715","1783","9287","9200",凱基-內湖,32,0,32,1,1.11
"20210715","1783","9825","9800",元大-新營,3,33,30,-1,1.04
"20210715","1783","9322","9300",華南永昌-公誠,31,0,31,1,1.08
"20210715","1783","9268","9200",凱基-台北,123,144,21,-1,0.73
"20210715","1783","2184","2180",亞東-新竹,30,0,30,1,1.04
"20210715","1783","1520","1520",瑞士信貸,10,30,20,-1,0.69
"20210715","1783","9319","9300",華南永昌-鶯歌,30,0,30,1,1.04
"20210715","1783","6461","6460",大昌-樹林,0,20,20,-1,0.69
"20210716","1783","0039003800310070","9800",元大-松山,49,0,49,1,4.40
"20210716","1783","0039003200300041","9200",凱基-板橋,10,69,59,-1,5.30
"20210716","1783","9285","9200",凱基-中壢,40,0,40,1,3.59
"20210716","1783","9268","9200",凱基-台北,25,82,57,-1,5.12
"20210716","1783","0039003800390055","9800",元大-大甲,30,0,30,1,2.70
"20210716","1783","5850","5850",統一,0,32,32,-1,2.88
"20210716","1783","1233","1230",彰銀-台中,20,0,20,1,1.80
"20210716","1783","0039003100380048","9100",群益金鼎-中山,0,30,30,-1,2.70
"20210716","1783","9331","9300",華南永昌-鳳山,19,0,19,1,1.71
"20210716","1783","1440","1440",美林,0,22,22,-1,1.98
"20210716","1783","0039004100380046","9A00",永豐金-敦南,63,45,18,1,1.62
"20210716","1783","1650","1650",新加坡商瑞銀,0,21,21,-1,1.89
"20210716","1783","0035003900320049","5920",元富-嘉義,17,0,17,1,1.53
"20210716","1783","6167","6160",中國信託-松江,0,20,20,-1,1.80
"20210716","1783","9255","9200",凱基-和平,22,6,16,1,1.44
"20210716","1783","8564","8560",新光-台南,6,25,19,-1,1.71
"20210716","1783","003900380031004b","9800",元大-林園,15,0,15,1,1.35
"20210716","1783","0039003100380041","9100",群益金鼎-中壢,0,16,16,-1,1.44
"20210716","1783","9831","9800",元大-四維,15,0,15,1,1.35
"20210716","1783","8150","8150",台新證券,0,15,15,-1,1.35
"20210716","1783","9857","9800",元大-東蘆,14,0,14,1,1.26
"20210716","1783","1020","1020",合庫證券,0,11,11,-1,0.99
"20210716","1783","8560","8560",新光,19,7,12,1,1.08
"20210716","1783","9358","9300",華南永昌-東勢,0,11,11,-1,0.99
"20210716","1783","9333","9300",華南永昌-長虹,12,0,12,1,1.08
"20210716","1783","0037003700390047","7790",國票-新莊,0,10,10,-1,0.90
"20210716","1783","9278","9200",凱基-永康,11,0,11,1,0.99
"20210716","1783","003800380034004a","8840",玉山-大里,7,17,10,-1,0.90
"20210719","1783","1440","1440",美林,68,4,64,1,3.93
"20210719","1783","6161","6160",中國信託-三重,5,56,51,-1,3.13
"20210719","1783","0037003700390075","7790",國票-長城,55,1,54,1,3.31
"20210719","1783","0037003000300056","7000",兆豐-新竹,0,51,51,-1,3.13
"20210719","1783","9268","9200",凱基-台北,103,50,53,1,3.25
"20210719","1783","6167","6160",中國信託-松江,0,50,50,-1,3.07
"20210719","1783","8560","8560",新光,68,18,50,1,3.07
"20210719","1783","0039003800390047","9800",元大-大同,0,35,35,-1,2.15
"20210719","1783","1560","1560",港商野村,55,7,48,1,2.95
"20210719","1783","003700300030006a","7000",兆豐-大安,1,33,32,-1,1.96
"20210719","1783","1480","1480",美商高盛,44,0,44,1,2.70
"20210719","1783","0037003700390072","7790",國票-桃園,0,31,31,-1,1.90
"20210719","1783","9834","9800",元大-中壢,46,6,40,1,2.46
"20210719","1783","0039003800390055","9800",元大-大甲,0,31,31,-1,1.90
"20210719","1783","9331","9300",華南永昌-鳳山,43,5,38,1,2.33
"20210719","1783","0039003100380048","9100",群益金鼎-中山,0,30,30,-1,1.84
"20210719","1783","9238","9200",凱基-士林,35,0,35,1,2.15
"20210719","1783","9322","9300",華南永昌-公誠,2,28,26,-1,1.60
"20210719","1783","0039004100390062","9A00",永豐金-虎尾,22,0,22,1,1.35
"20210719","1783","0039003600320045","9600",富邦-樹林,0,20,20,-1,1.23
"20210719","1783","1520","1520",瑞士信貸,20,1,19,1,1.17
"20210719","1783","9896","9800",元大-台南,0,19,19,-1,1.17
"20210719","1783","9333","9300",華南永昌-長虹,18,0,18,1,1.10
"20210719","1783","0039003600330041","9600",富邦-八德,0,17,17,-1,1.04
"20210719","1783","0039003800300043","9800",元大-斗六,16,1,15,1,0.92
"20210719","1783","5603","5600",永興-台中,3,18,15,-1,0.92
"20210719","1783","9878","9800",元大-金華,15,0,15,1,0.92
"20210719","1783","9287","9200",凱基-內湖,0,15,15,-1,0.92
"20210720","1783","9834","9800",元大-中壢,266,3,263,1,5.67
"20210720","1783","0039003600320056","9600",富邦-復興,0,153,153,-1,3.30
"20210720","1783","5850","5850",統一,158,7,151,1,3.26
"20210720","1783","0037003000300056","7000",兆豐-新竹,0,116,116,-1,2.50
"20210720","1783","0039003600310047","9600",富邦-成功,69,0,69,1,1.49
"20210720","1783","0039003600320043","9600",富邦-東門,0,101,101,-1,2.18
"20210720","1783","9135","9100",群益金鼎-東大,50,3,47,1,1.01
"20210720","1783","6167","6160",中國信託-松江,1,100,99,-1,2.13
"20210720","1783","9218","9200",凱基-大直,35,0,35,1,0.75
"20210720","1783","8587","8580",聯邦-興中,0,60,60,-1,1.29
"20210720","1783","1260","1260",宏遠證券,31,0,31,1,0.67
"20210720","1783","9268","9200",凱基-台北,77,126,49,-1,1.06
"20210720","1783","5603","5600",永興-台中,30,0,30,1,0.65
"20210720","1783","0036003000310064","6010",(牛牛牛)亞-鑫豐,7,53,46,-1,0.99
"20210720","1783","9667","9600",富邦-台南,31,1,30,1,0.65
"20210720","1783","003700300030006a","7000",兆豐-大安,0,46,46,-1,0.99
"20210720","1783","1520","1520",瑞士信貸,25,0,25,1,0.54
"20210720","1783","1440","1440",美林,25,66,41,-1,0.88
"20210720","1783","1560","1560",港商野村,74,49,25,1,0.54
"20210720","1783","0039003100380048","9100",群益金鼎-中山,3,43,40,-1,0.86
"20210720","1783","0038003100350053","8150",台新-中壢,23,0,23,1,0.50
"20210720","1783","0039003200310046","9200",凱基-天母,0,32,32,-1,0.69
"20210720","1783","0039003200300041","9200",凱基-板橋,75,54,21,1,0.45
"20210720","1783","0039003800390050","9800",元大-敦南,0,32,32,-1,0.69
"20210720","1783","6461","6460",大昌-樹林,20,0,20,1,0.43
"20210720","1783","9352","9300",華南永昌-桃園,0,28,28,-1,0.60
"20210720","1783","5856","5850",統一-台中,50,31,19,1,0.41
"20210720","1783","9661","9600",富邦-新店,6,33,27,-1,0.58
"20210721","1783","5603","5600",永興-台中,111,0,111,1,1.90
"20210721","1783","9834","9800",元大-中壢,9,270,261,-1,4.47
"20210721","1783","6160","6160",中國信託,120,14,106,1,1.82
"20210721","1783","9268","9200",凱基-台北,209,403,194,-1,3.32
"20210721","1783","8563","8560",新光-新竹,109,3,106,1,1.82
"20210721","1783","9329","9300",華南永昌-朴子,2,196,194,-1,3.32
"20210721","1783","9333","9300",華南永昌-長虹,109,3,106,1,1.82
"20210721","1783","5850","5850",統一,11,163,152,-1,2.60
"20210721","1783","003700300030006a","7000",兆豐-大安,100,3,97,1,1.66
"20210721","1783","0039003800310070","9800",元大-松山,0,74,74,-1,1.27
"20210721","1783","1470","1470",台灣摩根士丹利,93,7,86,1,1.47
"20210721","1783","0039003600310047","9600",富邦-成功,0,69,69,-1,1.18
"20210721","1783","9319","9300",華南永昌-鶯歌,85,7,78,1,1.34
"20210721","1783","1520","1520",瑞士信貸,0,58,58,-1,0.99
"20210721","1783","0039003600320056","9600",富邦-復興,60,2,58,1,0.99
"20210721","1783","8440","8440",摩根大通,225,281,56,-1,0.96
"20210721","1783","9867","9800",元大-北成功,56,0,56,1,0.96
"20210721","1783","0037003700390075","7790",國票-長城,3,56,53,-1,0.91
"20210721","1783","003900380039004a","9800",元大-彰化民生,52,0,52,1,0.89
"20210721","1783","1480","1480",美商高盛,98,149,51,-1,0.87
"20210721","1783","9814","9800",元大-大益,51,0,51,1,0.87
"20210721","1783","8564","8560",新光-台南,24,63,39,-1,0.67
"20210721","1783","0039003800310067","9800",元大-大里,53,6,47,1,0.80
"20210721","1783","1260","1260",宏遠證券,22,59,37,-1,0.63
"20210721","1783","7790","7790",國票證券,61,15,46,1,0.79
"20210721","1783","9218","9200",凱基-大直,0,35,35,-1,0.60
"20210721","1783","0039003100330055","9100",群益金鼎-崇德,42,1,41,1,0.70
"20210721","1783","2184","2180",亞東-新竹,0,30,30,-1,0.51
"20210722","1783","0037003700390072","7790",國票-桃園,41,0,41,1,3.76
"20210722","1783","1440","1440",美林,3,49,46,-1,4.22
"20210722","1783","8560","8560",新光,65,33,32,1,2.94
"20210722","1783","1560","1560",港商野村,0,43,43,-1,3.95
"20210722","1783","9333","9300",華南永昌-長虹,31,0,31,1,2.85
"20210722","1783","8157","8150",台新-左楠,0,30,30,-1,2.75
"20210722","1783","0037003700390058","7790",國票-中和,31,1,30,1,2.75
"20210722","1783","1650","1650",新加坡商瑞銀,2,31,29,-1,2.66
"20210722","1783","9319","9300",華南永昌-鶯歌,30,5,25,1,2.30
"20210722","1783","6161","6160",中國信託-三重,3,30,27,-1,2.48
"20210722","1783","003900380031006a","9800",元大-士林,22,0,22,1,2.02
"20210722","1783","0039003800300064","9800",元大-沙鹿,1,21,20,-1,1.84
"20210722","1783","5389","5380",第一金-中山,20,0,20,1,1.84
"20210722","1783","0038003100350041","8150",台新-高雄,2,20,18,-1,1.65
"20210722","1783","7006","7000",兆豐-台南,20,0,20,1,1.84
"20210722","1783","5262","5260",美好-楊梅,0,18,18,-1,1.65
"20210722","1783","9627","9600",富邦-內湖,25,5,20,1,1.84
"20210722","1783","0031003200360044","1260",宏遠-台南,1,16,15,-1,1.38
"20210722","1783","9665","9600",富邦-桃園,20,3,17,1,1.56
"20210722","1783","1470","1470",台灣摩根士丹利,2,16,14,-1,1.29
"20210722","1783","9366","9300",華南永昌-豐原,14,0,14,1,1.29
"20210722","1783","9676","9600",富邦-仁愛,1,15,14,-1,1.29
"20210722","1783","0039003800390043","9800",元大-板橋,15,1,14,1,1.29
"20210722","1783","0039004100380046","9A00",永豐金-敦南,0,13,13,-1,1.19
"20210722","1783","9322","9300",華南永昌-公誠,13,0,13,1,1.19
"20210722","1783","1480","1480",美商高盛,2,14,12,-1,1.10
"20210722","1783","0037003000300066","7000",兆豐-鹿港,11,0,11,1,1.01
"20210722","1783","5855","5850",統一-台南,0,11,11,-1,1.01
"20210723","1783","7006","7000",兆豐-台南,18,0,18,1,3.08
"20210723","1783","8560","8560",新光,0,37,37,-1,6.34
"20210723","1783","6915","6910",德信-和平,17,0,17,1,2.91
"20210723","1783","0039003800390064","9800",元大-北屯,2,24,22,-1,3.77
"20210723","1783","9623","9600",富邦-台北,17,1,16,1,2.74
"20210723","1783","8151","8150",台新-建北,0,20,20,-1,3.42
"20210723","1783","9898","9800",元大-新莊,16,0,16,1,2.74
"20210723","1783","0038003100350059","8150",台新-新營,0,20,20,-1,3.42
"20210723","1783","9183","9100",群益金鼎-高雄,15,0,15,1,2.57
"20210723","1783","9204","9200",凱基-台中,0,20,20,-1,3.42
"20210723","1783","9366","9300",華南永昌-豐原,16,1,15,1,2.57
"20210723","1783","8440","8440",摩根大通,14,33,19,-1,3.25
"20210723","1783","5603","5600",永興-台中,14,0,14,1,2.40
"20210723","1783","9857","9800",元大-東蘆,0,18,18,-1,3.08
"20210723","1783","9333","9300",華南永昌-長虹,14,0,14,1,2.40
"20210723","1783","9287","9200",凱基-內湖,2,18,16,-1,2.74
"20210723","1783","0039003600320056","9600",富邦-復興,10,0,10,1,1.71
"20210723","1783","9187","9100",群益金鼎-彰化,0,10,10,-1,1.71
"20210723","1783","003900380031006d","9800",元大-前金,10,0,10,1,1.71
"20210723","1783","9324","9300",華南永昌-岡山,0,10,10,-1,1.71
"20210723","1783","9867","9800",元大-北成功,10,0,10,1,1.71
"20210723","1783","0039003800390050","9800",元大-敦南,0,10,10,-1,1.71
"20210723","1783","0039004100390031","9A00",永豐金-松山,10,0,10,1,1.71
"20210723","1783","0035003800350051","5850",統一-三多,0,8,8,-1,1.37
"20210723","1783","8882","8880",國泰-台中,12,3,9,1,1.54
"20210723","1783","1650","1650",新加坡商瑞銀,1,8,7,-1,1.20
"20210723","1783","1470","1470",台灣摩根士丹利,14,6,8,1,1.37
"20210723","1783","0039003800390045","9800",元大-草屯,2,9,7,-1,1.20
"20210726","1783","8440","8440",摩根大通,210,85,125,1,5.65
"20210726","1783","5603","5600",永興-台中,0,102,102,-1,4.61
"20210726","1783","5384","5380",第一金-台南,102,2,100,1,4.52
"20210726","1783","9331","9300",華南永昌-鳳山,1,76,75,-1,3.39
"20210726","1783","0039003600310047","9600",富邦-成功,68,0,68,1,3.07
"20210726","1783","9307","9300",華南永昌-大安,0,51,51,-1,2.31
"20210726","1783","9297","9200",凱基-文心,55,5,50,1,2.26
"20210726","1783","0039003800390050","9800",元大-敦南,0,44,44,-1,1.99
"20210726","1783","9319","9300",華南永昌-鶯歌,46,0,46,1,2.08
"20210726","1783","0037003700390072","7790",國票-桃園,0,41,41,-1,1.85
"20210726","1783","9614","9600",富邦-基隆,32,0,32,1,1.45
"20210726","1783","9874","9800",元大-雙和,0,40,40,-1,1.81
"20210726","1783","0038003800340042","8840",玉山-台中,32,1,31,1,1.40
"20210726","1783","0039003800390064","9800",元大-北屯,0,32,32,-1,1.45
"20210726","1783","0039004100390068","9A00",永豐金-台南,28,0,28,1,1.27
"20210726","1783","003900380039004a","9800",元大-彰化民生,0,32,32,-1,1.45
"20210726","1783","1470","1470",台灣摩根士丹利,26,0,26,1,1.18
"20210726","1783","9665","9600",富邦-桃園,1,31,30,-1,1.36
"20210726","1783","5854","5850",統一-城中,33,9,24,1,1.08
"20210726","1783","9306","9300",華南永昌-台南,1,24,23,-1,1.04
"20210726","1783","0039003800310061","9800",元大-歸仁,23,2,21,1,0.95
"20210726","1783","5389","5380",第一金-中山,0,20,20,-1,0.90
"20210726","1783","8840","8840",玉山證券,22,1,21,1,0.95
"20210726","1783","6167","6160",中國信託-松江,0,20,20,-1,0.90
"20210726","1783","9661","9600",富邦-新店,22,1,21,1,0.95
"20210726","1783","9329","9300",華南永昌-朴子,0,19,19,-1,0.86
"20210726","1783","9666","9600",富邦-南屯,20,0,20,1,0.90
"20210726","1783","7006","7000",兆豐-台南,0,18,18,-1,0.81
"20210727","1783","8440","8440",摩根大通,259,94,165,1,5.07
"20210727","1783","0037003000300056","7000",兆豐-新竹,0,131,131,-1,4.03
"20210727","1783","9658","9600",富邦-建國,100,2,98,1,3.01
"20210727","1783","003700300030006a","7000",兆豐-大安,1,79,78,-1,2.40
"20210727","1783","003700370039007a","7790",國票-博愛,80,7,73,1,2.24
"20210727","1783","0039003600310047","9600",富邦-成功,0,68,68,-1,2.09
"20210727","1783","9884","9800",元大-斗信,68,0,68,1,2.09
"20210727","1783","5603","5600",永興-台中,16,60,44,-1,1.35
"20210727","1783","9331","9300",華南永昌-鳳山,70,3,67,1,2.06
"20210727","1783","0039003800390050","9800",元大-敦南,0,41,41,-1,1.26
"20210727","1783","9816","9800",元大-新竹,60,0,60,1,1.84
"20210727","1783","7790","7790",國票證券,3,37,34,-1,1.04
"20210727","1783","9692","9600",富邦-嘉義,60,2,58,1,1.78
"20210727","1783","003900380039004a","9800",元大-彰化民生,23,53,30,-1,0.92
"20210727","1783","1260","1260",宏遠證券,53,0,53,1,1.63
"20210727","1783","0039004100380046","9A00",永豐金-敦南,1,30,29,-1,0.89
"20210727","1783","0039003100380048","9100",群益金鼎-中山,50,2,48,1,1.48
"20210727","1783","5854","5850",統一-城中,13,40,27,-1,0.83
"20210727","1783","8587","8580",聯邦-興中,40,0,40,1,1.23
"20210727","1783","9322","9300",華南永昌-公誠,11,38,27,-1,0.83
"20210727","1783","1470","1470",台灣摩根士丹利,38,9,29,1,0.89
"20210727","1783","0039003200300056","9200",凱基-新店,0,23,23,-1,0.71
"20210727","1783","1650","1650",新加坡商瑞銀,29,3,26,1,0.80
"20210727","1783","8560","8560",新光,37,59,22,-1,0.68
"20210727","1783","7006","7000",兆豐-台南,73,52,21,1,0.65
"20210727","1783","003900380031006a","9800",元大-士林,1,23,22,-1,0.68
"20210727","1783","0039003800310072","9800",元大-屏南,21,0,21,1,0.65
"20210727","1783","0039003600310043","9600",富邦-南京,5,26,21,-1,0.65
"20210728","1783","9131","9100",群益金鼎-民權,214,4,210,1,3.29
"20210728","1783","0037003000300056","7000",兆豐-新竹,3,211,208,-1,3.26
"20210728","1783","9666","9600",富邦-南屯,152,2,150,1,2.35
"20210728","1783","5923","5920",元富-三重,2,205,203,-1,3.18
"20210728","1783","003500390032005a","5920",元富-安南,152,9,143,1,2.24
"20210728","1783","9137","9100",群益金鼎-士林,0,162,162,-1,2.54
"20210728","1783","1440","1440",美林,135,24,111,1,1.74
"20210728","1783","5852","5850",統一-敦南,0,160,160,-1,2.51
"20210728","1783","8563","8560",新光-新竹,103,6,97,1,1.52
"20210728","1783","5260","5260",美好,0,100,100,-1,1.57
"20210728","1783","0035003800350050","5850",統一-板橋,96,0,96,1,1.50
"20210728","1783","0039003600320056","9600",富邦-復興,0,85,85,-1,1.33
"20210728","1783","0039004100390037","9A00",永豐金-新竹,100,11,89,1,1.39
"20210728","1783","7792","7790",國票-北投,0,80,80,-1,1.25
"20210728","1783","9268","9200",凱基-台北,273,185,88,1,1.38
"20210728","1783","0039003600310043","9600",富邦-南京,5,74,69,-1,1.08
"20210728","1783","8150","8150",台新證券,107,31,76,1,1.19
"20210728","1783","9867","9800",元大-北成功,0,65,65,-1,1.02
"20210728","1783","0037003000300057","7000",兆豐-城中,65,0,65,1,1.02
"20210728","1783","0039003800390043","9800",元大-板橋,6,65,59,-1,0.92
"20210728","1783","1560","1560",港商野村,181,120,61,1,0.96
"20210728","1783","9898","9800",元大-新莊,11,65,54,-1,0.85
"20210728","1783","5920","5920",元富,76,18,58,1,0.91
"20210728","1783","0039003800390050","9800",元大-敦南,1,55,54,-1,0.85
"20210728","1783","8158","8150",台新-松江,54,4,50,1,0.78
"20210728","1783","9208","9200",凱基-桃園,20,73,53,-1,0.83
"20210728","1783","9614","9600",富邦-基隆,50,0,50,1,0.78
"20210728","1783","9692","9600",富邦-嘉義,23,74,51,-1,0.80
"20210729","1783","5261","5260",美好-蘆洲,306,6,300,1,4.00
"20210729","1783","9666","9600",富邦-南屯,4,157,153,-1,2.04
"20210729","1783","9256","9200",凱基-南崁,143,4,139,1,1.85
"20210729","1783","003500390032005a","5920",元富-安南,0,151,151,-1,2.01
"20210729","1783","9218","9200",凱基-大直,90,0,90,1,1.20
"20210729","1783","9333","9300",華南永昌-長虹,20,128,108,-1,1.44
"20210729","1783","0035003800350055","5850",統一-南京,80,0,80,1,1.07
"20210729","1783","0035003800350050","5850",統一-板橋,1,96,95,-1,1.27
"20210729","1783","9834","9800",元大-中壢,71,13,58,1,0.77
"20210729","1783","9268","9200",凱基-台北,279,372,93,-1,1.24
"20210729","1783","7031","7030",致和-台北,51,0,51,1,0.68
"20210729","1783","5853","5850",統一-中壢,1,89,88,-1,1.17
"20210729","1783","9614","9600",富邦-基隆,50,0,50,1,0.67
"20210729","1783","0039003800310071","9800",元大-萬華,1,75,74,-1,0.99
"20210729","1783","8150","8150",台新證券,131,88,43,1,0.57
"20210729","1783","1440","1440",美林,19,89,70,-1,0.93
"20210729","1783","0039004100390037","9A00",永豐金-新竹,63,22,41,1,0.55
"20210729","1783","1470","1470",台灣摩根士丹利,76,142,66,-1,0.88
"20210729","1783","9189","9100",群益金鼎-桃園,38,1,37,1,0.49
"20210729","1783","8560","8560",新光,99,161,62,-1,0.83
"20210729","1783","5050","5050",大展,44,8,36,1,0.48
"20210729","1783","0039003800310067","9800",元大-大里,12,62,50,-1,0.67
"20210729","1783","5854","5850",統一-城中,66,30,36,1,0.48
"20210729","1783","5923","5920",元富-三重,0,50,50,-1,0.67
"20210729","1783","9692","9600",富邦-嘉義,54,21,33,1,0.44
"20210729","1783","0039003100330055","9100",群益金鼎-崇德,2,52,50,-1,0.67
"20210729","1783","003900380031004b","9800",元大-林園,67,34,33,1,0.44
"20210729","1783","8440","8440",摩根大通,236,285,49,-1,0.65
"20210730","1783","0036003300380041","6380",光和-嘉義,106,1,105,1,1.21
"20210730","1783","0035003800350055","5850",統一-南京,2,248,246,-1,2.84
"20210730","1783","1520","1520",瑞士信貸,140,42,98,1,1.13
"20210730","1783","0037003000300048","7000",兆豐-東門,56,270,214,-1,2.47
"20210730","1783","0037003700390072","7790",國票-桃園,79,0,79,1,0.91
"20210730","1783","5603","5600",永興-台中,5,119,114,-1,1.31
"20210730","1783","9317","9300",華南永昌-林口,129,56,73,1,0.84
"20210730","1783","9268","9200",凱基-台北,604,694,90,-1,1.04
"20210730","1783","9614","9600",富邦-基隆,62,3,59,1,0.68
"20210730","1783","9218","9200",凱基-大直,2,90,88,-1,1.01
"20210730","1783","9324","9300",華南永昌-岡山,41,1,40,1,0.46
"20210730","1783","003700370039007a","7790",國票-博愛,0,80,80,-1,0.92
"20210730","1783","0039003200310047","9200",凱基-五股,40,1,39,1,0.45
"20210730","1783","9256","9200",凱基-南崁,3,74,71,-1,0.82
"20210730","1783","0039003800310067","9800",元大-大里,57,20,37,1,0.43
"20210730","1783","1560","1560",港商野村,327,383,56,-1,0.65
"20210730","1783","003500390032004c","5920",元富-中壢,118,84,34,1,0.39
"20210730","1783","9183","9100",群益金鼎-高雄,4,59,55,-1,0.63
"20210730","1783","0035003900320057","5920",元富-吉利,37,4,33,1,0.38
"20210730","1783","9834","9800",元大-中壢,12,65,53,-1,0.61
"20210730","1783","0038003100350059","8150",台新-新營,33,1,32,1,0.37
"20210730","1783","7031","7030",致和-台北,0,51,51,-1,0.59
"20210730","1783","1260","1260",宏遠證券,40,10,30,1,0.35
"20210730","1783","9627","9600",富邦-內湖,6,54,48,-1,0.55
"20210730","1783","9634","9600",富邦-羅東,42,12,30,1,0.35
"20210730","1783","5050","5050",大展,5,49,44,-1,0.51
"20210730","1783","003800380038004b","8880",國泰-板橋,42,12,30,1,0.35
"20210730","1783","0039003800310070","9800",元大-松山,4,44,40,-1,0.46
"20210601","1783","003900380039006a","9800",元大-樹林,44,10,34,1,2.71
"20210601","1783","1230","1230",彰銀,0,30,30,-1,2.39
"20210601","1783","9329","9300",華南永昌-朴子,30,0,30,1,2.39
"20210601","1783","8564","8560",新光-台南,8,30,22,-1,1.75
"20210601","1783","9800","9800",元大證券,27,2,25,1,1.99
"20210601","1783","9884","9800",元大-斗信,0,22,22,-1,1.75
"20210601","1783","0039003800310079","9800",元大-善化,23,1,22,1,1.75
"20210601","1783","9205","9200",凱基-三重,1,21,20,-1,1.59
"20210601","1783","5921","5920",元富-高雄,23,5,18,1,1.43
"20210601","1783","0039003800390045","9800",元大-草屯,0,15,15,-1,1.19
"20210601","1783","1560","1560",港商野村,40,23,17,1,1.35
"20210601","1783","003900380031004b","9800",元大-林園,0,14,14,-1,1.11
"20210601","1783","0039003800390041","9800",元大-北投,15,0,15,1,1.19
"20210601","1783","8450","8450",康和,0,13,13,-1,1.04
"20210601","1783","0039004100390058","9A00",永豐金-竹科,15,0,15,1,1.19
"20210601","1783","1020","1020",合庫證券,0,12,12,-1,0.96
"20210601","1783","0038003100350042","8150",台新-台中,17,3,14,1,1.11
"20210601","1783","1650","1650",新加坡商瑞銀,0,11,11,-1,0.88
"20210601","1783","9676","9600",富邦-仁愛,12,1,11,1,0.88
"20210601","1783","7006","7000",兆豐-台南,57,68,11,-1,0.88
"20210601","1783","1480","1480",美商高盛,10,0,10,1,0.80
"20210601","1783","0039003800380042","9800",元大-桃園,0,10,10,-1,0.80
"20210601","1783","003500390032004e","5920",元富-虎尾,10,0,10,1,0.80
"20210601","1783","003700300030005a","7000",兆豐-高雄,2,12,10,-1,0.80
"20210601","1783","0037003000300072","7000",兆豐-寶成,10,0,10,1,0.80
"20210601","1783","0037003700390063","7790",國票-敦北法人,0,10,10,-1,0.80
"20210601","1783","0039003200300046","9200",凱基-站前,10,0,10,1,0.80
"20210601","1783","003900410039004c","9A00",永豐金-台中,0,10,10,-1,0.80
"20210602","1783","1470","1470",台灣摩根士丹利,55,9,46,1,4.85
"20210602","1783","003900380030006c","9800",元大-虎尾,0,53,53,-1,5.59
"20210602","1783","9268","9200",凱基-台北,56,12,44,1,4.64
"20210602","1783","9362","9300",華南永昌-苗栗,0,41,41,-1,4.32
"20210602","1783","1440","1440",美林,25,0,25,1,2.64
"20210602","1783","003900380039006a","9800",元大-樹林,0,41,41,-1,4.32
"20210602","1783","1480","1480",美商高盛,22,1,21,1,2.22
"20210602","1783","0038003100350042","8150",台新-台中,0,16,16,-1,1.69
"20210602","1783","003700300030005a","7000",兆豐-高雄,21,0,21,1,2.22
"20210602","1783","0039004100390036","9A00",永豐金-博愛,0,14,14,-1,1.48
"20210602","1783","1033","1030",土銀-高雄,20,0,20,1,2.11
"20210602","1783","8882","8880",國泰-台中,1,13,12,-1,1.27
"20210602","1783","8440","8440",摩根大通,42,22,20,1,2.11
"20210602","1783","0035003800350057","5850",統一-金門,0,11,11,-1,1.16
"20210602","1783","9884","9800",元大-斗信,20,0,20,1,2.11
"20210602","1783","8560","8560",新光,3,14,11,-1,1.16
"20210602","1783","0039003800390045","9800",元大-草屯,20,0,20,1,2.11
"20210602","1783","9875","9800",元大-土城永寧,0,11,11,-1,1.16
"20210602","1783","1560","1560",港商野村,44,26,18,1,1.90
"20210602","1783","0039003800310053","9800",元大-崇德,0,10,10,-1,1.05
"20210602","1783","8846","8840",玉山-板橋,16,0,16,1,1.69
"20210602","1783","003900380030004b","9800",元大-竹科,1,10,9,-1,0.95
"20210602","1783","0035003800350046","5850",統一-彰化,15,0,15,1,1.58
"20210602","1783","0031003000340043","1040",臺銀-高雄,1,8,7,-1,0.74
"20210602","1783","5321","5320",高橋-龍潭,14,0,14,1,1.48
"20210602","1783","0039004100370039","9A00",永豐金-埔里,0,7,7,-1,0.74
"20210602","1783","0039003800300044","9800",元大-北府,15,1,14,1,1.48
"20210602","1783","5922","5920",元富-新店,0,6,6,-1,0.63
"20210603","1783","1560","1560",港商野村,53,7,46,1,5.54
"20210603","1783","0037003700390072","7790",國票-桃園,0,30,30,-1,3.61
"20210603","1783","1520","1520",瑞士信貸,41,1,40,1,4.81
"20210603","1783","0039003800310079","9800",元大-善化,0,22,22,-1,2.65
"20210603","1783","9867","9800",元大-北成功,39,0,39,1,4.69
"20210603","1783","5854","5850",統一-城中,0,20,20,-1,2.41
"20210603","1783","8564","8560",新光-台南,30,1,29,1,3.49
"20210603","1783","003900380030004b","9800",元大-竹科,0,17,17,-1,2.05
"20210603","1783","1470","1470",台灣摩根士丹利,29,0,29,1,3.49
"20210603","1783","0039003600310044","9600",富邦-忠孝,0,15,15,-1,1.81
"20210603","1783","9268","9200",凱基-台北,49,20,29,1,3.49
"20210603","1783","9614","9600",富邦-基隆,0,12,12,-1,1.44
"20210603","1783","0039003800300077","9800",元大-西屯,28,1,27,1,3.25
"20210603","1783","7000","7000",兆豐證券,0,10,10,-1,1.20
"20210603","1783","1650","1650",新加坡商瑞銀,26,6,20,1,2.41
"20210603","1783","9871","9800",元大-忠孝,0,10,10,-1,1.20
"20210603","1783","7006","7000",兆豐-台南,34,19,15,1,1.81
"20210603","1783","9884","9800",元大-斗信,0,10,10,-1,1.20
"20210603","1783","5261","5260",美好-蘆洲,10,0,10,1,1.20
"20210603","1783","003900380039006d","9800",元大-信義,6,16,10,-1,1.20
"20210603","1783","9324","9300",華南永昌-岡山,10,0,10,1,1.20
"20210603","1783","0039004100390062","9A00",永豐金-虎尾,0,7,7,-1,0.84
"20210603","1783","0039003600310048","9600",富邦-新板,10,0,10,1,1.20
"20210603","1783","6460","6460",大昌,0,6,6,-1,0.72
"20210603","1783","0039003600320044","9600",富邦-新莊,10,0,10,1,1.20
"20210603","1783","8560","8560",新光,6,12,6,-1,0.72
"20210603","1783","0039004100390058","9A00",永豐金-竹科,10,0,10,1,1.20
"20210603","1783","9274","9200",凱基-鳳山,0,6,6,-1,0.72
"20210604","1783","5852","5850",統一-敦南,96,2,94,1,7.84
"20210604","1783","1560","1560",港商野村,19,68,49,-1,4.09
"20210604","1783","7006","7000",兆豐-台南,60,35,25,1,2.09
"20210604","1783","8440","8440",摩根大通,49,98,49,-1,4.09
"20210604","1783","0039003800310079","9800",元大-善化,22,0,22,1,1.83
"20210604","1783","1650","1650",新加坡商瑞銀,0,42,42,-1,3.50
"20210604","1783","5600","5600",永興,20,0,20,1,1.67
"20210604","1783","1470","1470",台灣摩根士丹利,1,34,33,-1,2.75
"20210604","1783","003500390032006c","5920",元富-大裕,17,1,16,1,1.33
"20210604","1783","5389","5380",第一金-中山,0,22,22,-1,1.83
"20210604","1783","0036003000310064","6010",(牛牛牛)亞-鑫豐,16,0,16,1,1.33
"20210604","1783","1480","1480",美商高盛,1,21,20,-1,1.67
"20210604","1783","6210","6210",新百王,15,0,15,1,1.25
"20210604","1783","9369","9300",華南永昌-三重,0,20,20,-1,1.67
"20210604","1783","0039003200310046","9200",凱基-天母,12,0,12,1,1.00
"20210604","1783","8846","8840",玉山-板橋,2,21,19,-1,1.58
"20210604","1783","003900380039004a","9800",元大-彰化民生,12,1,11,1,0.92
"20210604","1783","0039003800390051","9800",元大-汐止,1,18,17,-1,1.42
"20210604","1783","5850","5850",統一,10,0,10,1,0.83
"20210604","1783","9135","9100",群益金鼎-東大,0,15,15,-1,1.25
"20210604","1783","9105","9100",群益金鼎-高盛,10,0,10,1,0.83
"20210604","1783","003700370039006e","7790",國票-南京,5,18,13,-1,1.08
"20210604","1783","0039004100390061","9A00",永豐金-苓雅,10,0,10,1,0.83
"20210604","1783","9634","9600",富邦-羅東,2,15,13,-1,1.08
"20210604","1783","0039003600320047","9600",富邦-斗六,9,0,9,1,0.75
"20210604","1783","003600310036004b","6160",中國信託-高雄,0,12,12,-1,1.00
"20210604","1783","9659","9600",富邦-高雄,14,5,9,1,0.75
"20210604","1783","8565","8560",新光-桃園,0,11,11,-1,0.92
"20210607","1783","0037003700390072","7790",國票-桃園,37,0,37,1,5.08
"20210607","1783","9268","9200",凱基-台北,15,57,42,-1,5.77
"20210607","1783","0039003800310046","9800",元大-福營,29,0,29,1,3.98
"20210607","1783","9329","9300",華南永昌-朴子,0,36,36,-1,4.95
"20210607","1783","5854","5850",統一-城中,28,4,24,1,3.30
"20210607","1783","5921","5920",元富-高雄,0,34,34,-1,4.67
"20210607","1783","9884","9800",元大-斗信,22,0,22,1,3.02
"20210607","1783","8150","8150",台新證券,0,31,31,-1,4.26
"20210607","1783","7006","7000",兆豐-台南,21,5,16,1,2.20
"20210607","1783","1650","1650",新加坡商瑞銀,1,27,26,-1,3.57
"20210607","1783","003500390032004e","5920",元富-虎尾,10,0,10,1,1.37
"20210607","1783","5321","5320",高橋-龍潭,0,14,14,-1,1.92
"20210607","1783","003500390032005a","5920",元富-安南,10,0,10,1,1.37
"20210607","1783","1020","1020",合庫證券,0,12,12,-1,1.65
"20210607","1783","7000","7000",兆豐證券,10,0,10,1,1.37
"20210607","1783","0039003600320044","9600",富邦-新莊,0,11,11,-1,1.51
"20210607","1783","0037003700390065","7790",國票-南科,10,0,10,1,1.37
"20210607","1783","9659","9600",富邦-高雄,0,11,11,-1,1.51
"20210607","1783","9853","9800",元大-南屯,10,0,10,1,1.37
"20210607","1783","1520","1520",瑞士信貸,0,10,10,-1,1.37
"20210607","1783","0038003100350059","8150",台新-新營,9,1,8,1,1.10
"20210607","1783","5261","5260",美好-蘆洲,0,10,10,-1,1.37
"20210607","1783","8560","8560",新光,33,25,8,1,1.10
"20210607","1783","003900310033004e","9100",群益金鼎-土城,0,10,10,-1,1.37
"20210607","1783","8565","8560",新光-桃園,8,0,8,1,1.10
"20210607","1783","9815","9800",元大-大灣,0,7,7,-1,0.96
"20210607","1783","0039003200310046","9200",凱基-天母,8,0,8,1,1.10
"20210607","1783","003900380031006d","9800",元大-前金,0,7,7,-1,0.96
"20210608","1783","7006","7000",兆豐-台南,19,2,17,1,4.84
"20210608","1783","9676","9600",富邦-仁愛,0,21,21,-1,5.98
"20210608","1783","1520","1520",瑞士信貸,14,0,14,1,3.99
"20210608","1783","9324","9300",華南永昌-岡山,0,20,20,-1,5.70
"20210608","1783","1440","1440",美林,13,1,12,1,3.42
"20210608","1783","1560","1560",港商野村,6,20,14,-1,3.99
"20210608","1783","003500320036004b","5260",美好-富順,10,0,10,1,2.85
"20210608","1783","8846","8840",玉山-板橋,0,12,12,-1,3.42
"20210608","1783","6210","6210",新百王,10,0,10,1,2.85
"20210608","1783","1111","1110",台灣企銀-台中,1,12,11,-1,3.13
"20210608","1783","9223","9200",凱基-豐中,10,0,10,1,2.85
"20210608","1783","003900310038004a","9100",群益金鼎-永和,0,11,11,-1,3.13
"20210608","1783","0039003800390064","9800",元大-北屯,10,0,10,1,2.85
"20210608","1783","6114","6110",台中銀-員林,0,10,10,-1,2.85
"20210608","1783","1470","1470",台灣摩根士丹利,19,10,9,1,2.56
"20210608","1783","9208","9200",凱基-桃園,0,10,10,-1,2.85
"20210608","1783","8440","8440",摩根大通,16,9,7,1,1.99
"20210608","1783","9853","9800",元大-南屯,0,10,10,-1,2.85
"20210608","1783","1480","1480",美商高盛,7,1,6,1,1.71
"20210608","1783","0031003200360058","1260",宏遠-新化,0,7,7,-1,1.99
"20210608","1783","0039003100330067","9100",群益金鼎-三重,8,2,6,1,1.71
"20210608","1783","8151","8150",台新-建北,1,7,6,-1,1.71
"20210608","1783","0035003900320045","5920",元富-城中,5,0,5,1,1.42
"20210608","1783","0039003800390043","9800",元大-板橋,1,7,6,-1,1.71
"20210608","1783","0035003900320064","5920",元富-延平(停),5,0,5,1,1.42
"20210608","1783","5850","5850",統一,0,5,5,-1,1.42
"20210608","1783","8841","8840",玉山-雙和,6,1,5,1,1.42
"20210608","1783","5856","5850",統一-台中,0,5,5,-1,1.42
"20210609","1783","9268","9200",凱基-台北,89,15,74,1,13.10
"20210609","1783","8880","8880",國泰證券,0,89,89,-1,15.75
"20210609","1783","0036003000310064","6010",(牛牛牛)亞-鑫豐,20,1,19,1,3.36
"20210609","1783","9239","9200",凱基-市政,0,32,32,-1,5.66
"20210609","1783","1560","1560",港商野村,16,2,14,1,2.48
"20210609","1783","003500390032006c","5920",元富-大裕,0,20,20,-1,3.54
"20210609","1783","0037003700390072","7790",國票-桃園,14,0,14,1,2.48
"20210609","1783","1111","1110",台灣企銀-台中,0,16,16,-1,2.83
"20210609","1783","8440","8440",摩根大通,29,16,13,1,2.30
"20210609","1783","9291","9200",凱基-大安,0,16,16,-1,2.83
"20210609","1783","8150","8150",台新證券,10,0,10,1,1.77
"20210609","1783","5962","5960",日茂-南投,0,10,10,-1,1.77
"20210609","1783","0039003800310046","9800",元大-福營,8,0,8,1,1.42
"20210609","1783","0037003700390065","7790",國票-南科,3,13,10,-1,1.77
"20210609","1783","6114","6110",台中銀-員林,6,0,6,1,1.06
"20210609","1783","0037003700390048","7790",國票-嘉義,1,11,10,-1,1.77
"20210609","1783","8841","8840",玉山-雙和,6,0,6,1,1.06
"20210609","1783","0039003600320047","9600",富邦-斗六,0,9,9,-1,1.59
"20210609","1783","0039003800390064","9800",元大-北屯,6,0,6,1,1.06
"20210609","1783","1470","1470",台灣摩根士丹利,2,8,6,-1,1.06
"20210609","1783","003500390032005a","5920",元富-安南,5,0,5,1,0.88
"20210609","1783","7792","7790",國票-北投,0,5,5,-1,0.88
"20210609","1783","9134","9100",群益金鼎-開元,5,0,5,1,0.88
"20210609","1783","0039003600310050","9600",富邦-和美,0,5,5,-1,0.88
"20210609","1783","0039003600310047","9600",富邦-成功,5,0,5,1,0.88
"20210609","1783","0039004100380046","9A00",永豐金-敦南,1,6,5,-1,0.88
"20210609","1783","9857","9800",元大-東蘆,5,0,5,1,0.88
"20210609","1783","1520","1520",瑞士信貸,0,4,4,-1,0.71
"20210610","1783","0031003000330046","1030",土銀-南港,20,0,20,1,6.78
"20210610","1783","9363","9300",華南永昌-彰化,0,20,20,-1,6.78
"20210610","1783","9268","9200",凱基-台北,29,9,20,1,6.78
"20210610","1783","9366","9300",華南永昌-豐原,0,14,14,-1,4.75
"20210610","1783","9208","9200",凱基-桃園,13,0,13,1,4.41
"20210610","1783","0039003600310048","9600",富邦-新板,0,12,12,-1,4.07
"20210610","1783","1650","1650",新加坡商瑞銀,10,0,10,1,3.39
"20210610","1783","0039004100390058","9A00",永豐金-竹科,0,10,10,-1,3.39
"20210610","1783","1480","1480",美商高盛,10,0,10,1,3.39
"20210610","1783","003900310038004a","9100",群益金鼎-永和,0,6,6,-1,2.03
"20210610","1783","9324","9300",華南永昌-岡山,10,0,10,1,3.39
"20210610","1783","9202","9200",凱基-中港,0,6,6,-1,2.03
"20210610","1783","8440","8440",摩根大通,20,11,9,1,3.05
"20210610","1783","7035","7030",致和-東門,0,5,5,-1,1.69
"20210610","1783","7006","7000",兆豐-台南,8,0,8,1,2.71
"20210610","1783","0037003700390045","7790",國票-南崁,0,5,5,-1,1.69
"20210610","1783","8151","8150",台新-建北,10,2,8,1,2.71
"20210610","1783","9134","9100",群益金鼎-開元,0,5,5,-1,1.69
"20210610","1783","9858","9800",元大-龍潭,7,0,7,1,2.37
"20210610","1783","8565","8560",新光-桃園,0,4,4,-1,1.36
"20210610","1783","8150","8150",台新證券,10,4,6,1,2.03
"20210610","1783","003900380031006d","9800",元大-前金,0,4,4,-1,1.36
"20210610","1783","8560","8560",新光,10,4,6,1,2.03
"20210610","1783","9831","9800",元大-四維,0,4,4,-1,1.36
"20210610","1783","8561","8560",新光-台中,6,0,6,1,2.03
"20210610","1783","9857","9800",元大-東蘆,1,5,4,-1,1.36
"20210610","1783","5323","5320",高橋-內壢,5,0,5,1,1.69
"20210610","1783","1021","1020",合庫-台中,0,3,3,-1,1.02
"20210611","1783","0031003000330046","1030",土銀-南港,20,0,20,1,7.04
"20210611","1783","9324","9300",華南永昌-岡山,0,20,20,-1,7.04
"20210611","1783","0035003900320044","5920",元富-大昌,12,0,12,1,4.23
"20210611","1783","0039003100380047","9100",群益金鼎-新莊,0,14,14,-1,4.93
"20210611","1783","9252","9200",凱基-嘉義,12,0,12,1,4.23
"20210611","1783","1560","1560",港商野村,6,19,13,-1,4.58
"20210611","1783","6210","6210",新百王,12,2,10,1,3.52
"20210611","1783","9268","9200",凱基-台北,4,16,12,-1,4.23
"20210611","1783","9312","9300",華南永昌-民權,10,0,10,1,3.52
"20210611","1783","5854","5850",統一-城中,0,10,10,-1,3.52
"20210611","1783","9817","9800",元大-東泰,14,4,10,1,3.52
"20210611","1783","003900310038004c","9100",群益金鼎-建成,0,10,10,-1,3.52
"20210611","1783","1470","1470",台灣摩根士丹利,8,1,7,1,2.46
"20210611","1783","0039004100390042","9A00",永豐金-中和,0,8,8,-1,2.82
"20210611","1783","8564","8560",新光-台南,7,0,7,1,2.46
"20210611","1783","7792","7790",國票-北投,0,7,7,-1,2.46
"20210611","1783","1111","1110",台灣企銀-台中,6,0,6,1,2.11
"20210611","1783","9278","9200",凱基-永康,0,6,6,-1,2.11
"20210611","1783","0039003200310046","9200",凱基-天母,6,0,6,1,2.11
"20210611","1783","7006","7000",兆豐-台南,0,5,5,-1,1.76
"20210611","1783","1116","1110",台灣企銀-屏東,5,0,5,1,1.76
"20210611","1783","9343","9300",華南永昌-頭份,0,5,5,-1,1.76
"20210611","1783","9215","9200",凱基-高美館,7,2,5,1,1.76
"20210611","1783","9661","9600",富邦-新店,0,5,5,-1,1.76
"20210611","1783","2181","2180",亞東-板橋,4,1,3,1,1.06
"20210611","1783","9300","9300",華南永昌,0,3,3,-1,1.06
"20210611","1783","6168","6160",中國信託-嘉義,3,0,3,1,1.06
"20210611","1783","9604","9600",富邦-陽明,0,3,3,-1,1.06
"20210615","1783","5603","5600",永興-台中,30,0,30,1,10.71
"20210615","1783","5855","5850",統一-台南,0,15,15,-1,5.36
"20210615","1783","1470","1470",台灣摩根士丹利,18,3,15,1,5.36
"20210615","1783","7792","7790",國票-北投,0,11,11,-1,3.93
"20210615","1783","8150","8150",台新證券,10,0,10,1,3.57
"20210615","1783","9208","9200",凱基-桃園,0,10,10,-1,3.57
"20210615","1783","9187","9100",群益金鼎-彰化,10,0,10,1,3.57
"20210615","1783","1480","1480",美商高盛,0,9,9,-1,3.21
"20210615","1783","0039003800310079","9800",元大-善化,8,0,8,1,2.86
"20210615","1783","003900360031004e","9600",富邦-西壢,0,9,9,-1,3.21
"20210615","1783","9857","9800",元大-東蘆,8,0,8,1,2.86
"20210615","1783","1560","1560",港商野村,6,13,7,-1,2.50
"20210615","1783","0039003200310046","9200",凱基-天母,6,0,6,1,2.14
"20210615","1783","8564","8560",新光-台南,0,7,7,-1,2.50
"20210615","1783","0039003800330055","9800",元大-頭份,6,0,6,1,2.14
"20210615","1783","8560","8560",新光,0,6,6,-1,2.14
"20210615","1783","9268","9200",凱基-台北,12,7,5,1,1.79
"20210615","1783","8888","8880",國泰-敦南,0,6,6,-1,2.14
"20210615","1783","0039004100390073","9A00",永豐金-彰化,5,0,5,1,1.79
"20210615","1783","8885","8880",國泰-桃園,0,5,5,-1,1.79
"20210615","1783","8561","8560",新光-台中,4,0,4,1,1.43
"20210615","1783","9309","9300",華南永昌-古亭,0,5,5,-1,1.79
"20210615","1783","1032","1030",土銀-台南,4,0,4,1,1.43
"20210615","1783","9312","9300",華南永昌-民權,0,5,5,-1,1.79
"20210615","1783","0035003900320044","5920",元富-大昌,5,1,4,1,1.43
"20210615","1783","9386","9300",華南永昌-東昇,0,5,5,-1,1.79
"20210615","1783","9888","9800",元大-鑫永和,4,0,4,1,1.43
"20210615","1783","1440","1440",美林,1,5,4,-1,1.43
"20210616","1783","9874","9800",元大-雙和,14,0,14,1,4.73
"20210616","1783","7006","7000",兆豐-台南,0,15,15,-1,5.07
"20210616","1783","9208","9200",凱基-桃園,13,0,13,1,4.39
"20210616","1783","0039003800310079","9800",元大-善化,4,19,15,-1,5.07
"20210616","1783","8440","8440",摩根大通,35,23,12,1,4.05
"20210616","1783","8150","8150",台新證券,1,12,11,-1,3.72
"20210616","1783","9268","9200",凱基-台北,17,5,12,1,4.05
"20210616","1783","9105","9100",群益金鼎-高盛,0,10,10,-1,3.38
"20210616","1783","6114","6110",台中銀-員林,10,0,10,1,3.38
"20210616","1783","0039004100390044","9A00",永豐金-忠孝,0,10,10,-1,3.38
"20210616","1783","0039003800380042","9800",元大-桃園,10,0,10,1,3.38
"20210616","1783","003800380038004b","8880",國泰-板橋,0,8,8,-1,2.70
"20210616","1783","6210","6210",新百王,9,0,9,1,3.04
"20210616","1783","9857","9800",元大-東蘆,0,8,8,-1,2.70
"20210616","1783","0039003200310046","9200",凱基-天母,8,0,8,1,2.70
"20210616","1783","003500390032004c","5920",元富-中壢,0,7,7,-1,2.36
"20210616","1783","0031003000320043","1020",合庫-自強,5,0,5,1,1.69
"20210616","1783","8157","8150",台新-左楠,0,6,6,-1,2.03
"20210616","1783","1560","1560",港商野村,10,5,5,1,1.69
"20210616","1783","0038003100350059","8150",台新-新營,0,6,6,-1,2.03
"20210616","1783","9322","9300",華南永昌-公誠,5,0,5,1,1.69
"20210616","1783","5384","5380",第一金-台南,0,5,5,-1,1.69
"20210616","1783","9324","9300",華南永昌-岡山,5,0,5,1,1.69
"20210616","1783","9312","9300",華南永昌-民權,0,5,5,-1,1.69
"20210616","1783","9814","9800",元大-大益,5,0,5,1,1.69
"20210616","1783","0039003800390045","9800",元大-草屯,0,5,5,-1,1.69
"20210616","1783","0039003800310049","9800",元大-天母,5,0,5,1,1.69
"20210616","1783","003900360035004b","9600",富邦-台中,0,4,4,-1,1.35
"20210617","1783","5603","5600",永興-台中,34,0,34,1,10.66
"20210617","1783","7006","7000",兆豐-台南,20,70,50,-1,15.67
"20210617","1783","6380","6380",光和,21,0,21,1,6.58
"20210617","1783","9800","9800",元大證券,0,27,27,-1,8.46
"20210617","1783","5263","5260",美好-泰山,19,0,19,1,5.96
"20210617","1783","1480","1480",美商高盛,1,17,16,-1,5.02
"20210617","1783","0039003800310044","9800",元大-南投,15,0,15,1,4.70
"20210617","1783","9324","9300",華南永昌-岡山,0,10,10,-1,3.13
"20210617","1783","0039003800310046","9800",元大-福營,15,0,15,1,4.70
"20210617","1783","1650","1650",新加坡商瑞銀,0,8,8,-1,2.51
"20210617","1783","9238","9200",凱基-士林,12,0,12,1,3.76
"20210617","1783","003900380039006d","9800",元大-信義,0,8,8,-1,2.51
"20210617","1783","9268","9200",凱基-台北,16,4,12,1,3.76
"20210617","1783","0035003900320045","5920",元富-城中,0,7,7,-1,2.19
"20210617","1783","9291","9200",凱基-大安,10,0,10,1,3.13
"20210617","1783","9654","9600",富邦-永和,0,7,7,-1,2.19
"20210617","1783","1440","1440",美林,8,0,8,1,2.51
"20210617","1783","5265","5260",美好-苗栗,0,5,5,-1,1.57
"20210617","1783","6167","6160",中國信託-松江,4,0,4,1,1.25
"20210617","1783","1560","1560",港商野村,5,10,5,-1,1.57
"20210617","1783","0039003200310046","9200",凱基-天母,4,0,4,1,1.25
"20210617","1783","5323","5320",高橋-內壢,0,5,5,-1,1.57
"20210617","1783","9257","9200",凱基-林口,4,0,4,1,1.25
"20210617","1783","0035003900320077","5920",元富-佳里,0,5,5,-1,1.57
"20210617","1783","9278","9200",凱基-永康,4,0,4,1,1.25
"20210617","1783","8565","8560",新光-桃園,0,5,5,-1,1.57
"20210617","1783","9817","9800",元大-東泰,4,0,4,1,1.25
"20210617","1783","0039003600320044","9600",富邦-新莊,0,5,5,-1,1.57
"20210618","1783","5603","5600",永興-台中,36,1,35,1,9.41
"20210618","1783","7000","7000",兆豐證券,0,22,22,-1,5.91
"20210618","1783","8440","8440",摩根大通,35,8,27,1,7.26
"20210618","1783","6380","6380",光和,0,21,21,-1,5.65
"20210618","1783","1560","1560",港商野村,26,5,21,1,5.65
"20210618","1783","9817","9800",元大-東泰,0,21,21,-1,5.65
"20210618","1783","9268","9200",凱基-台北,29,8,21,1,5.65
"20210618","1783","7006","7000",兆豐-台南,10,30,20,-1,5.38
"20210618","1783","0037003700390065","7790",國票-南科,11,1,10,1,2.69
"20210618","1783","8150","8150",台新證券,0,17,17,-1,4.57
"20210618","1783","9238","9200",凱基-士林,10,0,10,1,2.69
"20210618","1783","8842","8840",玉山-新莊,0,13,13,-1,3.49
"20210618","1783","9324","9300",華南永昌-岡山,10,0,10,1,2.69
"20210618","1783","0038003800380041","8880",國泰-館前,0,10,10,-1,2.69
"20210618","1783","1470","1470",台灣摩根士丹利,11,2,9,1,2.42
"20210618","1783","0038003100350059","8150",台新-新營,0,8,8,-1,2.15
"20210618","1783","9867","9800",元大-北成功,10,2,8,1,2.15
"20210618","1783","0039003800310044","9800",元大-南投,0,8,8,-1,2.15
"20210618","1783","1440","1440",美林,7,0,7,1,1.88
"20210618","1783","0036003000310064","6010",(牛牛牛)亞-鑫豐,0,7,7,-1,1.88
"20210618","1783","5854","5850",統一-城中,5,0,5,1,1.34
"20210618","1783","9208","9200",凱基-桃園,0,6,6,-1,1.61
"20210618","1783","0038003100350041","8150",台新-高雄,5,0,5,1,1.34
"20210618","1783","0039004100390055","9A00",永豐金-中正,0,6,6,-1,1.61
"20210618","1783","8847","8840",玉山-台南,5,0,5,1,1.34
"20210618","1783","8560","8560",新光,0,6,6,-1,1.61
"20210618","1783","0039003600310056","9600",富邦-板橋中山,5,0,5,1,1.34
"20210618","1783","0039003600320042","9600",富邦-二林,0,5,5,-1,1.34
"20210621","1783","0031003000320043","1020",合庫-自強,38,7,31,1,8.27
"20210621","1783","5854","5850",統一-城中,0,25,25,-1,6.67
"20210621","1783","0039003800310072","9800",元大-屏南,21,0,21,1,5.60
"20210621","1783","7006","7000",兆豐-台南,0,17,17,-1,4.53
"20210621","1783","0039003600310056","9600",富邦-板橋中山,20,0,20,1,5.33
"20210621","1783","0039003600310043","9600",富邦-南京,0,11,11,-1,2.93
"20210621","1783","5389","5380",第一金-中山,19,1,18,1,4.80
"20210621","1783","9898","9800",元大-新莊,4,15,11,-1,2.93
"20210621","1783","9366","9300",華南永昌-豐原,15,0,15,1,4.00
"20210621","1783","5929","5920",元富-台南,0,10,10,-1,2.67
"20210621","1783","5603","5600",永興-台中,23,9,14,1,3.73
"20210621","1783","003900360033004c","9600",富邦-豐原,0,10,10,-1,2.67
"20210621","1783","1650","1650",新加坡商瑞銀,13,1,12,1,3.20
"20210621","1783","6210","6210",新百王,0,9,9,-1,2.40
"20210621","1783","7003","7000",兆豐-台中,10,0,10,1,2.67
"20210621","1783","0039003800330055","9800",元大-頭份,0,8,8,-1,2.13
"20210621","1783","9226","9200",凱基-汐止,10,0,10,1,2.67
"20210621","1783","9208","9200",凱基-桃園,0,7,7,-1,1.87
"20210621","1783","003900380034004b","9800",元大-館前,8,0,8,1,2.13
"20210621","1783","0039004100390038","9A00",永豐金-大園,0,7,7,-1,1.87
"20210621","1783","1440","1440",美林,7,0,7,1,1.87
"20210621","1783","1042","1040",臺銀-臺南,0,5,5,-1,1.33
"20210621","1783","8440","8440",摩根大通,12,5,7,1,1.87
"20210621","1783","8711","8710",陽信-石牌,0,5,5,-1,1.33
"20210621","1783","1480","1480",美商高盛,7,1,6,1,1.60
"20210621","1783","0039003200300047","9200",凱基-彰化,0,5,5,-1,1.33
"20210621","1783","1560","1560",港商野村,16,10,6,1,1.60
"20210621","1783","003900360031004a","9600",富邦-興業,0,5,5,-1,1.33
"20210622","1783","8560","8560",新光,26,3,23,1,6.17
"20210622","1783","8440","8440",摩根大通,1,37,36,-1,9.65
"20210622","1783","9655","9600",富邦-板橋,20,0,20,1,5.36
"20210622","1783","9268","9200",凱基-台北,3,31,28,-1,7.51
"20210622","1783","9238","9200",凱基-士林,14,0,14,1,3.75
"20210622","1783","1470","1470",台灣摩根士丹利,0,23,23,-1,6.17
"20210622","1783","5263","5260",美好-泰山,11,0,11,1,2.95
"20210622","1783","5389","5380",第一金-中山,0,18,18,-1,4.83
"20210622","1783","9226","9200",凱基-汐止,10,0,10,1,2.68
"20210622","1783","0037003700390065","7790",國票-南科,0,10,10,-1,2.68
"20210622","1783","0035003900320064","5920",元富-延平(停),9,1,8,1,2.14
"20210622","1783","8884","8880",國泰-台南,0,9,9,-1,2.41
"20210622","1783","0039003800390064","9800",元大-北屯,7,0,7,1,1.88
"20210622","1783","9884","9800",元大-斗信,0,8,8,-1,2.14
"20210622","1783","9215","9200",凱基-高美館,7,1,6,1,1.61
"20210622","1783","0039004100390042","9A00",永豐金-中和,0,8,8,-1,2.14
"20210622","1783","0039003200310046","9200",凱基-天母,5,0,5,1,1.34
"20210622","1783","1480","1480",美商高盛,3,10,7,-1,1.88
"20210622","1783","9339","9300",華南永昌-竹北,5,0,5,1,1.34
"20210622","1783","1650","1650",新加坡商瑞銀,3,10,7,-1,1.88
"20210622","1783","9814","9800",元大-大益,5,0,5,1,1.34
"20210622","1783","6460","6460",大昌,0,5,5,-1,1.34
"20210622","1783","8565","8560",新光-桃園,4,0,4,1,1.07
"20210622","1783","8847","8840",玉山-台南,0,5,5,-1,1.34
"20210622","1783","9322","9300",華南永昌-公誠,4,0,4,1,1.07
"20210622","1783","003900320031004d","9200",凱基-八德,3,8,5,-1,1.34
"20210622","1783","0039003600310043","9600",富邦-南京,4,0,4,1,1.07
"20210622","1783","0039003800310053","9800",元大-崇德,0,5,5,-1,1.34
"20210623","1783","9291","9200",凱基-大安,40,0,40,1,12.12
"20210623","1783","9268","9200",凱基-台北,2,18,16,-1,4.85
"20210623","1783","0038003800340045","8840",玉山-城中,15,0,15,1,4.55
"20210623","1783","0039003800390064","9800",元大-北屯,0,16,16,-1,4.85
"20210623","1783","8586","8580",聯邦-大業,10,0,10,1,3.03
"20210623","1783","8440","8440",摩根大通,8,21,13,-1,3.94
"20210623","1783","9238","9200",凱基-士林,10,0,10,1,3.03
"20210623","1783","9328","9300",華南永昌-潮州,0,11,11,-1,3.33
"20210623","1783","9857","9800",元大-東蘆,10,0,10,1,3.03
"20210623","1783","0039003600320042","9600",富邦-二林,0,10,10,-1,3.03
"20210623","1783","1470","1470",台灣摩根士丹利,13,4,9,1,2.73
"20210623","1783","0039003800310053","9800",元大-崇德,0,10,10,-1,3.03
"20210623","1783","1480","1480",美商高盛,7,0,7,1,2.12
"20210623","1783","0039003800340043","9800",元大-新店中正,0,10,10,-1,3.03
"20210623","1783","9898","9800",元大-新莊,7,0,7,1,2.12
"20210623","1783","0035003900320064","5920",元富-延平(停),0,8,8,-1,2.42
"20210623","1783","0039003200310046","9200",凱基-天母,4,0,4,1,1.21
"20210623","1783","9831","9800",元大-四維,0,7,7,-1,2.12
"20210623","1783","003500390032007a","5920",元富-文心,3,0,3,1,0.91
"20210623","1783","0039004100390037","9A00",永豐金-新竹,0,6,6,-1,1.82
"20210623","1783","1520","1520",瑞士信貸,2,0,2,1,0.61
"20210623","1783","1115","1110",台灣企銀-太平,0,5,5,-1,1.52
"20210623","1783","8841","8840",玉山-雙和,2,0,2,1,0.61
"20210623","1783","8151","8150",台新-建北,0,5,5,-1,1.52
"20210623","1783","0039003200320048","9200",凱基-復興,2,0,2,1,0.61
"20210623","1783","0038003100350041","8150",台新-高雄,1,6,5,-1,1.52
"20210623","1783","9331","9300",華南永昌-鳳山,2,0,2,1,0.61
"20210623","1783","8847","8840",玉山-台南,0,5,5,-1,1.52
"20210624","1783","1470","1470",台灣摩根士丹利,38,0,38,1,8.80
"20210624","1783","0039003800390064","9800",元大-北屯,0,24,24,-1,5.56
"20210624","1783","1650","1650",新加坡商瑞銀,35,1,34,1,7.87
"20210624","1783","0036003000310064","6010",(牛牛牛)亞-鑫豐,0,21,21,-1,4.86
"20210624","1783","5852","5850",統一-敦南,34,0,34,1,7.87
"20210624","1783","0038003800340045","8840",玉山-城中,0,15,15,-1,3.47
"20210624","1783","1440","1440",美林,20,0,20,1,4.63
"20210624","1783","0039003200310045","9200",凱基-三峽,0,15,15,-1,3.47
"20210624","1783","5389","5380",第一金-中山,20,0,20,1,4.63
"20210624","1783","9366","9300",華南永昌-豐原,0,15,15,-1,3.47
"20210624","1783","9268","9200",凱基-台北,22,4,18,1,4.17
"20210624","1783","0039003800340043","9800",元大-新店中正,10,23,13,-1,3.01
"20210624","1783","5603","5600",永興-台中,24,10,14,1,3.24
"20210624","1783","8150","8150",台新證券,1,12,11,-1,2.55
"20210624","1783","6210","6210",新百王,17,7,10,1,2.31
"20210624","1783","0039004100390042","9A00",永豐金-中和,0,8,8,-1,1.85
"20210624","1783","9187","9100",群益金鼎-彰化,10,0,10,1,2.31
"20210624","1783","9666","9600",富邦-南屯,0,7,7,-1,1.62
"20210624","1783","9291","9200",凱基-大安,10,0,10,1,2.31
"20210624","1783","9238","9200",凱基-士林,0,6,6,-1,1.39
"20210624","1783","9627","9600",富邦-內湖,13,6,7,1,1.62
"20210624","1783","9252","9200",凱基-嘉義,0,6,6,-1,1.39
"20210624","1783","1560","1560",港商野村,24,18,6,1,1.39
"20210624","1783","9278","9200",凱基-永康,0,6,6,-1,1.39
"20210624","1783","003500380035004d","5850",統一-士林,6,0,6,1,1.39
"20210624","1783","0039003600320043","9600",富邦-東門,0,6,6,-1,1.39
"20210624","1783","9884","9800",元大-斗信,6,0,6,1,1.39
"20210624","1783","1021","1020",合庫-台中,0,5,5,-1,1.16
"20210625","1783","8440","8440",摩根大通,48,17,31,1,7.13
"20210625","1783","5854","5850",統一-城中,0,21,21,-1,4.83
"20210625","1783","1650","1650",新加坡商瑞銀,30,0,30,1,6.90
"20210625","1783","5389","5380",第一金-中山,0,20,20,-1,4.60
"20210625","1783","5852","5850",統一-敦南,24,0,24,1,5.52
"20210625","1783","5858","5850",統一-嘉義,0,14,14,-1,3.22
"20210625","1783","1470","1470",台灣摩根士丹利,20,0,20,1,4.60
"20210625","1783","0037003700390072","7790",國票-桃園,0,12,12,-1,2.76
"20210625","1783","8883","8880",國泰-松江,15,0,15,1,3.45
"20210625","1783","1041","1040",臺銀-鳳山,0,10,10,-1,2.30
"20210625","1783","6464","6460",大昌-新店,12,0,12,1,2.76
"20210625","1783","0039003800390058","9800",元大-民生,0,10,10,-1,2.30
"20210625","1783","1560","1560",港商野村,22,11,11,1,2.53
"20210625","1783","0039003200300046","9200",凱基-站前,0,8,8,-1,1.84
"20210625","1783","7003","7000",兆豐-台中,10,0,10,1,2.30
"20210625","1783","9215","9200",凱基-高美館,0,8,8,-1,1.84
"20210625","1783","003900380031004e","9800",元大-金門,8,0,8,1,1.84
"20210625","1783","0039003800310053","9800",元大-崇德,0,7,7,-1,1.61
"20210625","1783","0039003800300077","9800",元大-西屯,7,0,7,1,1.61
"20210625","1783","0039003100380075","9100",群益金鼎-瑞豐,0,5,5,-1,1.15
"20210625","1783","1480","1480",美商高盛,10,4,6,1,1.38
"20210625","1783","9233","9200",凱基-長庚,0,5,5,-1,1.15
"20210625","1783","5926","5920",元富-四維(停),6,0,6,1,1.38
"20210625","1783","8563","8560",新光-新竹,0,4,4,-1,0.92
"20210625","1783","9677","9600",富邦-三重,6,0,6,1,1.38
"20210625","1783","8842","8840",玉山-新莊,0,4,4,-1,0.92
"20210625","1783","0039004100390048","9A00",永豐金-新莊,5,0,5,1,1.15
"20210625","1783","9184","9100",群益金鼎-台中,0,4,4,-1,0.92
"20210628","1783","5603","5600",永興-台中,61,0,61,1,21.94
"20210628","1783","5050","5050",大展,0,35,35,-1,12.59
"20210628","1783","9268","9200",凱基-台北,33,0,33,1,11.87
"20210628","1783","0038003800340041","8840",玉山-士林,0,20,20,-1,7.19
"20210628","1783","1520","1520",瑞士信貸,18,0,18,1,6.47
"20210628","1783","5384","5380",第一金-台南,0,17,17,-1,6.12
"20210628","1783","1560","1560",港商野村,11,0,11,1,3.96
"20210628","1783","0035003800350046","5850",統一-彰化,0,15,15,-1,5.40
"20210628","1783","1470","1470",台灣摩根士丹利,10,0,10,1,3.60
"20210628","1783","0039003200300046","9200",凱基-站前,0,11,11,-1,3.96
"20210628","1783","7003","7000",兆豐-台中,10,0,10,1,3.60
"20210628","1783","9324","9300",華南永昌-岡山,0,10,10,-1,3.60
"20210628","1783","003900380039006d","9800",元大-信義,7,0,7,1,2.52
"20210628","1783","003900360032004c","9600",富邦-雙和,0,10,10,-1,3.60
"20210628","1783","0039003600310056","9600",富邦-板橋中山,5,0,5,1,1.80
"20210628","1783","9857","9800",元大-東蘆,5,15,10,-1,3.60
"20210628","1783","8886","8880",國泰-新莊,3,0,3,1,1.08
"20210628","1783","9300","9300",華南永昌,0,8,8,-1,2.88
"20210628","1783","1480","1480",美商高盛,4,1,3,1,1.08
"20210628","1783","9658","9600",富邦-建國,0,8,8,-1,2.88
"20210628","1783","6210","6210",新百王,4,1,3,1,1.08
"20210628","1783","9322","9300",華南永昌-公誠,0,7,7,-1,2.52
"20210628","1783","0038003800340045","8840",玉山-城中,3,0,3,1,1.08
"20210628","1783","9672","9600",富邦-員林,0,7,7,-1,2.52
"20210628","1783","1440","1440",美林,2,0,2,1,0.72
"20210628","1783","9278","9200",凱基-永康,2,8,6,-1,2.16
"20210628","1783","9302","9300",華南永昌-台中,2,0,2,1,0.72
"20210628","1783","9623","9600",富邦-台北,0,6,6,-1,2.16
"20210629","1783","5603","5600",永興-台中,28,0,28,1,12.84
"20210629","1783","9278","9200",凱基-永康,0,12,12,-1,5.50
"20210629","1783","1470","1470",台灣摩根士丹利,23,0,23,1,10.55
"20210629","1783","8886","8880",國泰-新莊,0,10,10,-1,4.59
"20210629","1783","5389","5380",第一金-中山,23,0,23,1,10.55
"20210629","1783","9627","9600",富邦-內湖,0,10,10,-1,4.59
"20210629","1783","1520","1520",瑞士信貸,18,0,18,1,8.26
"20210629","1783","0036003000310064","6010",(牛牛牛)亞-鑫豐,0,8,8,-1,3.67
"20210629","1783","1560","1560",港商野村,12,0,12,1,5.50
"20210629","1783","9672","9600",富邦-員林,0,8,8,-1,3.67
"20210629","1783","0039003200300056","9200",凱基-新店,7,0,7,1,3.21
"20210629","1783","8151","8150",台新-建北,0,7,7,-1,3.21
"20210629","1783","003900380031004e","9800",元大-金門,8,1,7,1,3.21
"20210629","1783","8560","8560",新光,1,8,7,-1,3.21
"20210629","1783","0039003800310055","9800",元大-華山,7,0,7,1,3.21
"20210629","1783","0031003200360055","1260",宏遠-館前,0,5,5,-1,2.29
"20210629","1783","5920","5920",元富,6,0,6,1,2.75
"20210629","1783","1115","1110",台灣企銀-太平,0,5,5,-1,2.29
"20210629","1783","9268","9200",凱基-台北,8,2,6,1,2.75
"20210629","1783","9303","9300",華南永昌-高雄,0,5,5,-1,2.29
"20210629","1783","6464","6460",大昌-新店,4,0,4,1,1.83
"20210629","1783","0039003800390046","9800",元大-高雄,0,5,5,-1,2.29
"20210629","1783","8440","8440",摩根大通,5,2,3,1,1.38
"20210629","1783","0039004100390039","9A00",永豐金-中壢,0,5,5,-1,2.29
"20210629","1783","9835","9800",元大-員林中山,3,0,3,1,1.38
"20210629","1783","9300","9300",華南永昌,0,4,4,-1,1.83
"20210629","1783","6115","6110",台中銀-台北,2,0,2,1,0.92
"20210629","1783","0039003100380075","9100",群益金鼎-瑞豐,0,4,4,-1,1.83
"20210630","1783","7006","7000",兆豐-台南,34,0,34,1,1.51
"20210630","1783","8440","8440",摩根大通,110,195,85,-1,3.78
"20210630","1783","1470","1470",台灣摩根士丹利,33,2,31,1,1.38
"20210630","1783","003900380030004b","9800",元大-竹科,7,82,75,-1,3.33
"20210630","1783","7791","7790",國票-台東,30,0,30,1,1.33
"20210630","1783","5854","5850",統一-城中,0,55,55,-1,2.44
"20210630","1783","8563","8560",新光-新竹,27,1,26,1,1.16
"20210630","1783","1560","1560",港商野村,13,57,44,-1,1.96
"20210630","1783","0039003600310052","9600",富邦-南員林,25,1,24,1,1.07
"20210630","1783","6210","6210",新百王,0,39,39,-1,1.73
"20210630","1783","8560","8560",新光,46,25,21,1,0.93
"20210630","1783","0037003700390072","7790",國票-桃園,1,39,38,-1,1.69
"20210630","1783","0039003200300041","9200",凱基-板橋,20,0,20,1,0.89
"20210630","1783","9268","9200",凱基-台北,37,73,36,-1,1.60
"20210630","1783","9291","9200",凱基-大安,20,0,20,1,0.89
"20210630","1783","0038003100350059","8150",台新-新營,0,31,31,-1,1.38
"20210630","1783","9217","9200",凱基-松山,20,1,19,1,0.84
"20210630","1783","0039003800310053","9800",元大-崇德,0,23,23,-1,1.02
"20210630","1783","0039003800330057","9800",元大-大里德芳,17,0,17,1,0.76
"20210630","1783","1440","1440",美林,17,38,21,-1,0.93
"20210630","1783","003900380039006a","9800",元大-樹林,21,4,17,1,0.76
"20210630","1783","1480","1480",美商高盛,32,52,20,-1,0.89
"20210630","1783","9363","9300",華南永昌-彰化,16,0,16,1,0.71
"20210630","1783","7005","7000",兆豐-台中港,0,20,20,-1,0.89
"20210630","1783","9857","9800",元大-東蘆,28,12,16,1,0.71
"20210630","1783","003900380031004e","9800",元大-金門,5,24,19,-1,0.84
"20210630","1783","6012","6010",(牛牛牛)亞-網路,15,0,15,1,0.67
"20210630","1783","5603","5600",永興-台中,0,17,17,-1,0.76
"20210503","1783","003900360035004b","9600",富邦-台中,40,0,40,1,5.30
"20210503","1783","9324","9300",華南永昌-岡山,0,51,51,-1,6.75
"20210503","1783","5920","5920",元富,20,0,20,1,2.65
"20210503","1783","7006","7000",兆豐-台南,1,50,49,-1,6.49
"20210503","1783","003900310038004a","9100",群益金鼎-永和,20,0,20,1,2.65
"20210503","1783","9852","9800",元大-永春,0,32,32,-1,4.24
"20210503","1783","7792","7790",國票-北投,19,0,19,1,2.52
"20210503","1783","7790","7790",國票證券,0,30,30,-1,3.97
"20210503","1783","8560","8560",新光,20,2,18,1,2.38
"20210503","1783","1650","1650",新加坡商瑞銀,7,34,27,-1,3.58
"20210503","1783","9268","9200",凱基-台北,59,43,16,1,2.12
"20210503","1783","003500390032006c","5920",元富-大裕,0,16,16,-1,2.12
"20210503","1783","0039003600310043","9600",富邦-南京,13,0,13,1,1.72
"20210503","1783","9319","9300",華南永昌-鶯歌,0,16,16,-1,2.12
"20210503","1783","9363","9300",華南永昌-彰化,10,0,10,1,1.32
"20210503","1783","8843","8840",玉山-高雄,1,14,13,-1,1.72
"20210503","1783","5323","5320",高橋-內壢,15,5,10,1,1.32
"20210503","1783","1440","1440",美林,5,17,12,-1,1.59
"20210503","1783","6165","6160",中國信託-新竹,10,0,10,1,1.32
"20210503","1783","003500380035005a","5850",統一-松江,0,11,11,-1,1.46
"20210503","1783","9266","9200",凱基-新豐,25,15,10,1,1.32
"20210503","1783","1042","1040",臺銀-臺南,0,10,10,-1,1.32
"20210503","1783","9322","9300",華南永昌-公誠,10,0,10,1,1.32
"20210503","1783","5263","5260",美好-泰山,0,10,10,-1,1.32
"20210503","1783","0039003800300043","9800",元大-斗六,11,1,10,1,1.32
"20210503","1783","0039003200310045","9200",凱基-三峽,0,10,10,-1,1.32
"20210503","1783","8883","8880",國泰-松江,8,0,8,1,1.06
"20210503","1783","0039003800310043","9800",元大-路竹,0,10,10,-1,1.32
"20210504","1783","9202","9200",凱基-中港,34,0,34,1,4.43
"20210504","1783","9658","9600",富邦-建國,0,61,61,-1,7.95
"20210504","1783","8440","8440",摩根大通,47,25,22,1,2.87
"20210504","1783","8843","8840",玉山-高雄,0,28,28,-1,3.65
"20210504","1783","8560","8560",新光,23,2,21,1,2.74
"20210504","1783","1650","1650",新加坡商瑞銀,21,42,21,-1,2.74
"20210504","1783","0039003800300044","9800",元大-北府,18,0,18,1,2.35
"20210504","1783","9324","9300",華南永昌-岡山,0,20,20,-1,2.61
"20210504","1783","0039003800310046","9800",元大-福營,16,0,16,1,2.09
"20210504","1783","9888","9800",元大-鑫永和,0,20,20,-1,2.61
"20210504","1783","003900380039006a","9800",元大-樹林,16,0,16,1,2.09
"20210504","1783","8565","8560",新光-桃園,1,17,16,-1,2.09
"20210504","1783","0039003800390064","9800",元大-北屯,14,0,14,1,1.83
"20210504","1783","9266","9200",凱基-新豐,0,15,15,-1,1.96
"20210504","1783","5922","5920",元富-新店,10,0,10,1,1.30
"20210504","1783","0039004100390052","9A00",永豐金-信義,0,13,13,-1,1.69
"20210504","1783","9322","9300",華南永昌-公誠,10,0,10,1,1.30
"20210504","1783","9257","9200",凱基-林口,10,22,12,-1,1.56
"20210504","1783","003900380039006d","9800",元大-信義,10,0,10,1,1.30
"20210504","1783","0038003100350041","8150",台新-高雄,0,11,11,-1,1.43
"20210504","1783","0038003800340042","8840",玉山-台中,9,0,9,1,1.17
"20210504","1783","0039003600310048","9600",富邦-新板,0,11,11,-1,1.43
"20210504","1783","9302","9300",華南永昌-台中,10,1,9,1,1.17
"20210504","1783","5854","5850",統一-城中,0,10,10,-1,1.30
"20210504","1783","7792","7790",國票-北投,8,1,7,1,0.91
"20210504","1783","6165","6160",中國信託-新竹,0,10,10,-1,1.30
"20210504","1783","0039004100390037","9A00",永豐金-新竹,7,0,7,1,0.91
"20210504","1783","0039003100380041","9100",群益金鼎-中壢,0,10,10,-1,1.30
"20210505","1783","5603","5600",永興-台中,52,0,52,1,14.65
"20210505","1783","9255","9200",凱基-和平,0,30,30,-1,8.45
"20210505","1783","8440","8440",摩根大通,44,2,42,1,11.83
"20210505","1783","9307","9300",華南永昌-大安,0,13,13,-1,3.66
"20210505","1783","1480","1480",美商高盛,26,4,22,1,6.20
"20210505","1783","9322","9300",華南永昌-公誠,1,13,12,-1,3.38
"20210505","1783","1650","1650",新加坡商瑞銀,20,0,20,1,5.63
"20210505","1783","8586","8580",聯邦-大業,0,10,10,-1,2.82
"20210505","1783","9324","9300",華南永昌-岡山,20,0,20,1,5.63
"20210505","1783","8380","8380",安泰,0,8,8,-1,2.25
"20210505","1783","1470","1470",台灣摩根士丹利,17,0,17,1,4.79
"20210505","1783","5927","5920",元富-林園,0,6,6,-1,1.69
"20210505","1783","1440","1440",美林,5,0,5,1,1.41
"20210505","1783","1233","1230",彰銀-台中,0,5,5,-1,1.41
"20210505","1783","0039003600320056","9600",富邦-復興,5,0,5,1,1.41
"20210505","1783","7005","7000",兆豐-台中港,0,5,5,-1,1.41
"20210505","1783","8560","8560",新光,5,1,4,1,1.13
"20210505","1783","7032","7030",致和-佳里,0,5,5,-1,1.41
"20210505","1783","9276","9200",凱基-苗栗,3,0,3,1,0.85
"20210505","1783","7790","7790",國票證券,0,5,5,-1,1.41
"20210505","1783","003900380039004a","9800",元大-彰化民生,3,0,3,1,0.85
"20210505","1783","8580","8580",聯邦商銀,0,5,5,-1,1.41
"20210505","1783","5112","5110",富隆-長安(停),2,0,2,1,0.56
"20210505","1783","0038003800340043","8840",玉山-南京東路,0,5,5,-1,1.41
"20210505","1783","1116","1110",台灣企銀-屏東,2,0,2,1,0.56
"20210505","1783","9205","9200",凱基-三重,0,5,5,-1,1.41
"20210505","1783","7006","7000",兆豐-台南,2,0,2,1,0.56
"20210505","1783","9208","9200",凱基-桃園,0,5,5,-1,1.41
"20210506","1783","7006","7000",兆豐-台南,29,0,29,1,5.54
"20210506","1783","8840","8840",玉山證券,0,51,51,-1,9.75
"20210506","1783","8440","8440",摩根大通,51,24,27,1,5.16
"20210506","1783","9217","9200",凱基-松山,32,72,40,-1,7.65
"20210506","1783","6452","6450",永全-八德,15,0,15,1,2.87
"20210506","1783","5385","5380",第一金-桃園,0,17,17,-1,3.25
"20210506","1783","0039003800310046","9800",元大-福營,15,0,15,1,2.87
"20210506","1783","1021","1020",合庫-台中,0,15,15,-1,2.87
"20210506","1783","8560","8560",新光,14,0,14,1,2.68
"20210506","1783","9331","9300",華南永昌-鳳山,0,14,14,-1,2.68
"20210506","1783","0039003600310043","9600",富邦-南京,14,0,14,1,2.68
"20210506","1783","0039003600320045","9600",富邦-樹林,0,10,10,-1,1.91
"20210506","1783","1440","1440",美林,16,6,10,1,1.91
"20210506","1783","003500390032006f","5920",元富-新興,0,8,8,-1,1.53
"20210506","1783","0039003200310059","9200",凱基-東勢,10,0,10,1,1.91
"20210506","1783","0039003600320043","9600",富邦-東門,0,8,8,-1,1.53
"20210506","1783","1560","1560",港商野村,6,0,6,1,1.15
"20210506","1783","9822","9800",元大-土城學府,0,6,6,-1,1.15
"20210506","1783","2180","2180",亞東,7,1,6,1,1.15
"20210506","1783","0035003900320057","5920",元富-吉利,0,5,5,-1,0.96
"20210506","1783","1110","1110",台灣企銀,5,0,5,1,0.96
"20210506","1783","7032","7030",致和-佳里,0,5,5,-1,0.96
"20210506","1783","7005","7000",兆豐-台中港,5,0,5,1,0.96
"20210506","1783","0037003700390050","7790",國票-九鼎,0,5,5,-1,0.96
"20210506","1783","9661","9600",富邦-新店,5,0,5,1,0.96
"20210506","1783","8380","8380",安泰,0,5,5,-1,0.96
"20210506","1783","0031003100310042","1110",台灣企銀-建成,4,0,4,1,0.76
"20210506","1783","8490","8490",京城,0,5,5,-1,0.96
"20210507","1783","9268","9200",凱基-台北,52,6,46,1,19.57
"20210507","1783","0039003800390043","9800",元大-板橋,0,16,16,-1,6.81
"20210507","1783","8440","8440",摩根大通,36,8,28,1,11.91
"20210507","1783","0035003800350067","5850",統一-平鎮,0,11,11,-1,4.68
"20210507","1783","1470","1470",台灣摩根士丹利,12,0,12,1,5.11
"20210507","1783","9324","9300",華南永昌-岡山,0,11,11,-1,4.68
"20210507","1783","9857","9800",元大-東蘆,10,0,10,1,4.26
"20210507","1783","8840","8840",玉山證券,0,10,10,-1,4.26
"20210507","1783","6162","6160",中國信託-忠孝,8,0,8,1,3.40
"20210507","1783","9187","9100",群益金鼎-彰化,0,10,10,-1,4.26
"20210507","1783","1560","1560",港商野村,6,0,6,1,2.55
"20210507","1783","9655","9600",富邦-板橋,0,10,10,-1,4.26
"20210507","1783","7005","7000",兆豐-台中港,5,0,5,1,2.13
"20210507","1783","0039003800320042","9800",元大-博愛,0,10,10,-1,4.26
"20210507","1783","9800","9800",元大證券,4,0,4,1,1.70
"20210507","1783","9623","9600",富邦-台北,0,8,8,-1,3.40
"20210507","1783","5262","5260",美好-楊梅,3,0,3,1,1.28
"20210507","1783","7032","7030",致和-佳里,0,7,7,-1,2.98
"20210507","1783","0035003900320065","5920",元富-古亭,3,0,3,1,1.28
"20210507","1783","0035003800350044","5850",統一-新台中,0,5,5,-1,2.13
"20210507","1783","8150","8150",台新證券,3,0,3,1,1.28
"20210507","1783","9233","9200",凱基-長庚,0,5,5,-1,2.13
"20210507","1783","8561","8560",新光-台中,3,0,3,1,1.28
"20210507","1783","9323","9300",華南永昌-小港,0,5,5,-1,2.13
"20210507","1783","9307","9300",華南永昌-大安,3,0,3,1,1.28
"20210507","1783","0039003800310041","9800",元大-鶯歌,0,5,5,-1,2.13
"20210507","1783","1520","1520",瑞士信貸,2,0,2,1,0.85
"20210507","1783","003500390032006d","5920",元富-成功,0,4,4,-1,1.70
"20210510","1783","5603","5600",永興-台中,45,0,45,1,13.35
"20210510","1783","5854","5850",統一-城中,0,71,71,-1,21.07
"20210510","1783","9268","9200",凱基-台北,32,7,25,1,7.42
"20210510","1783","0037003000300045","7000",兆豐-斗南(停),0,10,10,-1,2.97
"20210510","1783","8560","8560",新光,20,0,20,1,5.93
"20210510","1783","9658","9600",富邦-建國,1,11,10,-1,2.97
"20210510","1783","1470","1470",台灣摩根士丹利,16,0,16,1,4.75
"20210510","1783","0039003800320042","9800",元大-博愛,0,10,10,-1,2.97
"20210510","1783","003900310033004e","9100",群益金鼎-土城,13,0,13,1,3.86
"20210510","1783","9857","9800",元大-東蘆,0,10,10,-1,2.97
"20210510","1783","1440","1440",美林,12,0,12,1,3.56
"20210510","1783","9871","9800",元大-忠孝,0,10,10,-1,2.97
"20210510","1783","9324","9300",華南永昌-岡山,10,0,10,1,2.97
"20210510","1783","6168","6160",中國信託-嘉義,0,6,6,-1,1.78
"20210510","1783","0039003100380058","9100",群益金鼎-台北,9,0,9,1,2.67
"20210510","1783","7032","7030",致和-佳里,0,5,5,-1,1.48
"20210510","1783","0039003800310046","9800",元大-福營,9,0,9,1,2.67
"20210510","1783","003800340035004a","8450",康和-高雄,0,5,5,-1,1.48
"20210510","1783","0039003800310055","9800",元大-華山,5,0,5,1,1.48
"20210510","1783","9188","9100",群益金鼎-三民,0,5,5,-1,1.48
"20210510","1783","5262","5260",美好-楊梅,4,0,4,1,1.19
"20210510","1783","0039003600320058","9600",富邦-文化,0,5,5,-1,1.48
"20210510","1783","5261","5260",美好-蘆洲,3,0,3,1,0.89
"20210510","1783","0039003800390057","9800",元大-豐原站前,0,4,4,-1,1.19
"20210510","1783","1560","1560",港商野村,3,0,3,1,0.89
"20210510","1783","0037003700390058","7790",國票-中和,0,3,3,-1,0.89
"20210510","1783","9306","9300",華南永昌-台南,3,0,3,1,0.89
"20210510","1783","8840","8840",玉山證券,10,13,3,-1,0.89
"20210511","1783","9874","9800",元大-雙和,57,0,57,1,9.11
"20210511","1783","8440","8440",摩根大通,65,101,36,-1,5.75
"20210511","1783","8560","8560",新光,55,2,53,1,8.47
"20210511","1783","7032","7030",致和-佳里,0,35,35,-1,5.59
"20210511","1783","1520","1520",瑞士信貸,35,2,33,1,5.27
"20210511","1783","9268","9200",凱基-台北,8,43,35,-1,5.59
"20210511","1783","0035003900320065","5920",元富-古亭,14,0,14,1,2.24
"20210511","1783","1440","1440",美林,8,37,29,-1,4.63
"20210511","1783","003900310033004e","9100",群益金鼎-土城,12,0,12,1,1.92
"20210511","1783","0039003800310067","9800",元大-大里,0,24,24,-1,3.83
"20210511","1783","1470","1470",台灣摩根士丹利,10,0,10,1,1.60
"20210511","1783","1560","1560",港商野村,1,23,22,-1,3.51
"20210511","1783","9257","9200",凱基-林口,10,0,10,1,1.60
"20210511","1783","003700370039005a","7790",國票-安和,0,20,20,-1,3.19
"20210511","1783","9334","9300",華南永昌-世貿,10,0,10,1,1.60
"20210511","1783","1480","1480",美商高盛,2,17,15,-1,2.40
"20210511","1783","0039003100380047","9100",群益金鼎-新莊,7,0,7,1,1.12
"20210511","1783","5263","5260",美好-泰山,0,15,15,-1,2.40
"20210511","1783","5265","5260",美好-苗栗,7,1,6,1,0.96
"20210511","1783","1650","1650",新加坡商瑞銀,0,11,11,-1,1.76
"20210511","1783","9208","9200",凱基-桃園,5,0,5,1,0.80
"20210511","1783","0038003800340043","8840",玉山-南京東路,0,11,11,-1,1.76
"20210511","1783","9215","9200",凱基-高美館,5,0,5,1,0.80
"20210511","1783","5385","5380",第一金-桃園,0,10,10,-1,1.60
"20210511","1783","9838","9800",元大-豐原,5,0,5,1,0.80
"20210511","1783","9324","9300",華南永昌-岡山,0,10,10,-1,1.60
"20210511","1783","0035003800350048","5850",統一-桃園,4,0,4,1,0.64
"20210511","1783","0039003800300043","9800",元大-斗六,0,10,10,-1,1.60
"20210512","1783","0039003100380073","9100",群益金鼎-丹鳳,106,1,105,1,3.46
"20210512","1783","5603","5600",永興-台中,11,113,102,-1,3.36
"20210512","1783","003900320031004d","9200",凱基-八德,52,0,52,1,1.71
"20210512","1783","5854","5850",統一-城中,95,170,75,-1,2.47
"20210512","1783","1520","1520",瑞士信貸,93,48,45,1,1.48
"20210512","1783","6452","6450",永全-八德,0,45,45,-1,1.48
"20210512","1783","9899","9800",元大-淡水,38,0,38,1,1.25
"20210512","1783","9307","9300",華南永昌-大安,0,40,40,-1,1.32
"20210512","1783","1031","1030",土銀-台中,33,0,33,1,1.09
"20210512","1783","9100","9100",群益金鼎,0,38,38,-1,1.25
"20210512","1783","5265","5260",美好-苗栗,30,0,30,1,0.99
"20210512","1783","9257","9200",凱基-林口,89,125,36,-1,1.18
"20210512","1783","003900310033004e","9100",群益金鼎-土城,31,1,30,1,0.99
"20210512","1783","9202","9200",凱基-中港,3,37,34,-1,1.12
"20210512","1783","9822","9800",元大-土城學府,29,0,29,1,0.95
"20210512","1783","6465","6460",大昌-桃園,10,39,29,-1,0.95
"20210512","1783","1440","1440",美林,83,57,26,1,0.86
"20210512","1783","0039003600320056","9600",富邦-復興,0,29,29,-1,0.95
"20210512","1783","0039003800330047","9800",元大-上新莊,26,0,26,1,0.86
"20210512","1783","003900380039006d","9800",元大-信義,0,28,28,-1,0.92
"20210512","1783","9200","9200",凱基,23,0,23,1,0.76
"20210512","1783","003900380039006a","9800",元大-樹林,8,34,26,-1,0.86
"20210512","1783","0039003600320045","9600",富邦-樹林,24,2,22,1,0.72
"20210512","1783","5850","5850",統一,22,1,21,1,0.69
"20210512","1783","0031003000320043","1020",合庫-自強,2,23,21,-1,0.69
"20210512","1783","6382","6380",光和-田中,20,0,20,1,0.66
"20210512","1783","9278","9200",凱基-永康,0,21,21,-1,0.69
"20210513","1783","5603","5600",永興-台中,212,128,84,1,1.75
"20210513","1783","9268","9200",凱基-台北,281,398,117,-1,2.44
"20210513","1783","2180","2180",亞東,46,4,42,1,0.88
"20210513","1783","0039003100380073","9100",群益金鼎-丹鳳,2,105,103,-1,2.15
"20210513","1783","9858","9800",元大-龍潭,42,2,40,1,0.83
"20210513","1783","1520","1520",瑞士信貸,3,85,82,-1,1.71
"20210513","1783","8560","8560",新光,72,36,36,1,0.75
"20210513","1783","9281","9200",凱基-斗六,0,41,41,-1,0.86
"20210513","1783","9654","9600",富邦-永和,35,0,35,1,0.73
"20210513","1783","003900360035004b","9600",富邦-台中,17,51,34,-1,0.71
"20210513","1783","9874","9800",元大-雙和,37,10,27,1,0.56
"20210513","1783","1031","1030",土銀-台中,0,33,33,-1,0.69
"20210513","1783","8888","8880",國泰-敦南,92,69,23,1,0.48
"20210513","1783","1440","1440",美林,38,71,33,-1,0.69
"20210513","1783","5384","5380",第一金-台南,23,1,22,1,0.46
"20210513","1783","0039003800310046","9800",元大-福營,4,36,32,-1,0.67
"20210513","1783","003900380030004b","9800",元大-竹科,25,3,22,1,0.46
"20210513","1783","0039003200320048","9200",凱基-復興,0,31,31,-1,0.65
"20210513","1783","003900310033004e","9100",群益金鼎-土城,22,2,20,1,0.42
"20210513","1783","1650","1650",新加坡商瑞銀,20,48,28,-1,0.58
"20210513","1783","0039003800310044","9800",元大-南投,19,0,19,1,0.40
"20210513","1783","9822","9800",元大-土城學府,23,51,28,-1,0.58
"20210513","1783","6460","6460",大昌,19,1,18,1,0.38
"20210513","1783","1470","1470",台灣摩根士丹利,0,27,27,-1,0.56
"20210513","1783","1028","1020",合庫-彰化,15,0,15,1,0.31
"20210513","1783","7005","7000",兆豐-台中港,1,25,24,-1,0.50
"20210513","1783","0037003000300042","7000",兆豐-板橋,15,0,15,1,0.31
"20210513","1783","9200","9200",凱基,0,23,23,-1,0.48
"20210514","1783","8560","8560",新光,55,8,47,1,5.02
"20210514","1783","9654","9600",富邦-永和,0,35,35,-1,3.74
"20210514","1783","6167","6160",中國信託-松江,40,2,38,1,4.06
"20210514","1783","8440","8440",摩根大通,43,77,34,-1,3.63
"20210514","1783","9268","9200",凱基-台北,106,76,30,1,3.20
"20210514","1783","1650","1650",新加坡商瑞銀,3,28,25,-1,2.67
"20210514","1783","7006","7000",兆豐-台南,30,1,29,1,3.09
"20210514","1783","003700370039005a","7790",國票-安和,2,22,20,-1,2.13
"20210514","1783","9257","9200",凱基-林口,20,0,20,1,2.13
"20210514","1783","9896","9800",元大-台南,0,15,15,-1,1.60
"20210514","1783","0039003800310061","9800",元大-歸仁,17,0,17,1,1.81
"20210514","1783","0039003800300065","9800",元大-清水,2,16,14,-1,1.49
"20210514","1783","8450","8450",康和,13,0,13,1,1.39
"20210514","1783","7790","7790",國票證券,0,13,13,-1,1.39
"20210514","1783","9208","9200",凱基-桃園,20,8,12,1,1.28
"20210514","1783","0039003800390046","9800",元大-高雄,0,12,12,-1,1.28
"20210514","1783","9874","9800",元大-雙和,13,1,12,1,1.28
"20210514","1783","003900310038004b","9100",群益金鼎-東湖,0,11,11,-1,1.17
"20210514","1783","9272","9200",凱基-竹科,11,0,11,1,1.17
"20210514","1783","9801","9800",元大-城東,0,11,11,-1,1.17
"20210514","1783","7036","7030",致和-高雄,10,0,10,1,1.07
"20210514","1783","0039003800390067","9800",元大-嘉義,0,11,11,-1,1.17
"20210514","1783","8883","8880",國泰-松江,15,5,10,1,1.07
"20210514","1783","5320","5320",高橋,0,10,10,-1,1.07
"20210514","1783","9322","9300",華南永昌-公誠,12,2,10,1,1.07
"20210514","1783","0039004100390059","9A00",永豐金-板盛,0,10,10,-1,1.07
"20210514","1783","9838","9800",元大-豐原,11,1,10,1,1.07
"20210514","1783","9337","9300",華南永昌-內壢,0,9,9,-1,0.96
"20210517","1783","003900380030004b","9800",元大-竹科,200,0,200,1,6.59
"20210517","1783","5389","5380",第一金-中山,0,121,121,-1,3.99
"20210517","1783","9268","9200",凱基-台北,270,71,199,1,6.56
"20210517","1783","9309","9300",華南永昌-古亭,3,108,105,-1,3.46
"20210517","1783","5850","5850",統一,153,1,152,1,5.01
"20210517","1783","5384","5380",第一金-台南,70,4,66,1,2.18
"20210517","1783","003900360031004d","9600",富邦-木柵,0,96,96,-1,3.17
"20210517","1783","1560","1560",港商野村,75,14,61,1,2.01
"20210517","1783","5854","5850",統一-城中,71,160,89,-1,2.93
"20210517","1783","1440","1440",美林,39,8,31,1,1.02
"20210517","1783","0039003800310053","9800",元大-崇德,5,67,62,-1,2.04
"20210517","1783","003500380035004a","5850",統一-三重,31,0,31,1,1.02
"20210517","1783","9281","9200",凱基-斗六,0,50,50,-1,1.65
"20210517","1783","1230","1230",彰銀,30,0,30,1,0.99
"20210517","1783","9875","9800",元大-土城永寧,2,49,47,-1,1.55
"20210517","1783","003500330038004e","5380",第一金-豐原,28,0,28,1,0.92
"20210517","1783","0038003400350055","8450",康和-台北,0,35,35,-1,1.15
"20210517","1783","0039003100380044","9100",群益金鼎-東門,28,3,25,1,0.82
"20210517","1783","0039003800310046","9800",元大-福營,2,35,33,-1,1.09
"20210517","1783","003900380039006a","9800",元大-樹林,22,0,22,1,0.73
"20210517","1783","6620","6620",口袋證券,0,30,30,-1,0.99
"20210517","1783","9893","9800",元大-大天母,21,0,21,1,0.69
"20210517","1783","7006","7000",兆豐-台南,2,31,29,-1,0.96
"20210517","1783","5852","5850",統一-敦南,20,0,20,1,0.66
"20210517","1783","0039003800330047","9800",元大-上新莊,3,31,28,-1,0.92
"20210517","1783","6950","6950",福勝,20,0,20,1,0.66
"20210517","1783","0038003800340045","8840",玉山-城中,3,29,26,-1,0.86
"20210518","1783","5389","5380",第一金-中山,50,0,50,1,2.45
"20210518","1783","003900380030004b","9800",元大-竹科,1,200,199,-1,9.74
"20210518","1783","5050","5050",大展,35,1,34,1,1.66
"20210518","1783","5850","5850",統一,1,153,152,-1,7.44
"20210518","1783","0039003800310046","9800",元大-福營,33,1,32,1,1.57
"20210518","1783","1560","1560",港商野村,0,63,63,-1,3.08
"20210518","1783","9875","9800",元大-土城永寧,31,0,31,1,1.52
"20210518","1783","1650","1650",新加坡商瑞銀,4,53,49,-1,2.40
"20210518","1783","9661","9600",富邦-新店,32,3,29,1,1.42
"20210518","1783","1440","1440",美林,10,39,29,-1,1.42
"20210518","1783","1230","1230",彰銀,30,3,27,1,1.32
"20210518","1783","0038003400350046","8450",康和-仁愛,20,0,20,1,0.98
"20210518","1783","0039003200310043","9200",凱基-民權,0,20,20,-1,0.98
"20210518","1783","0039003600320056","9600",富邦-復興,21,1,20,1,0.98
"20210518","1783","5852","5850",統一-敦南,1,20,19,-1,0.93
"20210518","1783","0039003800390051","9800",元大-汐止,21,1,20,1,0.98
"20210518","1783","9822","9800",元大-土城學府,3,20,17,-1,0.83
"20210518","1783","0035003800350046","5850",統一-彰化,15,0,15,1,0.73
"20210518","1783","9873","9800",元大-西門,1,14,13,-1,0.64
"20210518","1783","9816","9800",元大-新竹,14,0,14,1,0.69
"20210518","1783","003900380039006a","9800",元大-樹林,10,22,12,-1,0.59
"20210518","1783","5263","5260",美好-泰山,11,0,11,1,0.54
"20210518","1783","6451","6450",永全-南崁,0,10,10,-1,0.49
"20210518","1783","0037003700390050","7790",國票-九鼎,11,0,11,1,0.54
"20210518","1783","9869","9800",元大-新盛,0,10,10,-1,0.49
"20210518","1783","9322","9300",華南永昌-公誠,15,4,11,1,0.54
"20210518","1783","8520","8520",中農,1,10,9,-1,0.44
"20210519","1783","5854","5850",統一-城中,30,0,30,1,5.79
"20210519","1783","1650","1650",新加坡商瑞銀,1,27,26,-1,5.02
"20210519","1783","003900380039006a","9800",元大-樹林,21,0,21,1,4.05
"20210519","1783","8440","8440",摩根大通,12,38,26,-1,5.02
"20210519","1783","5389","5380",第一金-中山,20,0,20,1,3.86
"20210519","1783","003500380035004a","5850",統一-三重,0,25,25,-1,4.83
"20210519","1783","003900360032004c","9600",富邦-雙和,20,0,20,1,3.86
"20210519","1783","9268","9200",凱基-台北,27,48,21,-1,4.05
"20210519","1783","9322","9300",華南永昌-公誠,17,0,17,1,3.28
"20210519","1783","003900380031005a","9800",元大-潮州,0,20,20,-1,3.86
"20210519","1783","9208","9200",凱基-桃園,15,0,15,1,2.90
"20210519","1783","1480","1480",美商高盛,1,15,14,-1,2.70
"20210519","1783","8560","8560",新光,13,0,13,1,2.51
"20210519","1783","1115","1110",台灣企銀-太平,0,10,10,-1,1.93
"20210519","1783","9324","9300",華南永昌-岡山,15,4,11,1,2.12
"20210519","1783","7750","7750",北城證券,0,10,10,-1,1.93
"20210519","1783","0039003100380063","9100",群益金鼎-鳳山,10,0,10,1,1.93
"20210519","1783","0039003100330044","9100",群益金鼎-潭子,0,10,10,-1,1.93
"20210519","1783","9257","9200",凱基-林口,10,0,10,1,1.93
"20210519","1783","9831","9800",元大-四維,2,12,10,-1,1.93
"20210519","1783","8150","8150",台新證券,11,2,9,1,1.74
"20210519","1783","0039003800300064","9800",元大-沙鹿,0,9,9,-1,1.74
"20210519","1783","0039003800310046","9800",元大-福營,8,0,8,1,1.54
"20210519","1783","9273","9200",凱基-竹東,2,10,8,-1,1.54
"20210519","1783","003900380033006a","9800",元大-仁愛,7,0,7,1,1.35
"20210519","1783","6167","6160",中國信託-松江,0,7,7,-1,1.35
"20210519","1783","2180","2180",亞東,6,1,5,1,0.97
"20210519","1783","8888","8880",國泰-敦南,2,8,6,-1,1.16
"20210520","1783","5603","5600",永興-台中,79,3,76,1,4.89
"20210520","1783","7006","7000",兆豐-台南,15,75,60,-1,3.86
"20210520","1783","003900380030004b","9800",元大-竹科,50,1,49,1,3.15
"20210520","1783","003900380039006a","9800",元大-樹林,2,46,44,-1,2.83
"20210520","1783","1650","1650",新加坡商瑞銀,43,4,39,1,2.51
"20210520","1783","5263","5260",美好-泰山,0,40,40,-1,2.57
"20210520","1783","1560","1560",港商野村,53,15,38,1,2.44
"20210520","1783","003900360031004d","9600",富邦-木柵,0,30,30,-1,1.93
"20210520","1783","1440","1440",美林,42,5,37,1,2.38
"20210520","1783","9322","9300",華南永昌-公誠,0,29,29,-1,1.86
"20210520","1783","9205","9200",凱基-三重,30,0,30,1,1.93
"20210520","1783","0039003800310046","9800",元大-福營,1,23,22,-1,1.41
"20210520","1783","9268","9200",凱基-台北,53,30,23,1,1.48
"20210520","1783","0038003400350046","8450",康和-仁愛,0,20,20,-1,1.29
"20210520","1783","7000","7000",兆豐證券,47,25,22,1,1.41
"20210520","1783","9208","9200",凱基-桃園,0,20,20,-1,1.29
"20210520","1783","5389","5380",第一金-中山,20,0,20,1,1.29
"20210520","1783","0039003800310044","9800",元大-南投,4,24,20,-1,1.29
"20210520","1783","0039004100390067","9A00",永豐金-內湖,20,0,20,1,1.29
"20210520","1783","0038003100350042","8150",台新-台中,0,15,15,-1,0.96
"20210520","1783","9105","9100",群益金鼎-高盛,16,0,16,1,1.03
"20210520","1783","9257","9200",凱基-林口,0,15,15,-1,0.96
"20210520","1783","9366","9300",華南永昌-豐原,16,0,16,1,1.03
"20210520","1783","9816","9800",元大-新竹,1,16,15,-1,0.96
"20210520","1783","1470","1470",台灣摩根士丹利,14,0,14,1,0.90
"20210520","1783","8560","8560",新光,1,13,12,-1,0.77
"20210520","1783","1480","1480",美商高盛,18,4,14,1,0.90
"20210520","1783","0039003200300046","9200",凱基-站前,0,12,12,-1,0.77
"20210521","1783","0039003800390047","9800",元大-大同,100,15,85,1,5.32
"20210521","1783","5384","5380",第一金-台南,1,72,71,-1,4.44
"20210521","1783","9268","9200",凱基-台北,120,55,65,1,4.07
"20210521","1783","003900380030004b","9800",元大-竹科,0,50,50,-1,3.13
"20210521","1783","8440","8440",摩根大通,146,93,53,1,3.32
"20210521","1783","1230","1230",彰銀,0,40,40,-1,2.50
"20210521","1783","0035003800350055","5850",統一-南京,51,0,51,1,3.19
"20210521","1783","5854","5850",統一-城中,40,70,30,-1,1.88
"20210521","1783","5265","5260",美好-苗栗,30,0,30,1,1.88
"20210521","1783","0039003800310044","9800",元大-南投,0,29,29,-1,1.81
"20210521","1783","1440","1440",美林,42,16,26,1,1.63
"20210521","1783","9205","9200",凱基-三重,5,30,25,-1,1.56
"20210521","1783","0039003800380056","9800",元大-長庚,25,0,25,1,1.56
"20210521","1783","003500320036004b","5260",美好-富順,5,27,22,-1,1.38
"20210521","1783","1470","1470",台灣摩根士丹利,22,0,22,1,1.38
"20210521","1783","0039003100380044","9100",群益金鼎-東門,11,33,22,-1,1.38
"20210521","1783","9362","9300",華南永昌-苗栗,26,5,21,1,1.31
"20210521","1783","6950","6950",福勝,0,21,21,-1,1.31
"20210521","1783","0039003800310046","9800",元大-福營,23,2,21,1,1.31
"20210521","1783","5263","5260",美好-泰山,0,20,20,-1,1.25
"20210521","1783","9621","9600",富邦-花蓮,20,0,20,1,1.25
"20210521","1783","7000","7000",兆豐證券,0,20,20,-1,1.25
"20210521","1783","0031003000340044","1040",臺銀-金山,15,0,15,1,0.94
"20210521","1783","0039004100390067","9A00",永豐金-內湖,0,20,20,-1,1.25
"20210521","1783","0039003200300045","9200",凱基-東門,16,1,15,1,0.94
"20210521","1783","0035003800350046","5850",統一-彰化,0,15,15,-1,0.94
"20210521","1783","1262","1260",宏遠-桃園,16,2,14,1,0.88
"20210521","1783","9875","9800",元大-土城永寧,1,13,12,-1,0.75
"20210524","1783","0035003800350055","5850",統一-南京,151,2,149,1,4.00
"20210524","1783","9268","9200",凱基-台北,52,202,150,-1,4.03
"20210524","1783","0039003800390047","9800",元大-大同,139,12,127,1,3.41
"20210524","1783","5854","5850",統一-城中,85,210,125,-1,3.36
"20210524","1783","9884","9800",元大-斗信,95,1,94,1,2.53
"20210524","1783","1440","1440",美林,1,71,70,-1,1.88
"20210524","1783","8880","8880",國泰證券,89,0,89,1,2.39
"20210524","1783","1560","1560",港商野村,0,42,42,-1,1.13
"20210524","1783","9339","9300",華南永昌-竹北,85,25,60,1,1.61
"20210524","1783","1650","1650",新加坡商瑞銀,2,44,42,-1,1.13
"20210524","1783","8150","8150",台新證券,87,40,47,1,1.26
"20210524","1783","8561","8560",新光-台中,17,57,40,-1,1.07
"20210524","1783","8881","8880",國泰-高雄,48,4,44,1,1.18
"20210524","1783","0038003800340045","8840",玉山-城中,1,37,36,-1,0.97
"20210524","1783","8151","8150",台新-建北,31,1,30,1,0.81
"20210524","1783","5389","5380",第一金-中山,0,33,33,-1,0.89
"20210524","1783","2184","2180",亞東-新竹,25,0,25,1,0.67
"20210524","1783","0039003800390064","9800",元大-北屯,0,31,31,-1,0.83
"20210524","1783","5921","5920",元富-高雄,24,0,24,1,0.64
"20210524","1783","003500330038004e","5380",第一金-豐原,0,28,28,-1,0.75
"20210524","1783","003500390032004e","5920",元富-虎尾,22,0,22,1,0.59
"20210524","1783","1480","1480",美商高盛,2,24,22,-1,0.59
"20210524","1783","9184","9100",群益金鼎-台中,24,2,22,1,0.59
"20210524","1783","0039003600310058","9600",富邦-大墩,18,38,20,-1,0.54
"20210524","1783","9334","9300",華南永昌-世貿,22,4,18,1,0.48
"20210524","1783","0039003800310046","9800",元大-福營,16,36,20,-1,0.54
"20210524","1783","9627","9600",富邦-內湖,23,5,18,1,0.48
"20210524","1783","0035003900320067","5920",元富-中原,6,24,18,-1,0.48
"20210525","1783","0039003800390047","9800",元大-大同,50,0,50,1,4.42
"20210525","1783","8881","8880",國泰-高雄,0,45,45,-1,3.98
"20210525","1783","003900380039006a","9800",元大-樹林,42,0,42,1,3.71
"20210525","1783","0039003800310046","9800",元大-福營,1,40,39,-1,3.45
"20210525","1783","8564","8560",新光-台南,43,2,41,1,3.63
"20210525","1783","0039003200300044","9200",凱基-市府,0,36,36,-1,3.18
"20210525","1783","1020","1020",合庫證券,16,0,16,1,1.41
"20210525","1783","0038003800340045","8840",玉山-城中,0,30,30,-1,2.65
"20210525","1783","5854","5850",統一-城中,22,10,12,1,1.06
"20210525","1783","0039003100330049","9100",群益金鼎-萬華,0,17,17,-1,1.50
"20210525","1783","5853","5850",統一-中壢,10,0,10,1,0.88
"20210525","1783","0031003000340044","1040",臺銀-金山,0,15,15,-1,1.33
"20210525","1783","9837","9800",元大-北港,10,0,10,1,0.88
"20210525","1783","0039003600320044","9600",富邦-新莊,5,20,15,-1,1.33
"20210525","1783","0039004100390036","9A00",永豐金-博愛,10,0,10,1,0.88
"20210525","1783","1043","1040",臺銀-民權,0,13,13,-1,1.15
"20210525","1783","0035003300380050","5380",第一金-路竹,10,1,9,1,0.80
"20210525","1783","0039003600310052","9600",富邦-南員林,0,12,12,-1,1.06
"20210525","1783","8848","8840",玉山-嘉義,10,1,9,1,0.80
"20210525","1783","8888","8880",國泰-敦南,6,18,12,-1,1.06
"20210525","1783","0039003100380047","9100",群益金鼎-新莊,9,0,9,1,0.80
"20210525","1783","9625","9600",富邦-竹東,0,11,11,-1,0.97
"20210525","1783","9884","9800",元大-斗信,9,0,9,1,0.80
"20210525","1783","9326","9300",華南永昌-南京,0,10,10,-1,0.88
"20210525","1783","0039003200300046","9200",凱基-站前,8,0,8,1,0.71
"20210525","1783","9329","9300",華南永昌-朴子,0,10,10,-1,0.88
"20210525","1783","9658","9600",富邦-建國,8,0,8,1,0.71
"20210525","1783","9812","9800",元大-台中,0,10,10,-1,0.88
"20210526","1783","5852","5850",統一-敦南,209,0,209,1,1.93
"20210526","1783","0031003000320043","1020",合庫-自強,2,323,321,-1,2.96
"20210526","1783","5850","5850",統一,163,21,142,1,1.31
"20210526","1783","8440","8440",摩根大通,357,501,144,-1,1.33
"20210526","1783","0039003800350043","9800",元大-鳳中,105,0,105,1,0.97
"20210526","1783","5603","5600",永興-台中,82,224,142,-1,1.31
"20210526","1783","0039003800390047","9800",元大-大同,114,25,89,1,0.82
"20210526","1783","6115","6110",台中銀-台北,2,54,52,-1,0.48
"20210526","1783","7000","7000",兆豐證券,88,0,88,1,0.81
"20210526","1783","003900380039004a","9800",元大-彰化民生,2,54,52,-1,0.48
"20210526","1783","003900380030006c","9800",元大-虎尾,60,3,57,1,0.53
"20210526","1783","0038003800340045","8840",玉山-城中,9,59,50,-1,0.46
"20210526","1783","0037003700390050","7790",國票-九鼎,53,4,49,1,0.45
"20210526","1783","9884","9800",元大-斗信,77,123,46,-1,0.42
"20210526","1783","5926","5920",元富-四維(停),107,66,41,1,0.38
"20210526","1783","0039004100390048","9A00",永豐金-新莊,4,50,46,-1,0.42
"20210526","1783","8150","8150",台新證券,181,141,40,1,0.37
"20210526","1783","9858","9800",元大-龍潭,0,41,41,-1,0.38
"20210526","1783","0035003900320077","5920",元富-佳里,42,2,40,1,0.37
"20210526","1783","003900380039006a","9800",元大-樹林,4,45,41,-1,0.38
"20210526","1783","0039004100380046","9A00",永豐金-敦南,71,33,38,1,0.35
"20210526","1783","8564","8560",新光-台南,24,64,40,-1,0.37
"20210526","1783","8560","8560",新光,104,66,38,1,0.35
"20210526","1783","8840","8840",玉山證券,2,38,36,-1,0.33
"20210526","1783","9679","9600",富邦-延吉(停),41,5,36,1,0.33
"20210526","1783","2180","2180",亞東,1,34,33,-1,0.30
"20210526","1783","9200","9200",凱基,35,2,33,1,0.30
"20210526","1783","003500320036004b","5260",美好-富順,6,34,28,-1,0.26
"20210527","1783","8440","8440",摩根大通,73,32,41,1,3.04
"20210527","1783","2180","2180",亞東,0,51,51,-1,3.78
"20210527","1783","9268","9200",凱基-台北,48,22,26,1,1.93
"20210527","1783","0035003900320077","5920",元富-佳里,0,41,41,-1,3.04
"20210527","1783","9627","9600",富邦-內湖,25,1,24,1,1.78
"20210527","1783","9200","9200",凱基,0,33,33,-1,2.45
"20210527","1783","1480","1480",美商高盛,24,1,23,1,1.71
"20210527","1783","0039003800390047","9800",元大-大同,0,26,26,-1,1.93
"20210527","1783","9324","9300",華南永昌-岡山,20,0,20,1,1.48
"20210527","1783","1470","1470",台灣摩根士丹利,0,24,24,-1,1.78
"20210527","1783","0039003800310051","9800",元大-太平,18,0,18,1,1.34
"20210527","1783","8450","8450",康和,0,23,23,-1,1.71
"20210527","1783","003900360032004b","9600",富邦-中和,17,3,14,1,1.04
"20210527","1783","003500380035004d","5850",統一-士林,0,16,16,-1,1.19
"20210527","1783","003900380031004b","9800",元大-林園,14,0,14,1,1.04
"20210527","1783","0038003800380041","8880",國泰-館前,3,19,16,-1,1.19
"20210527","1783","0039003800390045","9800",元大-草屯,15,1,14,1,1.04
"20210527","1783","8881","8880",國泰-高雄,1,15,14,-1,1.04
"20210527","1783","1230","1230",彰銀,13,0,13,1,0.96
"20210527","1783","8150","8150",台新證券,15,28,13,-1,0.96
"20210527","1783","8520","8520",中農,13,0,13,1,0.96
"20210527","1783","5856","5850",統一-台中,0,12,12,-1,0.89
"20210527","1783","9386","9300",華南永昌-東昇,13,0,13,1,0.96
"20210527","1783","0039003800310079","9800",元大-善化,0,11,11,-1,0.82
"20210527","1783","8564","8560",新光-台南,13,2,11,1,0.82
"20210527","1783","8156","8150",台新-三民,0,10,10,-1,0.74
"20210527","1783","0039003800390051","9800",元大-汐止,14,3,11,1,0.82
"20210527","1783","0039003800310046","9800",元大-福營,0,10,10,-1,0.74
"20210528","1783","5854","5850",統一-城中,55,1,54,1,3.88
"20210528","1783","9679","9600",富邦-延吉(停),0,45,45,-1,3.23
"20210528","1783","0039003800390047","9800",元大-大同,41,0,41,1,2.94
"20210528","1783","5926","5920",元富-四維(停),0,35,35,-1,2.51
"20210528","1783","7006","7000",兆豐-台南,45,11,34,1,2.44
"20210528","1783","9339","9300",華南永昌-竹北,5,40,35,-1,2.51
"20210528","1783","9874","9800",元大-雙和,36,2,34,1,2.44
"20210528","1783","1480","1480",美商高盛,2,35,33,-1,2.37
"20210528","1783","5852","5850",統一-敦南,24,0,24,1,1.72
"20210528","1783","8440","8440",摩根大通,25,57,32,-1,2.30
"20210528","1783","0035003300380057","5380",第一金-華江,20,0,20,1,1.44
"20210528","1783","003700370039005a","7790",國票-安和,0,29,29,-1,2.08
"20210528","1783","0039003600320056","9600",富邦-復興,20,0,20,1,1.44
"20210528","1783","1650","1650",新加坡商瑞銀,0,28,28,-1,2.01
"20210528","1783","003900380039006d","9800",元大-信義,18,1,17,1,1.22
"20210528","1783","9666","9600",富邦-南屯,0,22,22,-1,1.58
"20210528","1783","0039003800390051","9800",元大-汐止,17,1,16,1,1.15
"20210528","1783","1117","1110",台灣企銀-竹北,0,21,21,-1,1.51
"20210528","1783","0035003800350055","5850",統一-南京,12,0,12,1,0.86
"20210528","1783","9837","9800",元大-北港,0,20,20,-1,1.44
"20210528","1783","5853","5850",統一-中壢,11,0,11,1,0.79
"20210528","1783","003500380035004a","5850",統一-三重,2,21,19,-1,1.36
"20210528","1783","0037003700390063","7790",國票-敦北法人,10,0,10,1,0.72
"20210528","1783","8455","8450",康和-台中,0,19,19,-1,1.36
"20210528","1783","9386","9300",華南永昌-東昇,10,0,10,1,0.72
"20210528","1783","9334","9300",華南永昌-世貿,1,20,19,-1,1.36
"20210528","1783","8584","8580",聯邦-雙和,8,0,8,1,0.57
"20210528","1783","1520","1520",瑞士信貸,0,16,16,-1,1.15
"20210531","1783","9268","9200",凱基-台北,129,26,103,1,7.54
"20210531","1783","0038003800380041","8880",國泰-館前,1,35,34,-1,2.49
"20210531","1783","0035003800350055","5850",統一-南京,68,1,67,1,4.90
"20210531","1783","9208","9200",凱基-桃園,0,28,28,-1,2.05
"20210531","1783","8564","8560",新光-台南,45,0,45,1,3.29
"20210531","1783","9627","9600",富邦-內湖,0,27,27,-1,1.98
"20210531","1783","7790","7790",國票證券,44,0,44,1,3.22
"20210531","1783","1650","1650",新加坡商瑞銀,0,22,22,-1,1.61
"20210531","1783","9672","9600",富邦-員林,41,0,41,1,3.00
"20210531","1783","5927","5920",元富-林園,0,21,21,-1,1.54
"20210531","1783","8440","8440",摩根大通,52,15,37,1,2.71
"20210531","1783","9621","9600",富邦-花蓮,0,20,20,-1,1.46
"20210531","1783","003900380039004a","9800",元大-彰化民生,25,0,25,1,1.83
"20210531","1783","9322","9300",華南永昌-公誠,1,20,19,-1,1.39
"20210531","1783","1020","1020",合庫證券,17,0,17,1,1.24
"20210531","1783","0039003200300045","9200",凱基-東門,1,19,18,-1,1.32
"20210531","1783","0035003800350048","5850",統一-桃園,17,0,17,1,1.24
"20210531","1783","1560","1560",港商野村,19,35,16,-1,1.17
"20210531","1783","0037003700390058","7790",國票-中和,15,0,15,1,1.10
"20210531","1783","0038003400350058","8450",康和-屏東,0,16,16,-1,1.17
"20210531","1783","0031003000320043","1020",合庫-自強,13,0,13,1,0.95
"20210531","1783","0039003800310052","9800",元大-竹山,0,15,15,-1,1.10
"20210531","1783","8150","8150",台新證券,27,14,13,1,0.95
"20210531","1783","7006","7000",兆豐-台南,51,65,14,-1,1.02
"20210531","1783","8450","8450",康和,28,15,13,1,0.95
"20210531","1783","5381","5380",第一金-員林,0,13,13,-1,0.95
"20210531","1783","003900380039006a","9800",元大-樹林,15,2,13,1,0.95
"20210531","1783","9636","9600",富邦-中壢,0,12,12,-1,0.88
"20210401","1783","7798","7790",國票-內壢,70,1,69,1,4.17
"20210401","1783","0039003800390058","9800",元大-民生,6,140,134,-1,8.11
"20210401","1783","003900360032004c","9600",富邦-雙和,56,2,54,1,3.27
"20210401","1783","8711","8710",陽信-石牌,0,65,65,-1,3.93
"20210401","1783","0031003000320043","1020",合庫-自強,46,0,46,1,2.78
"20210401","1783","7006","7000",兆豐-台南,20,72,52,-1,3.15
"20210401","1783","0039003600310047","9600",富邦-成功,128,92,36,1,2.18
"20210401","1783","9636","9600",富邦-中壢,15,48,33,-1,2.00
"20210401","1783","9322","9300",華南永昌-公誠,30,0,30,1,1.81
"20210401","1783","0039004100390044","9A00",永豐金-忠孝,37,61,24,-1,1.45
"20210401","1783","0038003800340045","8840",玉山-城中,28,1,27,1,1.63
"20210401","1783","9302","9300",華南永昌-台中,2,25,23,-1,1.39
"20210401","1783","0039003800310067","9800",元大-大里,23,0,23,1,1.39
"20210401","1783","6167","6160",中國信託-松江,0,21,21,-1,1.27
"20210401","1783","0035003300380057","5380",第一金-華江,20,0,20,1,1.21
"20210401","1783","8440","8440",摩根大通,24,45,21,-1,1.27
"20210401","1783","8381","8380",安泰-大發,18,0,18,1,1.09
"20210401","1783","8561","8560",新光-台中,2,23,21,-1,1.27
"20210401","1783","9816","9800",元大-新竹,17,0,17,1,1.03
"20210401","1783","0031003200360055","1260",宏遠-館前,0,19,19,-1,1.15
"20210401","1783","9319","9300",華南永昌-鶯歌,17,2,15,1,0.91
"20210401","1783","9859","9800",元大-新竹經國,2,20,18,-1,1.09
"20210401","1783","0039004100390065","9A00",永豐金-高雄,15,0,15,1,0.91
"20210401","1783","0039003600320050","9600",富邦-頭份,1,14,13,-1,0.79
"20210401","1783","8151","8150",台新-建北,14,0,14,1,0.85
"20210401","1783","1470","1470",台灣摩根士丹利,0,12,12,-1,0.73
"20210401","1783","9215","9200",凱基-高美館,16,3,13,1,0.79
"20210401","1783","0039004100390069","9A00",永豐金-新店,0,12,12,-1,0.73
"20210406","1783","8440","8440",摩根大通,101,10,91,1,11.45
"20210406","1783","0039003600310047","9600",富邦-成功,0,36,36,-1,4.53
"20210406","1783","0031003000320043","1020",合庫-自強,74,0,74,1,9.31
"20210406","1783","9300","9300",華南永昌,10,41,31,-1,3.90
"20210406","1783","5854","5850",統一-城中,53,0,53,1,6.67
"20210406","1783","9893","9800",元大-大天母,0,31,31,-1,3.90
"20210406","1783","0035003800350048","5850",統一-桃園,20,0,20,1,2.52
"20210406","1783","0038003800340042","8840",玉山-台中,0,25,25,-1,3.14
"20210406","1783","0039003200300044","9200",凱基-市府,20,0,20,1,2.52
"20210406","1783","9822","9800",元大-土城學府,0,18,18,-1,2.26
"20210406","1783","9324","9300",華南永昌-岡山,20,0,20,1,2.52
"20210406","1783","8564","8560",新光-台南,0,16,16,-1,2.01
"20210406","1783","0039003800390058","9800",元大-民生,20,0,20,1,2.52
"20210406","1783","0039003200300047","9200",凱基-彰化,7,23,16,-1,2.01
"20210406","1783","0035003800350055","5850",統一-南京,20,1,19,1,2.39
"20210406","1783","8884","8880",國泰-台南,0,15,15,-1,1.89
"20210406","1783","0039003800310053","9800",元大-崇德,16,0,16,1,2.01
"20210406","1783","9186","9100",群益金鼎-新竹,0,14,14,-1,1.76
"20210406","1783","0039004100390044","9A00",永豐金-忠孝,15,0,15,1,1.89
"20210406","1783","0039003200300056","9200",凱基-新店,0,12,12,-1,1.51
"20210406","1783","9366","9300",華南永昌-豐原,12,0,12,1,1.51
"20210406","1783","9869","9800",元大-新盛,0,12,12,-1,1.51
"20210406","1783","1114","1110",台灣企銀-嘉義,10,0,10,1,1.26
"20210406","1783","9873","9800",元大-西門,0,10,10,-1,1.26
"20210406","1783","8848","8840",玉山-嘉義,10,1,9,1,1.13
"20210406","1783","0035003900320049","5920",元富-嘉義,0,10,10,-1,1.26
"20210406","1783","1560","1560",港商野村,7,0,7,1,0.88
"20210406","1783","9285","9200",凱基-中壢,0,10,10,-1,1.26
"20210407","1783","8440","8440",摩根大通,63,3,60,1,6.59
"20210407","1783","0039004100390044","9A00",永豐金-忠孝,0,35,35,-1,3.84
"20210407","1783","0035003800350048","5850",統一-桃園,20,0,20,1,2.20
"20210407","1783","9108","9100",群益金鼎-海山,0,30,30,-1,3.29
"20210407","1783","7006","7000",兆豐-台南,30,10,20,1,2.20
"20210407","1783","0039003800390058","9800",元大-民生,10,40,30,-1,3.29
"20210407","1783","9285","9200",凱基-中壢,20,0,20,1,2.20
"20210407","1783","0031003000320043","1020",合庫-自強,15,0,15,1,1.65
"20210407","1783","9822","9800",元大-土城學府,0,24,24,-1,2.63
"20210407","1783","003900310033004e","9100",群益金鼎-土城,15,0,15,1,1.65
"20210407","1783","9208","9200",凱基-桃園,2,22,20,-1,2.20
"20210407","1783","0039003800310053","9800",元大-崇德,15,0,15,1,1.65
"20210407","1783","8841","8840",玉山-雙和,6,22,16,-1,1.76
"20210407","1783","0039004100390048","9A00",永豐金-新莊,15,0,15,1,1.65
"20210407","1783","8151","8150",台新-建北,0,14,14,-1,1.54
"20210407","1783","8564","8560",新光-台南,17,3,14,1,1.54
"20210407","1783","0038003800340045","8840",玉山-城中,0,13,13,-1,1.43
"20210407","1783","5265","5260",美好-苗栗,11,0,11,1,1.21
"20210407","1783","9655","9600",富邦-板橋,0,13,13,-1,1.43
"20210407","1783","1440","1440",美林,40,30,10,1,1.10
"20210407","1783","1470","1470",台灣摩根士丹利,0,12,12,-1,1.32
"20210407","1783","9647","9600",富邦-新竹,10,0,10,1,1.10
"20210407","1783","003600310036004b","6160",中國信託-高雄,0,11,11,-1,1.21
"20210407","1783","0039003800320042","9800",元大-博愛,9,0,9,1,0.99
"20210407","1783","9205","9200",凱基-三重,1,12,11,-1,1.21
"20210407","1783","8842","8840",玉山-新莊,10,2,8,1,0.88
"20210407","1783","7080","7080",石橋證券,0,10,10,-1,1.10
"20210408","1783","0037003000330042","7030",致和-崇德,24,0,24,1,3.41
"20210408","1783","9268","9200",凱基-台北,3,54,51,-1,7.25
"20210408","1783","9874","9800",元大-雙和,21,0,21,1,2.99
"20210408","1783","1440","1440",美林,1,25,24,-1,3.41
"20210408","1783","5854","5850",統一-城中,30,10,20,1,2.84
"20210408","1783","9285","9200",凱基-中壢,0,22,22,-1,3.13
"20210408","1783","7005","7000",兆豐-台中港,20,0,20,1,2.84
"20210408","1783","0039004100390039","9A00",永豐金-中壢,0,22,22,-1,3.13
"20210408","1783","0035003800350048","5850",統一-桃園,20,2,18,1,2.56
"20210408","1783","1114","1110",台灣企銀-嘉義,0,20,20,-1,2.84
"20210408","1783","0039003800310053","9800",元大-崇德,16,0,16,1,2.28
"20210408","1783","1470","1470",台灣摩根士丹利,0,18,18,-1,2.56
"20210408","1783","9257","9200",凱基-林口,12,0,12,1,1.71
"20210408","1783","8564","8560",新光-台南,0,18,18,-1,2.56
"20210408","1783","003900360031004d","9600",富邦-木柵,12,1,11,1,1.56
"20210408","1783","1035","1030",土銀-新竹,0,11,11,-1,1.56
"20210408","1783","0039003800390064","9800",元大-北屯,11,0,11,1,1.56
"20210408","1783","9105","9100",群益金鼎-高盛,0,11,11,-1,1.56
"20210408","1783","0039004100390048","9A00",永豐金-新莊,11,0,11,1,1.56
"20210408","1783","1041","1040",臺銀-鳳山,0,10,10,-1,1.42
"20210408","1783","0031003000320043","1020",合庫-自強,10,0,10,1,1.42
"20210408","1783","7006","7000",兆豐-台南,0,10,10,-1,1.42
"20210408","1783","9204","9200",凱基-台中,10,0,10,1,1.42
"20210408","1783","0038003100350053","8150",台新-中壢,0,10,10,-1,1.42
"20210408","1783","8841","8840",玉山-雙和,9,0,9,1,1.28
"20210408","1783","8711","8710",陽信-石牌,0,10,10,-1,1.42
"20210408","1783","9366","9300",華南永昌-豐原,12,4,8,1,1.14
"20210408","1783","9211","9200",凱基-台南,0,10,10,-1,1.42
"20210409","1783","9309","9300",華南永昌-古亭,60,0,60,1,9.33
"20210409","1783","0038003400350045","8450",康和-澎湖,2,32,30,-1,4.67
"20210409","1783","0035003800350048","5850",統一-桃園,20,0,20,1,3.11
"20210409","1783","0037003000330042","7030",致和-崇德,0,24,24,-1,3.73
"20210409","1783","0031003000320043","1020",合庫-自強,42,24,18,1,2.80
"20210409","1783","0035003800350055","5850",統一-南京,0,20,20,-1,3.11
"20210409","1783","5603","5600",永興-台中,18,0,18,1,2.80
"20210409","1783","8380","8380",安泰,0,20,20,-1,3.11
"20210409","1783","0039004100390069","9A00",永豐金-新店,17,0,17,1,2.64
"20210409","1783","8455","8450",康和-台中,0,20,20,-1,3.11
"20210409","1783","003900380039004a","9800",元大-彰化民生,11,0,11,1,1.71
"20210409","1783","9894","9800",元大-桃興,0,15,15,-1,2.33
"20210409","1783","1021","1020",合庫-台中,10,0,10,1,1.56
"20210409","1783","6385","6380",光和-花壇,0,14,14,-1,2.18
"20210409","1783","5854","5850",統一-城中,10,0,10,1,1.56
"20210409","1783","0038003100350059","8150",台新-新營,1,13,12,-1,1.87
"20210409","1783","0035003900320069","5920",元富-中港,10,0,10,1,1.56
"20210409","1783","0039003200300057","9200",凱基-大里,0,11,11,-1,1.71
"20210409","1783","0039003800390058","9800",元大-民生,10,0,10,1,1.56
"20210409","1783","0035003900320055","5920",元富-宜蘭,0,10,10,-1,1.56
"20210409","1783","9268","9200",凱基-台北,35,26,9,1,1.40
"20210409","1783","6463","6460",大昌-新竹,0,10,10,-1,1.56
"20210409","1783","0039004100390063","9A00",永豐金-永康,9,0,9,1,1.40
"20210409","1783","7006","7000",兆豐-台南,0,10,10,-1,1.56
"20210409","1783","003900360031004d","9600",富邦-木柵,8,0,8,1,1.24
"20210409","1783","9349","9300",華南永昌-板橋,0,10,10,-1,1.56
"20210409","1783","0038003800340043","8840",玉山-南京東路,7,0,7,1,1.09
"20210409","1783","1043","1040",臺銀-民權,0,8,8,-1,1.24
"20210412","1783","0035003800350048","5850",統一-桃園,50,1,49,1,9.96
"20210412","1783","003800380034004a","8840",玉山-大里,0,24,24,-1,4.88
"20210412","1783","0039003200320048","9200",凱基-復興,30,0,30,1,6.10
"20210412","1783","0037003700390050","7790",國票-九鼎,0,20,20,-1,4.07
"20210412","1783","0031003000340044","1040",臺銀-金山,20,0,20,1,4.07
"20210412","1783","1043","1040",臺銀-民權,0,17,17,-1,3.46
"20210412","1783","1440","1440",美林,23,8,15,1,3.05
"20210412","1783","8842","8840",玉山-新莊,0,16,16,-1,3.25
"20210412","1783","0031003000330046","1030",土銀-南港,15,0,15,1,3.05
"20210412","1783","8490","8490",京城,1,14,13,-1,2.64
"20210412","1783","8150","8150",台新證券,15,0,15,1,3.05
"20210412","1783","9622","9600",富邦-園區(停),0,13,13,-1,2.64
"20210412","1783","8565","8560",新光-桃園,12,0,12,1,2.44
"20210412","1783","0039003800310061","9800",元大-歸仁,0,12,12,-1,2.44
"20210412","1783","9268","9200",凱基-台北,19,8,11,1,2.24
"20210412","1783","9283","9200",凱基-北門,0,10,10,-1,2.03
"20210412","1783","0037003000300044","7000",兆豐-西螺,10,0,10,1,2.03
"20210412","1783","8841","8840",玉山-雙和,0,7,7,-1,1.42
"20210412","1783","9300","9300",華南永昌,30,20,10,1,2.03
"20210412","1783","8848","8840",玉山-嘉義,0,7,7,-1,1.42
"20210412","1783","9315","9300",華南永昌-苑裡,10,0,10,1,2.03
"20210412","1783","003900360031005a","9600",富邦-永康,0,7,7,-1,1.42
"20210412","1783","8883","8880",國泰-松江,9,0,9,1,1.83
"20210412","1783","6950","6950",福勝,0,6,6,-1,1.22
"20210412","1783","0035003800350045","5850",統一-新營,8,0,8,1,1.63
"20210412","1783","0039003600310048","9600",富邦-新板,0,6,6,-1,1.22
"20210412","1783","0039003600320043","9600",富邦-東門,8,0,8,1,1.63
"20210412","1783","0039003800300075","9800",元大-府城,0,6,6,-1,1.22
"20210413","1783","003500380035005a","5850",統一-松江,178,68,110,1,7.29
"20210413","1783","8440","8440",摩根大通,0,83,83,-1,5.50
"20210413","1783","0039004100390044","9A00",永豐金-忠孝,74,0,74,1,4.91
"20210413","1783","0037003000300049","7000",兆豐-北高雄,0,35,35,-1,2.32
"20210413","1783","9216","9200",凱基-信義,60,0,60,1,3.98
"20210413","1783","9205","9200",凱基-三重,0,27,27,-1,1.79
"20210413","1783","0031003000330046","1030",土銀-南港,55,0,55,1,3.65
"20210413","1783","8560","8560",新光,13,37,24,-1,1.59
"20210413","1783","1650","1650",新加坡商瑞銀,91,45,46,1,3.05
"20210413","1783","9872","9800",元大-復北,2,25,23,-1,1.53
"20210413","1783","0039003800310046","9800",元大-福營,29,0,29,1,1.92
"20210413","1783","1440","1440",美林,22,43,21,-1,1.39
"20210413","1783","9822","9800",元大-土城學府,20,0,20,1,1.33
"20210413","1783","0039003800310051","9800",元大-太平,0,20,20,-1,1.33
"20210413","1783","0035003800350048","5850",統一-桃園,20,1,19,1,1.26
"20210413","1783","9268","9200",凱基-台北,6,22,16,-1,1.06
"20210413","1783","0038003100350053","8150",台新-中壢,19,2,17,1,1.13
"20210413","1783","9227","9200",凱基-城中,0,13,13,-1,0.86
"20210413","1783","9312","9300",華南永昌-民權,16,0,16,1,1.06
"20210413","1783","8841","8840",玉山-雙和,5,18,13,-1,0.86
"20210413","1783","9816","9800",元大-新竹,16,1,15,1,0.99
"20210413","1783","9108","9100",群益金鼎-海山,0,11,11,-1,0.73
"20210413","1783","7008","7000",兆豐-三重,15,1,14,1,0.93
"20210413","1783","0039003600320055","9600",富邦-縣政,0,11,11,-1,0.73
"20210413","1783","003900380031006a","9800",元大-士林,15,1,14,1,0.93
"20210413","1783","1114","1110",台灣企銀-嘉義,0,10,10,-1,0.66
"20210413","1783","9285","9200",凱基-中壢,12,0,12,1,0.80
"20210413","1783","1020","1020",合庫證券,0,10,10,-1,0.66
"20210414","1783","0039003800390058","9800",元大-民生,110,30,80,1,8.14
"20210414","1783","0039004100390058","9A00",永豐金-竹科,0,50,50,-1,5.09
"20210414","1783","0031003000320043","1020",合庫-自強,51,32,19,1,1.93
"20210414","1783","0039003800390043","9800",元大-板橋,0,45,45,-1,4.58
"20210414","1783","9800","9800",元大證券,19,0,19,1,1.93
"20210414","1783","9227","9200",凱基-城中,0,20,20,-1,2.03
"20210414","1783","8564","8560",新光-台南,15,0,15,1,1.53
"20210414","1783","0039003800390047","9800",元大-大同,0,18,18,-1,1.83
"20210414","1783","1440","1440",美林,22,8,14,1,1.42
"20210414","1783","9312","9300",華南永昌-民權,0,15,15,-1,1.53
"20210414","1783","003900310038004b","9100",群益金鼎-東湖,14,0,14,1,1.42
"20210414","1783","9134","9100",群益金鼎-開元,0,14,14,-1,1.42
"20210414","1783","003900360032004c","9600",富邦-雙和,14,0,14,1,1.42
"20210414","1783","9278","9200",凱基-永康,0,14,14,-1,1.42
"20210414","1783","9322","9300",華南永昌-公誠,10,0,10,1,1.02
"20210414","1783","0035003900320056","5920",元富-民權(停),0,13,13,-1,1.32
"20210414","1783","0039003200300044","9200",凱基-市府,10,1,9,1,0.92
"20210414","1783","003500390032004c","5920",元富-中壢,0,12,12,-1,1.22
"20210414","1783","9874","9800",元大-雙和,9,0,9,1,0.92
"20210414","1783","9285","9200",凱基-中壢,0,12,12,-1,1.22
"20210414","1783","1470","1470",台灣摩根士丹利,19,13,6,1,0.61
"20210414","1783","8560","8560",新光,0,12,12,-1,1.22
"20210414","1783","0037003700390050","7790",國票-九鼎,5,0,5,1,0.51
"20210414","1783","7003","7000",兆豐-台中,0,11,11,-1,1.12
"20210414","1783","9183","9100",群益金鼎-高雄,5,0,5,1,0.51
"20210414","1783","9324","9300",華南永昌-岡山,0,11,11,-1,1.12
"20210414","1783","9898","9800",元大-新莊,5,0,5,1,0.51
"20210414","1783","0039003600310057","9600",富邦-東花蓮,1,12,11,-1,1.12
"20210415","1783","1440","1440",美林,92,8,84,1,7.31
"20210415","1783","5854","5850",統一-城中,5,75,70,-1,6.09
"20210415","1783","9268","9200",凱基-台北,81,19,62,1,5.40
"20210415","1783","9257","9200",凱基-林口,1,63,62,-1,5.40
"20210415","1783","003500380035005a","5850",統一-松江,75,17,58,1,5.05
"20210415","1783","8150","8150",台新證券,3,46,43,-1,3.74
"20210415","1783","5603","5600",永興-台中,63,19,44,1,3.83
"20210415","1783","8888","8880",國泰-敦南,7,30,23,-1,2.00
"20210415","1783","1520","1520",瑞士信貸,38,0,38,1,3.31
"20210415","1783","0039003800300043","9800",元大-斗六,0,22,22,-1,1.91
"20210415","1783","9800","9800",元大證券,29,1,28,1,2.44
"20210415","1783","0035003900320057","5920",元富-吉利,0,20,20,-1,1.74
"20210415","1783","9816","9800",元大-新竹,25,0,25,1,2.18
"20210415","1783","0039003800320043","9800",元大-六合,0,20,20,-1,1.74
"20210415","1783","1560","1560",港商野村,23,0,23,1,2.00
"20210415","1783","8840","8840",玉山證券,0,18,18,-1,1.57
"20210415","1783","1650","1650",新加坡商瑞銀,23,0,23,1,2.00
"20210415","1783","0039004100390069","9A00",永豐金-新店,0,15,15,-1,1.31
"20210415","1783","0035003900320055","5920",元富-宜蘭,20,0,20,1,1.74
"20210415","1783","0039003800390047","9800",元大-大同,0,12,12,-1,1.04
"20210415","1783","6465","6460",大昌-桃園,20,0,20,1,1.74
"20210415","1783","0039004100390037","9A00",永豐金-新竹,2,14,12,-1,1.04
"20210415","1783","7006","7000",兆豐-台南,45,25,20,1,1.74
"20210415","1783","5929","5920",元富-台南,0,11,11,-1,0.96
"20210415","1783","7798","7790",國票-內壢,20,0,20,1,1.74
"20210415","1783","9105","9100",群益金鼎-高盛,0,11,11,-1,0.96
"20210415","1783","0039003100380041","9100",群益金鼎-中壢,20,0,20,1,1.74
"20210415","1783","0039004100390055","9A00",永豐金-中正,0,11,11,-1,0.96
"20210416","1783","9268","9200",凱基-台北,58,2,56,1,8.92
"20210416","1783","0039004100390044","9A00",永豐金-忠孝,34,76,42,-1,6.69
"20210416","1783","003900380039006a","9800",元大-樹林,50,0,50,1,7.96
"20210416","1783","003500380035005a","5850",統一-松江,0,32,32,-1,5.10
"20210416","1783","9800","9800",元大證券,32,0,32,1,5.10
"20210416","1783","8564","8560",新光-台南,0,16,16,-1,2.55
"20210416","1783","003900360032004c","9600",富邦-雙和,30,0,30,1,4.78
"20210416","1783","5854","5850",統一-城中,0,13,13,-1,2.07
"20210416","1783","0031003000320043","1020",合庫-自強,35,15,20,1,3.18
"20210416","1783","1043","1040",臺銀-民權,0,12,12,-1,1.91
"20210416","1783","0039003100380041","9100",群益金鼎-中壢,20,0,20,1,3.18
"20210416","1783","003900380039006d","9800",元大-信義,0,12,12,-1,1.91
"20210416","1783","1650","1650",新加坡商瑞銀,19,2,17,1,2.71
"20210416","1783","0035003800350048","5850",統一-桃園,0,10,10,-1,1.59
"20210416","1783","003900360032004b","9600",富邦-中和,12,0,12,1,1.91
"20210416","1783","9208","9200",凱基-桃園,0,10,10,-1,1.59
"20210416","1783","0039003100330059","9100",群益金鼎-館前,10,0,10,1,1.59
"20210416","1783","0039003200310047","9200",凱基-五股,0,10,10,-1,1.59
"20210416","1783","003900310038004b","9100",群益金鼎-東湖,10,0,10,1,1.59
"20210416","1783","9366","9300",華南永昌-豐原,0,10,10,-1,1.59
"20210416","1783","9324","9300",華南永昌-岡山,10,0,10,1,1.59
"20210416","1783","8560","8560",新光,0,9,9,-1,1.43
"20210416","1783","9813","9800",元大-八德,10,0,10,1,1.59
"20210416","1783","0035003900320079","5920",元富-花蓮,0,9,9,-1,1.43
"20210416","1783","0039004100390068","9A00",永豐金-台南,8,0,8,1,1.27
"20210416","1783","0031003000340044","1040",臺銀-金山,2,10,8,-1,1.27
"20210416","1783","0038003800340045","8840",玉山-城中,10,3,7,1,1.11
"20210416","1783","0039003600310048","9600",富邦-新板,0,8,8,-1,1.27
"20210419","1783","7006","7000",兆豐-台南,489,54,435,1,10.26
"20210419","1783","5960","5960",日茂,0,205,205,-1,4.84
"20210419","1783","5850","5850",統一,141,4,137,1,3.23
"20210419","1783","9300","9300",華南永昌,2,156,154,-1,3.63
"20210419","1783","9135","9100",群益金鼎-東大,143,9,134,1,3.16
"20210419","1783","6160","6160",中國信託,0,134,134,-1,3.16
"20210419","1783","0035003800350055","5850",統一-南京,121,10,111,1,2.62
"20210419","1783","9105","9100",群益金鼎-高盛,0,101,101,-1,2.38
"20210419","1783","003500380035005a","5850",統一-松江,120,50,70,1,1.65
"20210419","1783","8841","8840",玉山-雙和,0,67,67,-1,1.58
"20210419","1783","1650","1650",新加坡商瑞銀,75,7,68,1,1.60
"20210419","1783","9216","9200",凱基-信義,10,77,67,-1,1.58
"20210419","1783","9800","9800",元大證券,66,4,62,1,1.46
"20210419","1783","0036003300380041","6380",光和-嘉義,1,67,66,-1,1.56
"20210419","1783","1560","1560",港商野村,78,21,57,1,1.34
"20210419","1783","0039004100390037","9A00",永豐金-新竹,0,61,61,-1,1.44
"20210419","1783","0039003600310047","9600",富邦-成功,55,0,55,1,1.30
"20210419","1783","7792","7790",國票-北投,4,55,51,-1,1.20
"20210419","1783","003700370039005a","7790",國票-安和,50,0,50,1,1.18
"20210419","1783","0035003900320055","5920",元富-宜蘭,0,41,41,-1,0.97
"20210419","1783","003900310038004b","9100",群益金鼎-東湖,50,0,50,1,1.18
"20210419","1783","0039003600320056","9600",富邦-復興,0,41,41,-1,0.97
"20210419","1783","7790","7790",國票證券,50,7,43,1,1.01
"20210419","1783","8560","8560",新光,24,62,38,-1,0.90
"20210419","1783","8150","8150",台新證券,47,9,38,1,0.90
"20210419","1783","0031003200360055","1260",宏遠-館前,5,43,38,-1,0.90
"20210419","1783","9307","9300",華南永昌-大安,32,1,31,1,0.73
"20210419","1783","9208","9200",凱基-桃園,1,35,34,-1,0.80
"20210420","1783","5854","5850",統一-城中,334,180,154,1,3.03
"20210420","1783","9135","9100",群益金鼎-東大,9,145,136,-1,2.68
"20210420","1783","9278","9200",凱基-永康,127,4,123,1,2.42
"20210420","1783","0035003800350055","5850",統一-南京,0,121,121,-1,2.38
"20210420","1783","8450","8450",康和,124,32,92,1,1.81
"20210420","1783","003900360032004c","9600",富邦-雙和,15,124,109,-1,2.15
"20210420","1783","9658","9600",富邦-建國,80,19,61,1,1.20
"20210420","1783","5850","5850",統一,64,173,109,-1,2.15
"20210420","1783","0031003000320043","1020",合庫-自強,81,24,57,1,1.12
"20210420","1783","9268","9200",凱基-台北,105,191,86,-1,1.69
"20210420","1783","7006","7000",兆豐-台南,61,10,51,1,1.00
"20210420","1783","003900310038004b","9100",群益金鼎-東湖,15,98,83,-1,1.63
"20210420","1783","7005","7000",兆豐-台中港,44,6,38,1,0.75
"20210420","1783","1650","1650",新加坡商瑞銀,12,92,80,-1,1.57
"20210420","1783","5603","5600",永興-台中,41,5,36,1,0.71
"20210420","1783","003500380035005a","5850",統一-松江,78,148,70,-1,1.38
"20210420","1783","0039003600310057","9600",富邦-東花蓮,35,0,35,1,0.69
"20210420","1783","1440","1440",美林,3,73,70,-1,1.38
"20210420","1783","8151","8150",台新-建北,35,6,29,1,0.57
"20210420","1783","1560","1560",港商野村,31,87,56,-1,1.10
"20210420","1783","8888","8880",國泰-敦南,124,97,27,1,0.53
"20210420","1783","0039003600310047","9600",富邦-成功,0,55,55,-1,1.08
"20210420","1783","8150","8150",台新證券,90,63,27,1,0.53
"20210420","1783","1470","1470",台灣摩根士丹利,0,39,39,-1,0.77
"20210420","1783","9307","9300",華南永昌-大安,45,18,27,1,0.53
"20210420","1783","0036003300380041","6380",光和-嘉義,1,31,30,-1,0.59
"20210420","1783","9215","9200",凱基-高美館,26,1,25,1,0.49
"20210420","1783","9324","9300",華南永昌-岡山,11,41,30,-1,0.59
"20210421","1783","9278","9200",凱基-永康,55,0,55,1,3.92
"20210421","1783","9816","9800",元大-新竹,5,79,74,-1,5.27
"20210421","1783","0035003800350048","5850",統一-桃園,54,2,52,1,3.70
"20210421","1783","8440","8440",摩根大通,45,95,50,-1,3.56
"20210421","1783","0031003000320043","1020",合庫-自強,64,19,45,1,3.21
"20210421","1783","9300","9300",華南永昌,2,46,44,-1,3.13
"20210421","1783","003500380035005a","5850",統一-松江,48,16,32,1,2.28
"20210421","1783","8560","8560",新光,5,45,40,-1,2.85
"20210421","1783","0039003800310053","9800",元大-崇德,27,5,22,1,1.57
"20210421","1783","003800380034004a","8840",玉山-大里,0,37,37,-1,2.64
"20210421","1783","7006","7000",兆豐-台南,25,5,20,1,1.42
"20210421","1783","8150","8150",台新證券,6,40,34,-1,2.42
"20210421","1783","0037003700390072","7790",國票-桃園,20,0,20,1,1.42
"20210421","1783","0039003600310057","9600",富邦-東花蓮,1,35,34,-1,2.42
"20210421","1783","003900380031006e","9800",元大-旗山,35,16,19,1,1.35
"20210421","1783","1520","1520",瑞士信貸,0,24,24,-1,1.71
"20210421","1783","0039003600310052","9600",富邦-南員林,15,0,15,1,1.07
"20210421","1783","5382","5380",第一金-台中,0,20,20,-1,1.42
"20210421","1783","9623","9600",富邦-台北,15,1,14,1,1.00
"20210421","1783","9215","9200",凱基-高美館,0,20,20,-1,1.42
"20210421","1783","8565","8560",新光-桃園,14,1,13,1,0.93
"20210421","1783","0039004100390068","9A00",永豐金-台南,0,20,20,-1,1.42
"20210421","1783","9211","9200",凱基-台南,15,2,13,1,0.93
"20210421","1783","0037003700390063","7790",國票-敦北法人,0,19,19,-1,1.35
"20210421","1783","9814","9800",元大-大益,13,0,13,1,0.93
"20210421","1783","0039003100380078","9100",群益金鼎-延平,0,19,19,-1,1.35
"20210421","1783","003900380031004b","9800",元大-林園,15,2,13,1,0.93
"20210421","1783","9366","9300",華南永昌-豐原,0,17,17,-1,1.21
"20210422","1783","5603","5600",永興-台中,64,0,64,1,4.92
"20210422","1783","0039003100380078","9100",群益金鼎-延平,0,50,50,-1,3.85
"20210422","1783","003900380031006e","9800",元大-旗山,40,0,40,1,3.08
"20210422","1783","0039003800310046","9800",元大-福營,0,47,47,-1,3.62
"20210422","1783","8560","8560",新光,38,6,32,1,2.46
"20210422","1783","003900380039006d","9800",元大-信義,45,72,27,-1,2.08
"20210422","1783","0039003200310045","9200",凱基-三峽,30,0,30,1,2.31
"20210422","1783","0039003800390049","9800",元大-蘆洲,0,23,23,-1,1.77
"20210422","1783","7006","7000",兆豐-台南,59,38,21,1,1.62
"20210422","1783","9884","9800",元大-斗信,2,22,20,-1,1.54
"20210422","1783","9322","9300",華南永昌-公誠,20,0,20,1,1.54
"20210422","1783","8151","8150",台新-建北,1,20,19,-1,1.46
"20210422","1783","1042","1040",臺銀-臺南,20,0,20,1,1.54
"20210422","1783","1650","1650",新加坡商瑞銀,30,47,17,-1,1.31
"20210422","1783","0039004100390042","9A00",永豐金-中和,20,0,20,1,1.54
"20210422","1783","9324","9300",華南永昌-岡山,3,20,17,-1,1.31
"20210422","1783","9366","9300",華南永昌-豐原,17,0,17,1,1.31
"20210422","1783","003500380035005a","5850",統一-松江,52,68,16,-1,1.23
"20210422","1783","9319","9300",華南永昌-鶯歌,15,0,15,1,1.15
"20210422","1783","0039003800310069","9800",元大-西螺,0,16,16,-1,1.23
"20210422","1783","9332","9300",華南永昌-楠梓,13,0,13,1,1.00
"20210422","1783","0035003800350045","5850",統一-新營,0,15,15,-1,1.15
"20210422","1783","1040","1040",臺銀,10,0,10,1,0.77
"20210422","1783","0039003600310052","9600",富邦-南員林,0,15,15,-1,1.15
"20210422","1783","0035003800350042","5850",統一-永和,10,0,10,1,0.77
"20210422","1783","0039003800390064","9800",元大-北屯,0,15,15,-1,1.15
"20210422","1783","5922","5920",元富-新店,10,0,10,1,0.77
"20210422","1783","003900310038004d","9100",群益金鼎-嘉義,1,15,14,-1,1.08
"20210423","1783","5603","5600",永興-台中,47,0,47,1,5.58
"20210423","1783","003900360032004c","9600",富邦-雙和,0,67,67,-1,7.96
"20210423","1783","9278","9200",凱基-永康,44,4,40,1,4.75
"20210423","1783","0035003900320057","5920",元富-吉利,0,40,40,-1,4.75
"20210423","1783","0037003000300057","7000",兆豐-城中,20,0,20,1,2.38
"20210423","1783","003500380035005a","5850",統一-松江,56,89,33,-1,3.92
"20210423","1783","9661","9600",富邦-新店,20,0,20,1,2.38
"20210423","1783","0039003200310045","9200",凱基-三峽,0,30,30,-1,3.56
"20210423","1783","003900380039006d","9800",元大-信義,31,14,17,1,2.02
"20210423","1783","8560","8560",新光,1,26,25,-1,2.97
"20210423","1783","6164","6160",中國信託-文心,15,0,15,1,1.78
"20210423","1783","1040","1040",臺銀,0,10,10,-1,1.19
"20210423","1783","8440","8440",摩根大通,49,37,12,1,1.43
"20210423","1783","7031","7030",致和-台北,0,10,10,-1,1.19
"20210423","1783","5922","5920",元富-新店,10,0,10,1,1.19
"20210423","1783","0039003200320048","9200",凱基-復興,0,10,10,-1,1.19
"20210423","1783","003700300030004d","7000",兆豐-桃園,10,0,10,1,1.19
"20210423","1783","9233","9200",凱基-長庚,0,10,10,-1,1.19
"20210423","1783","9211","9200",凱基-台南,10,0,10,1,1.19
"20210423","1783","0039004100300030","9A00",永豐金證券,0,9,9,-1,1.07
"20210423","1783","9666","9600",富邦-南屯,8,0,8,1,0.95
"20210423","1783","0037003000300068","7000",兆豐-三民,0,7,7,-1,0.83
"20210423","1783","9268","9200",凱基-台北,113,106,7,1,0.83
"20210423","1783","0039003800300044","9800",元大-北府,0,7,7,-1,0.83
"20210423","1783","9822","9800",元大-土城學府,10,3,7,1,0.83
"20210423","1783","003900380031004b","9800",元大-林園,0,6,6,-1,0.71
"20210423","1783","1021","1020",合庫-台中,6,0,6,1,0.71
"20210423","1783","1032","1030",土銀-台南,0,5,5,-1,0.59
"20210426","1783","9324","9300",華南永昌-岡山,30,0,30,1,7.32
"20210426","1783","8381","8380",安泰-大發,0,28,28,-1,6.83
"20210426","1783","8440","8440",摩根大通,29,6,23,1,5.61
"20210426","1783","5854","5850",統一-城中,0,20,20,-1,4.88
"20210426","1783","003900360032004c","9600",富邦-雙和,15,1,14,1,3.41
"20210426","1783","9319","9300",華南永昌-鶯歌,0,18,18,-1,4.39
"20210426","1783","0039003800310053","9800",元大-崇德,12,0,12,1,2.93
"20210426","1783","0037003000300057","7000",兆豐-城中,6,21,15,-1,3.66
"20210426","1783","9692","9600",富邦-嘉義,11,0,11,1,2.68
"20210426","1783","8848","8840",玉山-嘉義,0,14,14,-1,3.41
"20210426","1783","003700300030006b","7000",兆豐-員林,10,0,10,1,2.44
"20210426","1783","0039003800390049","9800",元大-蘆洲,0,12,12,-1,2.93
"20210426","1783","9814","9800",元大-大益,10,0,10,1,2.44
"20210426","1783","0039003600320041","9600",富邦-信義,0,10,10,-1,2.44
"20210426","1783","9268","9200",凱基-台北,15,7,8,1,1.95
"20210426","1783","9300","9300",華南永昌,0,10,10,-1,2.44
"20210426","1783","8560","8560",新光,6,0,6,1,1.46
"20210426","1783","8888","8880",國泰-敦南,4,13,9,-1,2.20
"20210426","1783","0035003900320076","5920",元富-桃園,6,0,6,1,1.46
"20210426","1783","9898","9800",元大-新莊,1,10,9,-1,2.20
"20210426","1783","0039003600310052","9600",富邦-南員林,6,0,6,1,1.46
"20210426","1783","9859","9800",元大-新竹經國,1,10,9,-1,2.20
"20210426","1783","0039003600310045","9600",富邦-府城,5,0,5,1,1.22
"20210426","1783","0035003900320067","5920",元富-中原,4,10,6,-1,1.46
"20210426","1783","1035","1030",土銀-新竹,5,0,5,1,1.22
"20210426","1783","003900310038004d","9100",群益金鼎-嘉義,1,7,6,-1,1.46
"20210426","1783","7006","7000",兆豐-台南,5,0,5,1,1.22
"20210426","1783","0035003800350052","5850",統一-汐止,0,5,5,-1,1.22
"20210427","1783","9300","9300",華南永昌,30,0,30,1,3.03
"20210427","1783","003900380031006e","9800",元大-旗山,0,40,40,-1,4.04
"20210427","1783","9278","9200",凱基-永康,26,1,25,1,2.52
"20210427","1783","003900380039006a","9800",元大-樹林,1,38,37,-1,3.73
"20210427","1783","7006","7000",兆豐-台南,45,30,15,1,1.51
"20210427","1783","8848","8840",玉山-嘉義,0,17,17,-1,1.72
"20210427","1783","9852","9800",元大-永春,11,0,11,1,1.11
"20210427","1783","8450","8450",康和,0,15,15,-1,1.51
"20210427","1783","003900360032004c","9600",富邦-雙和,52,41,11,1,1.11
"20210427","1783","003900360031004d","9600",富邦-木柵,0,15,15,-1,1.51
"20210427","1783","1233","1230",彰銀-台中,10,0,10,1,1.01
"20210427","1783","9317","9300",華南永昌-林口,0,15,15,-1,1.51
"20210427","1783","5853","5850",統一-中壢,10,0,10,1,1.01
"20210427","1783","1650","1650",新加坡商瑞銀,5,17,12,-1,1.21
"20210427","1783","0039003100380041","9100",群益金鼎-中壢,10,0,10,1,1.01
"20210427","1783","9183","9100",群益金鼎-高雄,0,12,12,-1,1.21
"20210427","1783","9324","9300",華南永昌-岡山,10,0,10,1,1.01
"20210427","1783","0031003000320047","1020",合庫-三重,0,10,10,-1,1.01
"20210427","1783","0039003800310069","9800",元大-西螺,10,0,10,1,1.01
"20210427","1783","003500380035005a","5850",統一-松江,0,10,10,-1,1.01
"20210427","1783","1021","1020",合庫-台中,10,1,9,1,0.91
"20210427","1783","003500390032004c","5920",元富-中壢,0,10,10,-1,1.01
"20210427","1783","0039003600320041","9600",富邦-信義,9,0,9,1,0.91
"20210427","1783","003900380031006d","9800",元大-前金,0,10,10,-1,1.01
"20210427","1783","9136","9100",群益金鼎-西松,8,0,8,1,0.81
"20210427","1783","0035003900320076","5920",元富-桃園,0,9,9,-1,0.91
"20210427","1783","9655","9600",富邦-板橋,10,2,8,1,0.81
"20210427","1783","8560","8560",新光,7,15,8,-1,0.81
"20210428","1783","9268","9200",凱基-台北,58,6,52,1,11.48
"20210428","1783","8440","8440",摩根大通,0,26,26,-1,5.74
"20210428","1783","7006","7000",兆豐-台南,20,0,20,1,4.42
"20210428","1783","003500380035005a","5850",統一-松江,48,62,14,-1,3.09
"20210428","1783","9324","9300",華南永昌-岡山,20,0,20,1,4.42
"20210428","1783","1650","1650",新加坡商瑞銀,0,11,11,-1,2.43
"20210428","1783","0031003000320043","1020",合庫-自強,15,0,15,1,3.31
"20210428","1783","5850","5850",統一,0,11,11,-1,2.43
"20210428","1783","8560","8560",新光,17,2,15,1,3.31
"20210428","1783","9623","9600",富邦-台北,5,16,11,-1,2.43
"20210428","1783","0039003100380050","9100",群益金鼎-天母,15,0,15,1,3.31
"20210428","1783","9692","9600",富邦-嘉義,0,11,11,-1,2.43
"20210428","1783","1440","1440",美林,10,0,10,1,2.21
"20210428","1783","1233","1230",彰銀-台中,0,10,10,-1,2.21
"20210428","1783","7797","7790",國票-中正,10,0,10,1,2.21
"20210428","1783","0035003300380050","5380",第一金-路竹,0,10,10,-1,2.21
"20210428","1783","1021","1020",合庫-台中,8,0,8,1,1.77
"20210428","1783","003700300030006b","7000",兆豐-員林,0,10,10,-1,2.21
"20210428","1783","0039003800340043","9800",元大-新店中正,6,0,6,1,1.32
"20210428","1783","0039003600330041","9600",富邦-八德,0,10,10,-1,2.21
"20210428","1783","003900380039006d","9800",元大-信義,12,6,6,1,1.32
"20210428","1783","0039003100330048","9100",群益金鼎-屏東,0,8,8,-1,1.77
"20210428","1783","1045","1040",臺銀-新竹,5,0,5,1,1.10
"20210428","1783","9188","9100",群益金鼎-三民,0,8,8,-1,1.77
"20210428","1783","9343","9300",華南永昌-頭份,5,0,5,1,1.10
"20210428","1783","9834","9800",元大-中壢,0,7,7,-1,1.55
"20210428","1783","0039003800370041","9800",元大-楊梅,6,1,5,1,1.10
"20210428","1783","003900380034004b","9800",元大-館前,0,7,7,-1,1.55
"20210429","1783","9268","9200",凱基-台北,62,4,58,1,14.15
"20210429","1783","003900360032004c","9600",富邦-雙和,0,33,33,-1,8.05
"20210429","1783","7006","7000",兆豐-台南,45,0,45,1,10.98
"20210429","1783","9894","9800",元大-桃興,0,20,20,-1,4.88
"20210429","1783","0039003200310045","9200",凱基-三峽,10,0,10,1,2.44
"20210429","1783","0031003000340044","1040",臺銀-金山,0,20,20,-1,4.88
"20210429","1783","9363","9300",華南永昌-彰化,10,0,10,1,2.44
"20210429","1783","5850","5850",統一,0,19,19,-1,4.63
"20210429","1783","9255","9200",凱基-和平,10,1,9,1,2.20
"20210429","1783","8440","8440",摩根大通,10,23,13,-1,3.17
"20210429","1783","9322","9300",華南永昌-公誠,7,0,7,1,1.71
"20210429","1783","1042","1040",臺銀-臺南,0,10,10,-1,2.44
"20210429","1783","0037003000300070","7000",兆豐-復興,6,0,6,1,1.46
"20210429","1783","8380","8380",安泰,0,10,10,-1,2.44
"20210429","1783","1035","1030",土銀-新竹,5,0,5,1,1.22
"20210429","1783","9307","9300",華南永昌-大安,11,21,10,-1,2.44
"20210429","1783","0038003400350046","8450",康和-仁愛,5,0,5,1,1.22
"20210429","1783","9661","9600",富邦-新店,0,10,10,-1,2.44
"20210429","1783","003900380039004a","9800",元大-彰化民生,5,0,5,1,1.22
"20210429","1783","0039003800310046","9800",元大-福營,0,10,10,-1,2.44
"20210429","1783","0039004100390043","9A00",永豐金-員林,5,0,5,1,1.22
"20210429","1783","0039004100300030","9A00",永豐金證券,1,11,10,-1,2.44
"20210429","1783","0039004100390069","9A00",永豐金-新店,5,0,5,1,1.22
"20210429","1783","6168","6160",中國信託-嘉義,0,8,8,-1,1.95
"20210429","1783","0038003100350059","8150",台新-新營,4,0,4,1,0.98
"20210429","1783","9332","9300",華南永昌-楠梓,0,7,7,-1,1.71
"20210429","1783","9272","9200",凱基-竹科,4,0,4,1,0.98
"20210429","1783","9831","9800",元大-四維,0,7,7,-1,1.71
"20210302","1783","9888","9800",元大-鑫永和,17,0,17,1,9.83
"20210302","1783","1440","1440",美林,0,11,11,-1,6.36
"20210302","1783","9604","9600",富邦-陽明,11,0,11,1,6.36
"20210302","1783","0039003200300057","9200",凱基-大里,0,10,10,-1,5.78
"20210302","1783","6383","6380",光和-和美,10,0,10,1,5.78
"20210302","1783","9324","9300",華南永昌-岡山,0,10,10,-1,5.78
"20210302","1783","9300","9300",華南永昌,8,0,8,1,4.62
"20210302","1783","9813","9800",元大-八德,0,8,8,-1,4.62
"20210302","1783","003500330038006a","5380",第一金-安和,5,0,5,1,2.89
"20210302","1783","1470","1470",台灣摩根士丹利,0,6,6,-1,3.47
"20210302","1783","6163","6160",中國信託-永康,5,0,5,1,2.89
"20210302","1783","0039003200310045","9200",凱基-三峽,0,6,6,-1,3.47
"20210302","1783","6167","6160",中國信託-松江,3,0,3,1,1.73
"20210302","1783","0039003600310052","9600",富邦-南員林,0,6,6,-1,3.47
"20210302","1783","0037003000330042","7030",致和-崇德,4,1,3,1,1.73
"20210302","1783","0039003600320044","9600",富邦-新莊,0,6,6,-1,3.47
"20210302","1783","8882","8880",國泰-台中,3,0,3,1,1.73
"20210302","1783","1115","1110",台灣企銀-太平,0,5,5,-1,2.89
"20210302","1783","0039003600320043","9600",富邦-東門,3,0,3,1,1.73
"20210302","1783","9363","9300",華南永昌-彰化,0,5,5,-1,2.89
"20210302","1783","0031003000320043","1020",合庫-自強,2,0,2,1,1.16
"20210302","1783","0039003600310050","9600",富邦-和美,0,5,5,-1,2.89
"20210302","1783","7750","7750",北城證券,2,0,2,1,1.16
"20210302","1783","0039003800390051","9800",元大-汐止,0,5,5,-1,2.89
"20210302","1783","003700370039007a","7790",國票-博愛,2,0,2,1,1.16
"20210302","1783","1590","1590",花旗環球,0,4,4,-1,2.31
"20210302","1783","9817","9800",元大-東泰,6,4,2,1,1.16
"20210302","1783","0039003800310079","9800",元大-善化,0,4,4,-1,2.31
"20210303","1783","003500320036004b","5260",美好-富順,10,0,10,1,10.87
"20210303","1783","0035003800350059","5850",統一-土城,0,10,10,-1,10.87
"20210303","1783","0037003000300067","7000",兆豐-南門,10,0,10,1,10.87
"20210303","1783","1470","1470",台灣摩根士丹利,0,7,7,-1,7.61
"20210303","1783","1520","1520",瑞士信貸,5,0,5,1,5.43
"20210303","1783","0035003800350055","5850",統一-南京,0,7,7,-1,7.61
"20210303","1783","2180","2180",亞東,5,0,5,1,5.43
"20210303","1783","1029","1020",合庫-鳳山,0,3,3,-1,3.26
"20210303","1783","0031003000320043","1020",合庫-自強,5,1,4,1,4.35
"20210303","1783","8562","8560",新光-高雄,0,3,3,-1,3.26
"20210303","1783","1440","1440",美林,4,0,4,1,4.35
"20210303","1783","9268","9200",凱基-台北,0,3,3,-1,3.26
"20210303","1783","8840","8840",玉山證券,3,0,3,1,3.26
"20210303","1783","9363","9300",華南永昌-彰化,0,3,3,-1,3.26
"20210303","1783","9300","9300",華南永昌,3,0,3,1,3.26
"20210303","1783","0039003600310050","9600",富邦-和美,0,3,3,-1,3.26
"20210303","1783","0039003800390050","9800",元大-敦南,3,0,3,1,3.26
"20210303","1783","003900380030006c","9800",元大-虎尾,0,3,3,-1,3.26
"20210303","1783","0039003100380047","9100",群益金鼎-新莊,2,0,2,1,2.17
"20210303","1783","1590","1590",花旗環球,0,2,2,-1,2.17
"20210303","1783","9672","9600",富邦-員林,2,0,2,1,2.17
"20210303","1783","8561","8560",新光-台中,0,2,2,-1,2.17
"20210303","1783","9853","9800",元大-南屯,2,0,2,1,2.17
"20210303","1783","0038003800380041","8880",國泰-館前,0,2,2,-1,2.17
"20210303","1783","0039003800390045","9800",元大-草屯,2,0,2,1,2.17
"20210303","1783","9278","9200",凱基-永康,0,2,2,-1,2.17
"20210303","1783","0039004100390032","9A00",永豐金-萬盛,2,0,2,1,2.17
"20210303","1783","0039003800390053","9800",元大-鹿港,0,2,2,-1,2.17
"20210304","1783","9651","9600",富邦-民生(停),17,0,17,1,17.71
"20210304","1783","9268","9200",凱基-台北,0,12,12,-1,12.50
"20210304","1783","8560","8560",新光,5,0,5,1,5.21
"20210304","1783","003500320036004b","5260",美好-富順,1,7,6,-1,6.25
"20210304","1783","0035003800350062","5850",統一-內湖,5,0,5,1,5.21
"20210304","1783","8150","8150",台新證券,0,6,6,-1,6.25
"20210304","1783","0038003400350046","8450",康和-仁愛,5,0,5,1,5.21
"20210304","1783","9207","9200",凱基-永和,0,5,5,-1,5.21
"20210304","1783","9300","9300",華南永昌,4,0,4,1,4.17
"20210304","1783","9223","9200",凱基-豐中,0,5,5,-1,5.21
"20210304","1783","9879","9800",元大-板橋三民,2,0,2,1,2.08
"20210304","1783","0037003000300042","7000",兆豐-板橋,0,4,4,-1,4.17
"20210304","1783","0038003800380041","8880",國泰-館前,2,0,2,1,2.08
"20210304","1783","9200","9200",凱基,0,4,4,-1,4.17
"20210304","1783","9658","9600",富邦-建國,2,0,2,1,2.08
"20210304","1783","0039003200300047","9200",凱基-彰化,0,4,4,-1,4.17
"20210304","1783","0039004100390059","9A00",永豐金-板盛,2,0,2,1,2.08
"20210304","1783","003500330038006a","5380",第一金-安和,0,3,3,-1,3.13
"20210304","1783","8840","8840",玉山證券,1,0,1,1,1.04
"20210304","1783","8440","8440",摩根大通,0,3,3,-1,3.13
"20210304","1783","1590","1590",花旗環球,1,0,1,1,1.04
"20210304","1783","9229","9200",凱基-中山,0,2,2,-1,2.08
"20210304","1783","5856","5850",統一-台中,1,0,1,1,1.04
"20210304","1783","9800","9800",元大證券,0,2,2,-1,2.08
"20210304","1783","0037003700390057","7790",國票-彰化,1,0,1,1,1.04
"20210304","1783","9853","9800",元大-南屯,0,2,2,-1,2.08
"20210304","1783","0038003100350041","8150",台新-高雄,1,0,1,1,1.04
"20210304","1783","1113","1110",台灣企銀-九如,0,1,1,-1,1.04
"20210305","1783","9672","9600",富邦-員林,20,0,20,1,6.31
"20210305","1783","0039004100390055","9A00",永豐金-中正,0,38,38,-1,11.99
"20210305","1783","0039003100380048","9100",群益金鼎-中山,18,0,18,1,5.68
"20210305","1783","0039003800310046","9800",元大-福營,0,22,22,-1,6.94
"20210305","1783","0035003800350062","5850",統一-內湖,15,0,15,1,4.73
"20210305","1783","9326","9300",華南永昌-南京,0,15,15,-1,4.73
"20210305","1783","8840","8840",玉山證券,14,0,14,1,4.42
"20210305","1783","6383","6380",光和-和美,0,11,11,-1,3.47
"20210305","1783","8560","8560",新光,14,3,11,1,3.47
"20210305","1783","9234","9200",凱基-竹北,0,10,10,-1,3.15
"20210305","1783","003700300030006b","7000",兆豐-員林,10,0,10,1,3.15
"20210305","1783","9817","9800",元大-東泰,0,10,10,-1,3.15
"20210305","1783","8156","8150",台新-三民,10,0,10,1,3.15
"20210305","1783","0039003100380047","9100",群益金鼎-新莊,5,13,8,-1,2.52
"20210305","1783","0038003800340045","8840",玉山-城中,10,0,10,1,3.15
"20210305","1783","9333","9300",華南永昌-長虹,0,8,8,-1,2.52
"20210305","1783","6162","6160",中國信託-忠孝,9,0,9,1,2.84
"20210305","1783","003500330038006a","5380",第一金-安和,0,7,7,-1,2.21
"20210305","1783","8561","8560",新光-台中,6,0,6,1,1.89
"20210305","1783","9800","9800",元大證券,0,6,6,-1,1.89
"20210305","1783","1440","1440",美林,6,0,6,1,1.89
"20210305","1783","003500390032006c","5920",元富-大裕,0,5,5,-1,1.58
"20210305","1783","8150","8150",台新證券,6,0,6,1,1.89
"20210305","1783","0036003000310064","6010",(牛牛牛)亞-鑫豐,0,5,5,-1,1.58
"20210305","1783","9868","9800",元大-文心,6,0,6,1,1.89
"20210305","1783","003500320036004b","5260",美好-富順,0,4,4,-1,1.26
"20210305","1783","5384","5380",第一金-台南,5,0,5,1,1.58
"20210305","1783","1470","1470",台灣摩根士丹利,0,4,4,-1,1.26
"20210308","1783","0039003100380048","9100",群益金鼎-中山,88,0,88,1,11.33
"20210308","1783","9853","9800",元大-南屯,3,40,37,-1,4.76
"20210308","1783","9679","9600",富邦-延吉(停),49,0,49,1,6.31
"20210308","1783","0039003800310053","9800",元大-崇德,0,22,22,-1,2.83
"20210308","1783","8150","8150",台新證券,32,2,30,1,3.86
"20210308","1783","003500390032005a","5920",元富-安南,0,15,15,-1,1.93
"20210308","1783","9604","9600",富邦-陽明,39,9,30,1,3.86
"20210308","1783","0031003000320043","1020",合庫-自強,0,14,14,-1,1.80
"20210308","1783","0039003200300056","9200",凱基-新店,21,0,21,1,2.70
"20210308","1783","1520","1520",瑞士信貸,0,13,13,-1,1.67
"20210308","1783","003500390032004c","5920",元富-中壢,20,0,20,1,2.57
"20210308","1783","0036003100310041","6110",台中銀-豐原,0,12,12,-1,1.54
"20210308","1783","1440","1440",美林,20,4,16,1,2.06
"20210308","1783","9287","9200",凱基-內湖,0,12,12,-1,1.54
"20210308","1783","8451","8450",康和-延平,15,0,15,1,1.93
"20210308","1783","0031003100310043","1110",台灣企銀-三民,0,10,10,-1,1.29
"20210308","1783","0039004100390067","9A00",永豐金-內湖,13,0,13,1,1.67
"20210308","1783","5929","5920",元富-台南,0,10,10,-1,1.29
"20210308","1783","8560","8560",新光,31,20,11,1,1.42
"20210308","1783","6167","6160",中國信託-松江,0,10,10,-1,1.29
"20210308","1783","8842","8840",玉山-新莊,11,0,11,1,1.42
"20210308","1783","8156","8150",台新-三民,0,10,10,-1,1.29
"20210308","1783","8846","8840",玉山-板橋,11,1,10,1,1.29
"20210308","1783","9268","9200",凱基-台北,4,14,10,-1,1.29
"20210308","1783","9869","9800",元大-新盛,10,0,10,1,1.29
"20210308","1783","9283","9200",凱基-北門,0,10,10,-1,1.29
"20210308","1783","0039003800390045","9800",元大-草屯,10,0,10,1,1.29
"20210308","1783","0039003800310065","9800",元大-佳里,0,10,10,-1,1.29
"20210309","1783","003700300030005a","7000",兆豐-高雄,50,0,50,1,8.71
"20210309","1783","5323","5320",高橋-內壢,0,17,17,-1,2.96
"20210309","1783","0039004100390055","9A00",永豐金-中正,50,0,50,1,8.71
"20210309","1783","0039004100390038","9A00",永豐金-大園,0,17,17,-1,2.96
"20210309","1783","9305","9300",華南永昌-新莊,33,0,33,1,5.75
"20210309","1783","9229","9200",凱基-中山,0,15,15,-1,2.61
"20210309","1783","003500380035004a","5850",統一-三重,28,0,28,1,4.88
"20210309","1783","9654","9600",富邦-永和,0,15,15,-1,2.61
"20210309","1783","0035003900320051","5920",元富-敦南,20,0,20,1,3.48
"20210309","1783","0037003700390065","7790",國票-南科,0,14,14,-1,2.44
"20210309","1783","003900380030004b","9800",元大-竹科,20,0,20,1,3.48
"20210309","1783","0039003600310046","9600",富邦-中港,0,12,12,-1,2.09
"20210309","1783","0039003100380067","9100",群益金鼎-大甲,10,0,10,1,1.74
"20210309","1783","003900380031006e","9800",元大-旗山,0,12,12,-1,2.09
"20210309","1783","8156","8150",台新-三民,10,2,8,1,1.39
"20210309","1783","9189","9100",群益金鼎-桃園,0,11,11,-1,1.92
"20210309","1783","003900360035004b","9600",富邦-台中,6,0,6,1,1.05
"20210309","1783","9651","9600",富邦-民生(停),0,11,11,-1,1.92
"20210309","1783","9100","9100",群益金鼎,3,0,3,1,0.52
"20210309","1783","1043","1040",臺銀-民權,0,10,10,-1,1.74
"20210309","1783","5603","5600",永興-台中,1,0,1,1,0.17
"20210309","1783","0035003900320055","5920",元富-宜蘭,0,10,10,-1,1.74
"20210309","1783","8560","8560",新光,3,2,1,1,0.17
"20210309","1783","0039003100380043","9100",群益金鼎-古亭,0,10,10,-1,1.74
"20210309","1783","9135","9100",群益金鼎-東大,1,0,1,1,0.17
"20210309","1783","0039003800370041","9800",元大-楊梅,0,10,10,-1,1.74
"20210309","1783","003900310033004e","9100",群益金鼎-土城,1,0,1,1,0.17
"20210309","1783","0031003000340041","1040",臺銀-臺中,0,9,9,-1,1.57
"20210310","1783","5922","5920",元富-新店,108,2,106,1,2.89
"20210310","1783","9229","9200",凱基-中山,4,95,91,-1,2.48
"20210310","1783","8380","8380",安泰,67,0,67,1,1.82
"20210310","1783","0037003000300048","7000",兆豐-東門,1,78,77,-1,2.10
"20210310","1783","1115","1110",台灣企銀-太平,61,0,61,1,1.66
"20210310","1783","003700300030005a","7000",兆豐-高雄,8,84,76,-1,2.07
"20210310","1783","8158","8150",台新-松江,53,3,50,1,1.36
"20210310","1783","0039004100390055","9A00",永豐金-中正,1,77,76,-1,2.07
"20210310","1783","003900360032004c","9600",富邦-雙和,50,1,49,1,1.33
"20210310","1783","6950","6950",福勝,0,50,50,-1,1.36
"20210310","1783","9272","9200",凱基-竹科,47,0,47,1,1.28
"20210310","1783","0039003200300047","9200",凱基-彰化,3,48,45,-1,1.23
"20210310","1783","8561","8560",新光-台中,75,30,45,1,1.23
"20210310","1783","9217","9200",凱基-松山,4,48,44,-1,1.20
"20210310","1783","5926","5920",元富-四維(停),44,0,44,1,1.20
"20210310","1783","9873","9800",元大-西門,0,40,40,-1,1.09
"20210310","1783","0039004100390058","9A00",永豐金-竹科,46,5,41,1,1.12
"20210310","1783","9679","9600",富邦-延吉(停),8,48,40,-1,1.09
"20210310","1783","1440","1440",美林,137,97,40,1,1.09
"20210310","1783","9651","9600",富邦-民生(停),2,37,35,-1,0.95
"20210310","1783","9300","9300",華南永昌,40,4,36,1,0.98
"20210310","1783","9305","9300",華南永昌-新莊,0,33,33,-1,0.90
"20210310","1783","8560","8560",新光,94,59,35,1,0.95
"20210310","1783","9287","9200",凱基-內湖,2,34,32,-1,0.87
"20210310","1783","003500380035005a","5850",統一-松江,36,5,31,1,0.84
"20210310","1783","0038003400350045","8450",康和-澎湖,2,32,30,-1,0.82
"20210310","1783","0036003000310064","6010",(牛牛牛)亞-鑫豐,32,2,30,1,0.82
"20210310","1783","9697","9600",富邦-虎尾,1,31,30,-1,0.82
"20210311","1783","0035003900320044","5920",元富-大昌,66,0,66,1,6.50
"20210311","1783","0039003600320043","9600",富邦-東門,0,30,30,-1,2.96
"20210311","1783","9658","9600",富邦-建國,62,8,54,1,5.32
"20210311","1783","8560","8560",新光,18,42,24,-1,2.36
"20210311","1783","9824","9800",元大-向上,54,0,54,1,5.32
"20210311","1783","5960","5960",日茂,0,20,20,-1,1.97
"20210311","1783","0039003600390043","9600",富邦-北港,40,0,40,1,3.94
"20210311","1783","0037003000300068","7000",兆豐-三民,0,20,20,-1,1.97
"20210311","1783","003500390032004c","5920",元富-中壢,35,0,35,1,3.45
"20210311","1783","7798","7790",國票-內壢,0,20,20,-1,1.97
"20210311","1783","9817","9800",元大-東泰,26,0,26,1,2.56
"20210311","1783","0039003800300051","9800",元大-南崁,1,20,19,-1,1.87
"20210311","1783","0037003700390058","7790",國票-中和,25,0,25,1,2.46
"20210311","1783","9300","9300",華南永昌,3,20,17,-1,1.67
"20210311","1783","5921","5920",元富-高雄,20,0,20,1,1.97
"20210311","1783","5320","5320",高橋,0,16,16,-1,1.58
"20210311","1783","5922","5920",元富-新店,20,0,20,1,1.97
"20210311","1783","0035003800350042","5850",統一-永和,0,15,15,-1,1.48
"20210311","1783","0036003000310064","6010",(牛牛牛)亞-鑫豐,20,1,19,1,1.87
"20210311","1783","8451","8450",康和-延平,0,15,15,-1,1.48
"20210311","1783","0039004100390039","9A00",永豐金-中壢,18,0,18,1,1.77
"20210311","1783","0039003200310059","9200",凱基-東勢,0,15,15,-1,1.48
"20210311","1783","9686","9600",富邦-宜蘭,15,0,15,1,1.48
"20210311","1783","9875","9800",元大-土城永寧,0,12,12,-1,1.18
"20210311","1783","0039004100390061","9A00",永豐金-苓雅,16,1,15,1,1.48
"20210311","1783","8887","8880",國泰-忠孝,1,12,11,-1,1.08
"20210311","1783","0035003900320065","5920",元富-古亭,12,0,12,1,1.18
"20210311","1783","0035003800350057","5850",統一-金門,0,10,10,-1,0.99
"20210312","1783","9872","9800",元大-復北,50,0,50,1,5.26
"20210312","1783","8887","8880",國泰-忠孝,0,19,19,-1,2.00
"20210312","1783","0039004100390044","9A00",永豐金-忠孝,50,0,50,1,5.26
"20210312","1783","8561","8560",新光-台中,3,21,18,-1,1.89
"20210312","1783","9658","9600",富邦-建國,50,3,47,1,4.95
"20210312","1783","8560","8560",新光,8,22,14,-1,1.47
"20210312","1783","9873","9800",元大-西門,40,0,40,1,4.21
"20210312","1783","1440","1440",美林,66,79,13,-1,1.37
"20210312","1783","1025","1020",合庫-基隆,23,0,23,1,2.42
"20210312","1783","9815","9800",元大-大灣,1,13,12,-1,1.26
"20210312","1783","0039003800390044","9800",元大-左營,20,2,18,1,1.89
"20210312","1783","0039003800390045","9800",元大-草屯,0,11,11,-1,1.16
"20210312","1783","9268","9200",凱基-台北,28,11,17,1,1.79
"20210312","1783","0039004100390038","9A00",永豐金-大園,0,11,11,-1,1.16
"20210312","1783","0035003900320065","5920",元富-古亭,15,0,15,1,1.58
"20210312","1783","1042","1040",臺銀-臺南,0,10,10,-1,1.05
"20210312","1783","8840","8840",玉山證券,54,39,15,1,1.58
"20210312","1783","5320","5320",高橋,0,10,10,-1,1.05
"20210312","1783","0039003800390043","9800",元大-板橋,15,1,14,1,1.47
"20210312","1783","0038003800340046","8840",玉山-桃園,0,10,10,-1,1.05
"20210312","1783","9227","9200",凱基-城中,13,0,13,1,1.37
"20210312","1783","0039003100330049","9100",群益金鼎-萬華,0,10,10,-1,1.05
"20210312","1783","0039003200300057","9200",凱基-大里,12,0,12,1,1.26
"20210312","1783","0039003200300046","9200",凱基-站前,0,10,10,-1,1.05
"20210312","1783","0035003800350048","5850",統一-桃園,10,0,10,1,1.05
"20210312","1783","0039003600320043","9600",富邦-東門,0,10,10,-1,1.05
"20210312","1783","003500380035005a","5850",統一-松江,10,0,10,1,1.05
"20210312","1783","0039003600320055","9600",富邦-縣政,0,10,10,-1,1.05
"20210315","1783","5603","5600",永興-台中,33,0,33,1,6.20
"20210315","1783","0039004100390036","9A00",永豐金-博愛,0,34,34,-1,6.39
"20210315","1783","8560","8560",新光,36,8,28,1,5.26
"20210315","1783","1025","1020",合庫-基隆,0,23,23,-1,4.32
"20210315","1783","0037003000300066","7000",兆豐-鹿港,20,0,20,1,3.76
"20210315","1783","0037003000300070","7000",兆豐-復興,0,20,20,-1,3.76
"20210315","1783","0035003900320065","5920",元富-古亭,18,0,18,1,3.38
"20210315","1783","0039003800300043","9800",元大-斗六,2,19,17,-1,3.20
"20210315","1783","0035003800350052","5850",統一-汐止,15,0,15,1,2.82
"20210315","1783","5385","5380",第一金-桃園,0,15,15,-1,2.82
"20210315","1783","003500390032004c","5920",元富-中壢,15,1,14,1,2.63
"20210315","1783","1440","1440",美林,0,13,13,-1,2.44
"20210315","1783","003700370039005a","7790",國票-安和,14,0,14,1,2.63
"20210315","1783","0031003000340041","1040",臺銀-臺中,0,13,13,-1,2.44
"20210315","1783","0039003200300047","9200",凱基-彰化,13,0,13,1,2.44
"20210315","1783","9329","9300",華南永昌-朴子,0,13,13,-1,2.44
"20210315","1783","0036003000310064","6010",(牛牛牛)亞-鑫豐,13,2,11,1,2.07
"20210315","1783","5859","5850",統一-屏東,0,11,11,-1,2.07
"20210315","1783","0039003800300075","9800",元大-府城,11,0,11,1,2.07
"20210315","1783","5925","5920",元富-台中,0,11,11,-1,2.07
"20210315","1783","8490","8490",京城,9,0,9,1,1.69
"20210315","1783","9211","9200",凱基-台南,0,11,11,-1,2.07
"20210315","1783","0039004100390073","9A00",永豐金-彰化,9,0,9,1,1.69
"20210315","1783","003900380031005a","9800",元大-潮州,0,10,10,-1,1.88
"20210315","1783","8563","8560",新光-新竹,10,2,8,1,1.50
"20210315","1783","0039004100390067","9A00",永豐金-內湖,0,10,10,-1,1.88
"20210315","1783","003800380038004b","8880",國泰-板橋,10,2,8,1,1.50
"20210315","1783","9636","9600",富邦-中壢,0,10,10,-1,1.88
"20210316","1783","0039004100390048","9A00",永豐金-新莊,40,0,40,1,10.15
"20210316","1783","0039003600390043","9600",富邦-北港,0,15,15,-1,3.81
"20210316","1783","9824","9800",元大-向上,35,0,35,1,8.88
"20210316","1783","5262","5260",美好-楊梅,0,12,12,-1,3.05
"20210316","1783","8848","8840",玉山-嘉義,20,1,19,1,4.82
"20210316","1783","8380","8380",安泰,0,11,11,-1,2.79
"20210316","1783","0039003100300044","9100",群益金鼎-市府,14,0,14,1,3.55
"20210316","1783","5385","5380",第一金-桃園,0,10,10,-1,2.54
"20210316","1783","003900380033004b","9800",元大-學甲,11,0,11,1,2.79
"20210316","1783","0035003300380057","5380",第一金-華江,0,10,10,-1,2.54
"20210316","1783","9833","9800",元大-敦化,9,0,9,1,2.28
"20210316","1783","7035","7030",致和-東門,0,10,10,-1,2.54
"20210316","1783","0039003800390043","9800",元大-板橋,10,1,9,1,2.28
"20210316","1783","9323","9300",華南永昌-小港,0,10,10,-1,2.54
"20210316","1783","0038003100350042","8150",台新-台中,10,2,8,1,2.03
"20210316","1783","0039003800350043","9800",元大-鳳中,0,10,10,-1,2.54
"20210316","1783","9209","9200",凱基-岡山,13,5,8,1,2.03
"20210316","1783","0039004100390058","9A00",永豐金-竹科,0,10,10,-1,2.54
"20210316","1783","9800","9800",元大證券,12,4,8,1,2.03
"20210316","1783","9319","9300",華南永昌-鶯歌,0,9,9,-1,2.28
"20210316","1783","0031003000320043","1020",合庫-自強,6,0,6,1,1.52
"20210316","1783","0037003000300077","7000",兆豐-新莊,0,8,8,-1,2.03
"20210316","1783","0035003900320065","5920",元富-古亭,6,0,6,1,1.52
"20210316","1783","0039003800310068","9800",元大-屏東民生,0,8,8,-1,2.03
"20210316","1783","003700370039004a","7790",國票-北高雄,6,0,6,1,1.52
"20210316","1783","8888","8880",國泰-敦南,1,9,8,-1,2.03
"20210316","1783","9679","9600",富邦-延吉(停),6,0,6,1,1.52
"20210316","1783","003500380035004a","5850",統一-三重,0,7,7,-1,1.78
"20210317","1783","0037003700390058","7790",國票-中和,35,1,34,1,7.59
"20210317","1783","0039003600390043","9600",富邦-北港,0,21,21,-1,4.69
"20210317","1783","0035003900320057","5920",元富-吉利,30,0,30,1,6.70
"20210317","1783","5320","5320",高橋,0,20,20,-1,4.46
"20210317","1783","8560","8560",新光,24,1,23,1,5.13
"20210317","1783","5850","5850",統一,1,20,19,-1,4.24
"20210317","1783","003800380038004b","8880",國泰-板橋,21,0,21,1,4.69
"20210317","1783","9667","9600",富邦-台南,0,13,13,-1,2.90
"20210317","1783","0037003700390056","7790",國票-天祥,20,0,20,1,4.46
"20210317","1783","0035003300380059","5380",第一金-中壢,0,10,10,-1,2.23
"20210317","1783","0039003200320048","9200",凱基-復興,20,0,20,1,4.46
"20210317","1783","0036003000310064","6010",(牛牛牛)亞-鑫豐,0,10,10,-1,2.23
"20210317","1783","9268","9200",凱基-台北,17,0,17,1,3.79
"20210317","1783","0038003800340043","8840",玉山-南京東路,0,10,10,-1,2.23
"20210317","1783","9824","9800",元大-向上,15,1,14,1,3.13
"20210317","1783","0038003800340046","8840",玉山-桃園,0,10,10,-1,2.23
"20210317","1783","5857","5850",統一-新竹,10,0,10,1,2.23
"20210317","1783","9205","9200",凱基-三重,0,10,10,-1,2.23
"20210317","1783","0039004100390039","9A00",永豐金-中壢,10,0,10,1,2.23
"20210317","1783","0035003300380057","5380",第一金-華江,1,10,9,-1,2.01
"20210317","1783","0039003200310043","9200",凱基-民權,8,0,8,1,1.79
"20210317","1783","6162","6160",中國信託-忠孝,0,9,9,-1,2.01
"20210317","1783","0039004100390041","9A00",永豐金-羅東,8,0,8,1,1.79
"20210317","1783","9308","9300",華南永昌-麻豆,0,8,8,-1,1.79
"20210317","1783","9658","9600",富邦-建國,7,0,7,1,1.56
"20210317","1783","5262","5260",美好-楊梅,0,8,8,-1,1.79
"20210317","1783","0039003800390043","9800",元大-板橋,7,0,7,1,1.56
"20210317","1783","0036003300380041","6380",光和-嘉義,0,8,8,-1,1.79
"20210318","1783","0039003600320043","9600",富邦-東門,150,0,150,1,9.19
"20210318","1783","8561","8560",新光-台中,8,117,109,-1,6.67
"20210318","1783","7006","7000",兆豐-台南,100,20,80,1,4.90
"20210318","1783","6620","6620",口袋證券,3,63,60,-1,3.67
"20210318","1783","003900360032004c","9600",富邦-雙和,80,4,76,1,4.65
"20210318","1783","8380","8380",安泰,0,50,50,-1,3.06
"20210318","1783","0039003200310045","9200",凱基-三峽,70,0,70,1,4.29
"20210318","1783","9272","9200",凱基-竹科,3,46,43,-1,2.63
"20210318","1783","9205","9200",凱基-三重,67,1,66,1,4.04
"20210318","1783","0039003800300077","9800",元大-西屯,10,40,30,-1,1.84
"20210318","1783","0039004100390044","9A00",永豐金-忠孝,66,0,66,1,4.04
"20210318","1783","9315","9300",華南永昌-苑裡,0,26,26,-1,1.59
"20210318","1783","9208","9200",凱基-桃園,50,2,48,1,2.94
"20210318","1783","1041","1040",臺銀-鳳山,0,25,25,-1,1.53
"20210318","1783","8840","8840",玉山證券,51,8,43,1,2.63
"20210318","1783","9604","9600",富邦-陽明,2,25,23,-1,1.41
"20210318","1783","1440","1440",美林,59,22,37,1,2.27
"20210318","1783","5926","5920",元富-四維(停),0,22,22,-1,1.35
"20210318","1783","0039003100330049","9100",群益金鼎-萬華,37,0,37,1,2.27
"20210318","1783","9816","9800",元大-新竹,0,22,22,-1,1.35
"20210318","1783","0039003800390047","9800",元大-大同,20,0,20,1,1.22
"20210318","1783","0031003000320043","1020",合庫-自強,0,21,21,-1,1.29
"20210318","1783","9324","9300",華南永昌-岡山,20,1,19,1,1.16
"20210318","1783","0039004100390068","9A00",永豐金-台南,0,21,21,-1,1.29
"20210318","1783","003500380035005a","5850",統一-松江,12,0,12,1,0.73
"20210318","1783","003500390032006f","5920",元富-新興,0,19,19,-1,1.16
"20210318","1783","9377","9300",華南永昌-虎尾,12,0,12,1,0.73
"20210318","1783","0039003600320055","9600",富邦-縣政,1,20,19,-1,1.16
"20210319","1783","6167","6160",中國信託-松江,110,0,110,1,16.72
"20210319","1783","003500390032004c","5920",元富-中壢,0,49,49,-1,7.45
"20210319","1783","8840","8840",玉山證券,50,0,50,1,7.60
"20210319","1783","7006","7000",兆豐-台南,0,40,40,-1,6.08
"20210319","1783","8561","8560",新光-台中,20,0,20,1,3.04
"20210319","1783","9268","9200",凱基-台北,1,26,25,-1,3.80
"20210319","1783","8565","8560",新光-桃園,18,1,17,1,2.58
"20210319","1783","0039004100390039","9A00",永豐金-中壢,0,24,24,-1,3.65
"20210319","1783","9697","9600",富邦-虎尾,21,5,16,1,2.43
"20210319","1783","9658","9600",富邦-建國,0,18,18,-1,2.74
"20210319","1783","0037003000300045","7000",兆豐-斗南(停),15,0,15,1,2.28
"20210319","1783","5921","5920",元富-高雄,0,17,17,-1,2.58
"20210319","1783","0039003100330049","9100",群益金鼎-萬華,14,0,14,1,2.13
"20210319","1783","0035003900320076","5920",元富-桃園,0,15,15,-1,2.28
"20210319","1783","8440","8440",摩根大通,25,12,13,1,1.98
"20210319","1783","1440","1440",美林,9,22,13,-1,1.98
"20210319","1783","0031003000320043","1020",合庫-自強,12,0,12,1,1.82
"20210319","1783","0039004100390068","9A00",永豐金-台南,0,12,12,-1,1.82
"20210319","1783","0035003300380044","5380",第一金-忠孝,10,0,10,1,1.52
"20210319","1783","9300","9300",華南永昌,4,16,12,-1,1.82
"20210319","1783","0035003900320047","5920",元富-新竹,10,0,10,1,1.52
"20210319","1783","0038003400350041","8450",康和-內湖,0,11,11,-1,1.67
"20210319","1783","9347","9300",華南永昌-敦南,10,0,10,1,1.52
"20210319","1783","0038003800340045","8840",玉山-城中,0,11,11,-1,1.67
"20210319","1783","9874","9800",元大-雙和,10,0,10,1,1.52
"20210319","1783","9800","9800",元大證券,0,11,11,-1,1.67
"20210319","1783","9625","9600",富邦-竹東,7,0,7,1,1.06
"20210319","1783","0039003800390049","9800",元大-蘆洲,0,10,10,-1,1.52
"20210322","1783","9874","9800",元大-雙和,90,0,90,1,12.47
"20210322","1783","0039004100390044","9A00",永豐金-忠孝,0,73,73,-1,10.11
"20210322","1783","6167","6160",中國信託-松江,20,0,20,1,2.77
"20210322","1783","9205","9200",凱基-三重,0,67,67,-1,9.28
"20210322","1783","9309","9300",華南永昌-古亭,20,0,20,1,2.77
"20210322","1783","9208","9200",凱基-桃園,0,50,50,-1,6.93
"20210322","1783","8158","8150",台新-松江,19,0,19,1,2.63
"20210322","1783","7006","7000",兆豐-台南,0,40,40,-1,5.54
"20210322","1783","8561","8560",新光-台中,17,0,17,1,2.35
"20210322","1783","0039003200310045","9200",凱基-三峽,0,40,40,-1,5.54
"20210322","1783","003900380039006d","9800",元大-信義,15,0,15,1,2.08
"20210322","1783","003800380038004b","8880",國泰-板橋,0,31,31,-1,4.29
"20210322","1783","0038003400350046","8450",康和-仁愛,12,0,12,1,1.66
"20210322","1783","8150","8150",台新證券,0,29,29,-1,4.02
"20210322","1783","9255","9200",凱基-和平,11,0,11,1,1.52
"20210322","1783","1440","1440",美林,28,47,19,-1,2.63
"20210322","1783","9300","9300",華南永昌,10,0,10,1,1.39
"20210322","1783","0035003800350048","5850",統一-桃園,0,15,15,-1,2.08
"20210322","1783","003500390032004c","5920",元富-中壢,10,0,10,1,1.39
"20210322","1783","0031003000320043","1020",合庫-自強,0,13,13,-1,1.80
"20210322","1783","9324","9300",華南永昌-岡山,10,0,10,1,1.39
"20210322","1783","003900380033004b","9800",元大-學甲,0,11,11,-1,1.52
"20210322","1783","9676","9600",富邦-仁愛,10,0,10,1,1.39
"20210322","1783","0035003800350062","5850",統一-內湖,0,10,10,-1,1.39
"20210322","1783","9800","9800",元大證券,10,0,10,1,1.39
"20210322","1783","0037003000300068","7000",兆豐-三民,0,10,10,-1,1.39
"20210322","1783","9858","9800",元大-龍潭,10,0,10,1,1.39
"20210322","1783","8846","8840",玉山-板橋,0,10,10,-1,1.39
"20210323","1783","0039003800390058","9800",元大-民生,228,0,228,1,7.41
"20210323","1783","8560","8560",新光,6,86,80,-1,2.60
"20210323","1783","9692","9600",富邦-嘉義,477,287,190,1,6.17
"20210323","1783","1115","1110",台灣企銀-太平,0,67,67,-1,2.18
"20210323","1783","0035003800350055","5850",統一-南京,180,2,178,1,5.78
"20210323","1783","9283","9200",凱基-北門,0,67,67,-1,2.18
"20210323","1783","5850","5850",統一,146,0,146,1,4.74
"20210323","1783","9658","9600",富邦-建國,0,65,65,-1,2.11
"20210323","1783","9239","9200",凱基-市政,253,152,101,1,3.28
"20210323","1783","9105","9100",群益金鼎-高盛,0,52,52,-1,1.69
"20210323","1783","003500380035005a","5850",統一-松江,88,0,88,1,2.86
"20210323","1783","9604","9600",富邦-陽明,0,43,43,-1,1.40
"20210323","1783","8440","8440",摩根大通,69,0,69,1,2.24
"20210323","1783","9874","9800",元大-雙和,4,44,40,-1,1.30
"20210323","1783","0038003400350045","8450",康和-澎湖,63,1,62,1,2.01
"20210323","1783","5389","5380",第一金-中山,2,40,38,-1,1.23
"20210323","1783","2180","2180",亞東,61,4,57,1,1.85
"20210323","1783","003900380031006d","9800",元大-前金,0,34,34,-1,1.10
"20210323","1783","1560","1560",港商野村,62,14,48,1,1.56
"20210323","1783","0039003200310045","9200",凱基-三峽,0,31,31,-1,1.01
"20210323","1783","8158","8150",台新-松江,66,18,48,1,1.56
"20210323","1783","0039003800310045","9800",元大-發財,0,31,31,-1,1.01
"20210323","1783","0035003300380057","5380",第一金-華江,50,4,46,1,1.49
"20210323","1783","8561","8560",新光-台中,0,29,29,-1,0.94
"20210323","1783","9300","9300",華南永昌,41,0,41,1,1.33
"20210323","1783","8888","8880",國泰-敦南,21,48,27,-1,0.88
"20210323","1783","8565","8560",新光-桃園,47,12,35,1,1.14
"20210323","1783","5926","5920",元富-四維(停),0,24,24,-1,0.78
"20210324","1783","0039003800390058","9800",元大-民生,402,135,267,1,3.68
"20210324","1783","9692","9600",富邦-嘉義,133,319,186,-1,2.57
"20210324","1783","5260","5260",美好,100,0,100,1,1.38
"20210324","1783","9300","9300",華南永昌,18,189,171,-1,2.36
"20210324","1783","9257","9200",凱基-林口,104,7,97,1,1.34
"20210324","1783","0035003800350055","5850",統一-南京,5,130,125,-1,1.72
"20210324","1783","003900410039004c","9A00",永豐金-台中,106,10,96,1,1.32
"20210324","1783","9239","9200",凱基-市政,16,115,99,-1,1.37
"20210324","1783","8848","8840",玉山-嘉義,95,0,95,1,1.31
"20210324","1783","003500380035005a","5850",統一-松江,211,288,77,-1,1.06
"20210324","1783","8888","8880",國泰-敦南,137,77,60,1,0.83
"20210324","1783","0038003400350045","8450",康和-澎湖,0,74,74,-1,1.02
"20210324","1783","0039004100390044","9A00",永豐金-忠孝,82,28,54,1,0.75
"20210324","1783","8565","8560",新光-桃園,40,113,73,-1,1.01
"20210324","1783","0038003800340045","8840",玉山-城中,60,7,53,1,0.73
"20210324","1783","8158","8150",台新-松江,4,71,67,-1,0.92
"20210324","1783","8150","8150",台新證券,85,32,53,1,0.73
"20210324","1783","0039003100330049","9100",群益金鼎-萬華,54,113,59,-1,0.81
"20210324","1783","9322","9300",華南永昌-公誠,46,1,45,1,0.62
"20210324","1783","1560","1560",港商野村,0,57,57,-1,0.79
"20210324","1783","1031","1030",土銀-台中,42,0,42,1,0.58
"20210324","1783","9824","9800",元大-向上,0,56,56,-1,0.77
"20210324","1783","0037003000300049","7000",兆豐-北高雄,46,7,39,1,0.54
"20210324","1783","6950","6950",福勝,3,58,55,-1,0.76
"20210324","1783","9822","9800",元大-土城學府,40,1,39,1,0.54
"20210324","1783","0039003200300057","9200",凱基-大里,2,53,51,-1,0.70
"20210324","1783","0039003600310046","9600",富邦-中港,52,15,37,1,0.51
"20210324","1783","5850","5850",統一,142,187,45,-1,0.62
"20210325","1783","0039003800390058","9800",元大-民生,140,25,115,1,4.18
"20210325","1783","8848","8840",玉山-嘉義,0,95,95,-1,3.45
"20210325","1783","0039004100390037","9A00",永豐金-新竹,81,4,77,1,2.80
"20210325","1783","003900410039004c","9A00",永豐金-台中,0,86,86,-1,3.12
"20210325","1783","0031003200360055","1260",宏遠-館前,73,2,71,1,2.58
"20210325","1783","0037003700390058","7790",國票-中和,4,67,63,-1,2.29
"20210325","1783","9257","9200",凱基-林口,61,3,58,1,2.11
"20210325","1783","8440","8440",摩根大通,14,66,52,-1,1.89
"20210325","1783","5922","5920",元富-新店,45,0,45,1,1.63
"20210325","1783","1031","1030",土銀-台中,0,43,43,-1,1.56
"20210325","1783","0039003800310053","9800",元大-崇德,35,5,30,1,1.09
"20210325","1783","0039003600310046","9600",富邦-中港,2,37,35,-1,1.27
"20210325","1783","0039003800390056","9800",元大-北三重,30,0,30,1,1.09
"20210325","1783","003500380035005a","5850",統一-松江,110,144,34,-1,1.24
"20210325","1783","0038003800340045","8840",玉山-城中,48,22,26,1,0.94
"20210325","1783","0039003600310048","9600",富邦-新板,1,31,30,-1,1.09
"20210325","1783","8158","8150",台新-松江,26,2,24,1,0.87
"20210325","1783","0039004100390044","9A00",永豐金-忠孝,0,30,30,-1,1.09
"20210325","1783","0039004100390055","9A00",永豐金-中正,21,0,21,1,0.76
"20210325","1783","0039004100390063","9A00",永豐金-永康,4,32,28,-1,1.02
"20210325","1783","9309","9300",華南永昌-古亭,23,2,21,1,0.76
"20210325","1783","0039003200320048","9200",凱基-復興,0,26,26,-1,0.94
"20210325","1783","1025","1020",合庫-基隆,23,6,17,1,0.62
"20210325","1783","8562","8560",新光-高雄,10,34,24,-1,0.87
"20210325","1783","1023","1020",合庫-高雄,16,0,16,1,0.58
"20210325","1783","0039003200300043","9200",凱基-雙和,1,25,24,-1,0.87
"20210325","1783","6168","6160",中國信託-嘉義,16,0,16,1,0.58
"20210325","1783","9884","9800",元大-斗信,0,23,23,-1,0.84
"20210326","1783","0039004100390044","9A00",永豐金-忠孝,31,0,31,1,3.49
"20210326","1783","0031003200360055","1260",宏遠-館前,1,36,35,-1,3.94
"20210326","1783","0039003800390058","9800",元大-民生,53,23,30,1,3.38
"20210326","1783","8158","8150",台新-松江,2,25,23,-1,2.59
"20210326","1783","0037003000300066","7000",兆豐-鹿港,30,0,30,1,3.38
"20210326","1783","1025","1020",合庫-基隆,5,25,20,-1,2.25
"20210326","1783","0038003800340042","8840",玉山-台中,26,0,26,1,2.93
"20210326","1783","9208","9200",凱基-桃園,1,21,20,-1,2.25
"20210326","1783","003500390032004c","5920",元富-中壢,21,0,21,1,2.36
"20210326","1783","9349","9300",華南永昌-板橋,0,16,16,-1,1.80
"20210326","1783","8843","8840",玉山-高雄,21,0,21,1,2.36
"20210326","1783","9623","9600",富邦-台北,1,15,14,-1,1.58
"20210326","1783","5854","5850",統一-城中,30,10,20,1,2.25
"20210326","1783","0035003900320079","5920",元富-花蓮,0,13,13,-1,1.46
"20210326","1783","003500380035005a","5850",統一-松江,47,31,16,1,1.80
"20210326","1783","8711","8710",陽信-石牌,0,12,12,-1,1.35
"20210326","1783","9300","9300",華南永昌,13,0,13,1,1.46
"20210326","1783","9268","9200",凱基-台北,12,24,12,-1,1.35
"20210326","1783","5922","5920",元富-新店,10,0,10,1,1.13
"20210326","1783","8888","8880",國泰-敦南,8,19,11,-1,1.24
"20210326","1783","8450","8450",康和,10,0,10,1,1.13
"20210326","1783","003900380039006d","9800",元大-信義,31,42,11,-1,1.24
"20210326","1783","9329","9300",華南永昌-朴子,20,10,10,1,1.13
"20210326","1783","0031003000340041","1040",臺銀-臺中,0,10,10,-1,1.13
"20210326","1783","0039003800390047","9800",元大-大同,10,0,10,1,1.13
"20210326","1783","8490","8490",京城,0,10,10,-1,1.13
"20210326","1783","0039004100390067","9A00",永豐金-內湖,10,0,10,1,1.13
"20210326","1783","9283","9200",凱基-北門,0,10,10,-1,1.13
"20210329","1783","9324","9300",華南永昌-岡山,25,0,25,1,4.11
"20210329","1783","003500380035005a","5850",統一-松江,11,48,37,-1,6.09
"20210329","1783","9302","9300",華南永昌-台中,21,0,21,1,3.45
"20210329","1783","0035003800350041","5850",統一-基隆,0,20,20,-1,3.29
"20210329","1783","8380","8380",安泰,20,2,18,1,2.96
"20210329","1783","5854","5850",統一-城中,0,15,15,-1,2.47
"20210329","1783","0038003800340045","8840",玉山-城中,18,3,15,1,2.47
"20210329","1783","0039004100390053","9A00",永豐金-南京,0,12,12,-1,1.97
"20210329","1783","0039003100380047","9100",群益金鼎-新莊,15,0,15,1,2.47
"20210329","1783","5660","5660",日進,0,11,11,-1,1.81
"20210329","1783","0037003000300066","7000",兆豐-鹿港,15,0,15,1,2.47
"20210329","1783","9667","9600",富邦-台南,0,10,10,-1,1.64
"20210329","1783","0039003200300047","9200",凱基-彰化,14,1,13,1,2.14
"20210329","1783","0039003800390058","9800",元大-民生,0,10,10,-1,1.64
"20210329","1783","9268","9200",凱基-台北,14,2,12,1,1.97
"20210329","1783","0039003600310056","9600",富邦-板橋中山,0,9,9,-1,1.48
"20210329","1783","7080","7080",石橋證券,10,0,10,1,1.64
"20210329","1783","5852","5850",統一-敦南,0,8,8,-1,1.32
"20210329","1783","9322","9300",華南永昌-公誠,10,0,10,1,1.64
"20210329","1783","8156","8150",台新-三民,0,8,8,-1,1.32
"20210329","1783","0039003600320044","9600",富邦-新莊,10,0,10,1,1.64
"20210329","1783","9256","9200",凱基-南崁,0,8,8,-1,1.32
"20210329","1783","003900380033004e","9800",元大-大安,10,0,10,1,1.64
"20210329","1783","0039003800310071","9800",元大-萬華,0,8,8,-1,1.32
"20210329","1783","9873","9800",元大-西門,10,0,10,1,1.64
"20210329","1783","9891","9800",元大-永和,0,8,8,-1,1.32
"20210329","1783","0039003800390045","9800",元大-草屯,10,0,10,1,1.64
"20210329","1783","003900360031004d","9600",富邦-木柵,0,6,6,-1,0.99
"20210330","1783","8711","8710",陽信-石牌,50,0,50,1,8.56
"20210330","1783","0035003800350055","5850",統一-南京,0,50,50,-1,8.56
"20210330","1783","0039003800310053","9800",元大-崇德,48,3,45,1,7.71
"20210330","1783","0039004100390044","9A00",永豐金-忠孝,0,33,33,-1,5.65
"20210330","1783","0038003400350045","8450",康和-澎湖,34,0,34,1,5.82
"20210330","1783","8440","8440",摩根大通,0,25,25,-1,4.28
"20210330","1783","7006","7000",兆豐-台南,22,0,22,1,3.77
"20210330","1783","003500390032004c","5920",元富-中壢,0,21,21,-1,3.60
"20210330","1783","9278","9200",凱基-永康,22,0,22,1,3.77
"20210330","1783","0039003800390058","9800",元大-民生,0,20,20,-1,3.42
"20210330","1783","9324","9300",華南永昌-岡山,20,0,20,1,3.42
"20210330","1783","1520","1520",瑞士信貸,0,16,16,-1,2.74
"20210330","1783","0037003000300066","7000",兆豐-鹿港,15,0,15,1,2.57
"20210330","1783","7032","7030",致和-佳里,0,14,14,-1,2.40
"20210330","1783","0038003800380041","8880",國泰-館前,10,0,10,1,1.71
"20210330","1783","5854","5850",統一-城中,0,13,13,-1,2.23
"20210330","1783","0039003800310052","9800",元大-竹山,10,0,10,1,1.71
"20210330","1783","9331","9300",華南永昌-鳳山,0,10,10,-1,1.71
"20210330","1783","0039004100360039","9A00",永豐金-屏東,10,0,10,1,1.71
"20210330","1783","5857","5850",統一-新竹,0,9,9,-1,1.54
"20210330","1783","0039003200320048","9200",凱基-復興,8,0,8,1,1.37
"20210330","1783","0031003200360055","1260",宏遠-館前,0,8,8,-1,1.37
"20210330","1783","1110","1110",台灣企銀,7,0,7,1,1.20
"20210330","1783","1470","1470",台灣摩根士丹利,0,8,8,-1,1.37
"20210330","1783","0035003900320047","5920",元富-新竹,12,5,7,1,1.20
"20210330","1783","0038003100350041","8150",台新-高雄,0,8,8,-1,1.37
"20210330","1783","0039003800300052","9800",元大-南海,6,0,6,1,1.03
"20210330","1783","8888","8880",國泰-敦南,1,9,8,-1,1.37
"20210331","1783","6380","6380",光和,61,0,61,1,8.06
"20210331","1783","0039003800390058","9800",元大-民生,0,40,40,-1,5.28
"20210331","1783","8440","8440",摩根大通,37,2,35,1,4.62
"20210331","1783","0039004100390044","9A00",永豐金-忠孝,4,30,26,-1,3.43
"20210331","1783","9636","9600",富邦-中壢,33,0,33,1,4.36
"20210331","1783","7008","7000",兆豐-三重,0,25,25,-1,3.30
"20210331","1783","0035003300380057","5380",第一金-華江,30,0,30,1,3.96
"20210331","1783","8843","8840",玉山-高雄,0,23,23,-1,3.04
"20210331","1783","1440","1440",美林,31,7,24,1,3.17
"20210331","1783","0038003800340045","8840",玉山-城中,0,18,18,-1,2.38
"20210331","1783","0035003900320055","5920",元富-宜蘭,20,1,19,1,2.51
"20210331","1783","0039003800300064","9800",元大-沙鹿,2,20,18,-1,2.38
"20210331","1783","8564","8560",新光-台南,17,0,17,1,2.25
"20210331","1783","0039004100390037","9A00",永豐金-新竹,0,12,12,-1,1.59
"20210331","1783","1560","1560",港商野村,14,0,14,1,1.85
"20210331","1783","5602","5600",永興-水湳,0,10,10,-1,1.32
"20210331","1783","0039003600320055","9600",富邦-縣政,11,0,11,1,1.45
"20210331","1783","003900380033004e","9800",元大-大安,0,10,10,-1,1.32
"20210331","1783","9869","9800",元大-新盛,15,4,11,1,1.45
"20210331","1783","0039003800390045","9800",元大-草屯,3,13,10,-1,1.32
"20210331","1783","8381","8380",安泰-大發,10,0,10,1,1.32
"20210331","1783","6452","6450",永全-八德,0,9,9,-1,1.19
"20210331","1783","9285","9200",凱基-中壢,10,0,10,1,1.32
"20210331","1783","8560","8560",新光,3,12,9,-1,1.19
"20210331","1783","1520","1520",瑞士信貸,7,0,7,1,0.92
"20210331","1783","8561","8560",新光-台中,2,11,9,-1,1.19
"20210331","1783","8157","8150",台新-左楠,6,0,6,1,0.79
"20210331","1783","9208","9200",凱基-桃園,1,10,9,-1,1.19
"20210201","1783","9600","9600",富邦證券,60,0,60,1,22.99
"20210201","1783","0039003800300064","9800",元大-沙鹿,0,13,13,-1,4.98
"20210201","1783","1440","1440",美林,24,10,14,1,5.36
"20210201","1783","0035003300380042","5380",第一金-新竹,0,6,6,-1,2.30
"20210201","1783","8150","8150",台新證券,12,1,11,1,4.21
"20210201","1783","9856","9800",元大-花蓮,0,6,6,-1,2.30
"20210201","1783","9326","9300",華南永昌-南京,10,0,10,1,3.83
"20210201","1783","1590","1590",花旗環球,0,5,5,-1,1.92
"20210201","1783","8887","8880",國泰-忠孝,8,0,8,1,3.07
"20210201","1783","0037003000300052","7000",兆豐-小港,1,6,5,-1,1.92
"20210201","1783","0035003300380050","5380",第一金-路竹,7,0,7,1,2.68
"20210201","1783","0039003600310048","9600",富邦-新板,0,5,5,-1,1.92
"20210201","1783","0031003000320046","1020",合庫-西台中,5,0,5,1,1.92
"20210201","1783","1110","1110",台灣企銀,0,4,4,-1,1.53
"20210201","1783","6385","6380",光和-花壇,5,0,5,1,1.92
"20210201","1783","9655","9600",富邦-板橋,0,4,4,-1,1.53
"20210201","1783","8440","8440",摩根大通,4,0,4,1,1.53
"20210201","1783","0039003800350043","9800",元大-鳳中,0,4,4,-1,1.53
"20210201","1783","9604","9600",富邦-陽明,3,0,3,1,1.15
"20210201","1783","0039003200300044","9200",凱基-市府,0,3,3,-1,1.15
"20210201","1783","0036003300380041","6380",光和-嘉義,2,0,2,1,0.77
"20210201","1783","0039003600350055","9600",富邦-彰化,0,3,3,-1,1.15
"20210201","1783","8880","8880",國泰證券,2,0,2,1,0.77
"20210201","1783","0035003900320047","5920",元富-新竹,0,2,2,-1,0.77
"20210201","1783","9300","9300",華南永昌,2,0,2,1,0.77
"20210201","1783","0037003700390050","7790",國票-九鼎,0,2,2,-1,0.77
"20210201","1783","9623","9600",富邦-台北,2,0,2,1,0.77
"20210201","1783","003500320036004b","5260",美好-富順,0,1,1,-1,0.38
"20210202","1783","0035003900320057","5920",元富-吉利,53,0,53,1,35.81
"20210202","1783","6620","6620",口袋證券,0,18,18,-1,12.16
"20210202","1783","1480","1480",美商高盛,5,0,5,1,3.38
"20210202","1783","8150","8150",台新證券,0,11,11,-1,7.43
"20210202","1783","003900310038004a","9100",群益金鼎-永和,3,0,3,1,2.03
"20210202","1783","0039003200310043","9200",凱基-民權,0,7,7,-1,4.73
"20210202","1783","0039003800390045","9800",元大-草屯,3,0,3,1,2.03
"20210202","1783","9187","9100",群益金鼎-彰化,0,6,6,-1,4.05
"20210202","1783","003800380038004b","8880",國泰-板橋,2,0,2,1,1.35
"20210202","1783","0039003100380043","9100",群益金鼎-古亭,0,5,5,-1,3.38
"20210202","1783","8440","8440",摩根大通,2,0,2,1,1.35
"20210202","1783","1590","1590",花旗環球,0,3,3,-1,2.03
"20210202","1783","8880","8880",國泰證券,3,1,2,1,1.35
"20210202","1783","5383","5380",第一金-高雄,0,2,2,-1,1.35
"20210202","1783","9300","9300",華南永昌,2,0,2,1,1.35
"20210202","1783","0039004100390047","9A00",永豐金-天母,0,2,2,-1,1.35
"20210202","1783","9693","9600",富邦-新營,2,0,2,1,1.35
"20210202","1783","0039003600350055","9600",富邦-彰化,0,2,2,-1,1.35
"20210202","1783","0039003800390064","9800",元大-北屯,2,0,2,1,1.35
"20210202","1783","0035003900320050","5920",元富-同大,0,1,1,-1,0.68
"20210202","1783","1440","1440",美林,6,5,1,1,0.68
"20210202","1783","003500390032006e","5920",元富-西松,0,1,1,-1,0.68
"20210202","1783","0031003200360051","1260",宏遠-高雄,1,0,1,1,0.68
"20210202","1783","0035003900320065","5920",元富-古亭,0,1,1,-1,0.68
"20210202","1783","9274","9200",凱基-鳳山,1,0,1,1,0.68
"20210202","1783","0031003000320046","1020",合庫-西台中,0,1,1,-1,0.68
"20210202","1783","9623","9600",富邦-台北,1,0,1,1,0.68
"20210202","1783","003900310038007a","9100",群益金鼎-宜蘭,0,1,1,-1,0.68
"20210203","1783","003800380038004b","8880",國泰-板橋,8,0,8,1,9.88
"20210203","1783","0038003800340048","8840",玉山-新竹,0,19,19,-1,23.46
"20210203","1783","9300","9300",華南永昌,4,0,4,1,4.94
"20210203","1783","0039003600360046","9600",富邦-左營,0,10,10,-1,12.35
"20210203","1783","6460","6460",大昌,2,0,2,1,2.47
"20210203","1783","1110","1110",台灣企銀,0,7,7,-1,8.64
"20210203","1783","0035003900320055","5920",元富-宜蘭,2,0,2,1,2.47
"20210203","1783","0039003800390061","9800",元大-苑裡,0,3,3,-1,3.70
"20210203","1783","9233","9200",凱基-長庚,2,0,2,1,2.47
"20210203","1783","8843","8840",玉山-高雄,0,2,2,-1,2.47
"20210203","1783","9623","9600",富邦-台北,2,0,2,1,2.47
"20210203","1783","1590","1590",花旗環球,0,2,2,-1,2.47
"20210203","1783","9326","9300",華南永昌-南京,1,0,1,1,1.23
"20210203","1783","003900310038007a","9100",群益金鼎-宜蘭,0,2,2,-1,2.47
"20210203","1783","6913","6910",德信-新營,1,0,1,1,1.23
"20210203","1783","0039003600320045","9600",富邦-樹林,0,2,2,-1,2.47
"20210203","1783","6464","6460",大昌-新店,1,0,1,1,1.23
"20210203","1783","0039003600320047","9600",富邦-斗六,0,2,2,-1,2.47
"20210203","1783","003900310038004a","9100",群益金鼎-永和,1,0,1,1,1.23
"20210203","1783","003900410039004b","9A00",永豐金-三重,0,2,2,-1,2.47
"20210203","1783","0039003800310046","9800",元大-福營,1,0,1,1,1.23
"20210203","1783","0037003700390050","7790",國票-九鼎,0,1,1,-1,1.23
"20210203","1783","0039003800390045","9800",元大-草屯,1,0,1,1,1.23
"20210203","1783","0037003000300052","7000",兆豐-小港,0,1,1,-1,1.23
"20210203","1783","8881","8880",國泰-高雄,0,0,0,1,0.00
"20210203","1783","0031003200360069","1260",宏遠-光隆,0,1,1,-1,1.23
"20210203","1783","5850","5850",統一,0,0,0,1,0.00
"20210203","1783","1440","1440",美林,0,1,1,-1,1.23
"20210204","1783","0035003900320057","5920",元富-吉利,38,0,38,1,27.74
"20210204","1783","0037003000300048","7000",兆豐-東門,0,29,29,-1,21.17
"20210204","1783","9300","9300",華南永昌,7,0,7,1,5.11
"20210204","1783","8560","8560",新光,2,22,20,-1,14.60
"20210204","1783","9604","9600",富邦-陽明,8,1,7,1,5.11
"20210204","1783","1115","1110",台灣企銀-太平,0,5,5,-1,3.65
"20210204","1783","0037003700390050","7790",國票-九鼎,5,0,5,1,3.65
"20210204","1783","7006","7000",兆豐-台南,0,3,3,-1,2.19
"20210204","1783","9853","9800",元大-南屯,2,0,2,1,1.46
"20210204","1783","9679","9600",富邦-延吉(停),0,3,3,-1,2.19
"20210204","1783","0039003800390051","9800",元大-汐止,2,0,2,1,1.46
"20210204","1783","0039003800310065","9800",元大-佳里,0,3,3,-1,2.19
"20210204","1783","5323","5320",高橋-內壢,2,1,1,1,0.73
"20210204","1783","1590","1590",花旗環球,0,2,2,-1,1.46
"20210204","1783","9108","9100",群益金鼎-海山,1,0,1,1,0.73
"20210204","1783","9252","9200",凱基-嘉義,2,4,2,-1,1.46
"20210204","1783","9274","9200",凱基-鳳山,1,0,1,1,0.73
"20210204","1783","9317","9300",華南永昌-林口,0,2,2,-1,1.46
"20210204","1783","9332","9300",華南永昌-楠梓,1,0,1,1,0.73
"20210204","1783","0035003900320043","5920",元富-潮州,0,1,1,-1,0.73
"20210204","1783","0039003800310046","9800",元大-福營,1,0,1,1,0.73
"20210204","1783","5851","5850",統一-高雄,0,1,1,-1,0.73
"20210204","1783","9898","9800",元大-新莊,1,0,1,1,0.73
"20210204","1783","0031003000340041","1040",臺銀-臺中,1,2,1,-1,0.73
"20210204","1783","9131","9100",群益金鼎-民權,0,0,0,1,0.00
"20210204","1783","1470","1470",台灣摩根士丹利,0,1,1,-1,0.73
"20210204","1783","0038003800380041","8880",國泰-館前,0,0,0,1,0.00
"20210204","1783","0037003000300049","7000",兆豐-北高雄,0,1,1,-1,0.73
"20210205","1783","9600","9600",富邦證券,31,0,31,1,20.53
"20210205","1783","8150","8150",台新證券,1,8,7,-1,4.64
"20210205","1783","0038003800340044","8840",玉山-左營,20,0,20,1,13.25
"20210205","1783","003500320036004b","5260",美好-富順,2,8,6,-1,3.97
"20210205","1783","003800380038004b","8880",國泰-板橋,4,0,4,1,2.65
"20210205","1783","8843","8840",玉山-高雄,0,6,6,-1,3.97
"20210205","1783","6115","6110",台中銀-台北,3,0,3,1,1.99
"20210205","1783","003100320036004c","1260",宏遠-台中,0,5,5,-1,3.31
"20210205","1783","9317","9300",華南永昌-林口,3,0,3,1,1.99
"20210205","1783","9285","9200",凱基-中壢,0,5,5,-1,3.31
"20210205","1783","9892","9800",元大-屏東,3,0,3,1,1.99
"20210205","1783","0039003800300044","9800",元大-北府,0,5,5,-1,3.31
"20210205","1783","0039003800390043","9800",元大-板橋,3,0,3,1,1.99
"20210205","1783","0031003000320046","1020",合庫-西台中,0,4,4,-1,2.65
"20210205","1783","0039003800390064","9800",元大-北屯,3,0,3,1,1.99
"20210205","1783","0035003300380042","5380",第一金-新竹,0,4,4,-1,2.65
"20210205","1783","0039003800390051","9800",元大-汐止,3,0,3,1,1.99
"20210205","1783","9693","9600",富邦-新營,0,4,4,-1,2.65
"20210205","1783","0035003900320063","5920",元富-烏日,2,0,2,1,1.32
"20210205","1783","1440","1440",美林,1,4,3,-1,1.99
"20210205","1783","7032","7030",致和-佳里,2,0,2,1,1.32
"20210205","1783","5320","5320",高橋,0,3,3,-1,1.99
"20210205","1783","8562","8560",新光-高雄,2,0,2,1,1.32
"20210205","1783","5382","5380",第一金-台中,0,3,3,-1,1.99
"20210205","1783","9257","9200",凱基-林口,2,0,2,1,1.32
"20210205","1783","9211","9200",凱基-台南,0,3,3,-1,1.99
"20210205","1783","9326","9300",華南永昌-南京,2,0,2,1,1.32
"20210205","1783","9853","9800",元大-南屯,0,3,3,-1,1.99
"20210217","1783","9600","9600",富邦證券,187,0,187,1,32.75
"20210217","1783","0038003800340044","8840",玉山-左營,0,20,20,-1,3.50
"20210217","1783","8840","8840",玉山證券,80,0,80,1,14.01
"20210217","1783","003900410039004a","9A00",永豐金-板新,0,20,20,-1,3.50
"20210217","1783","0035003800350067","5850",統一-平鎮,10,0,10,1,1.75
"20210217","1783","0037003700390065","7790",國票-南科,0,10,10,-1,1.75
"20210217","1783","0039004100390044","9A00",永豐金-忠孝,6,0,6,1,1.05
"20210217","1783","0038003800340042","8840",玉山-台中,0,10,10,-1,1.75
"20210217","1783","0039003100330055","9100",群益金鼎-崇德,5,0,5,1,0.88
"20210217","1783","0039003800310046","9800",元大-福營,0,6,6,-1,1.05
"20210217","1783","0039003200300056","9200",凱基-新店,5,0,5,1,0.88
"20210217","1783","0039003800380043","9800",元大-三重,0,5,5,-1,0.88
"20210217","1783","9892","9800",元大-屏東,5,0,5,1,0.88
"20210217","1783","003900380039006d","9800",元大-信義,0,5,5,-1,0.88
"20210217","1783","9326","9300",華南永昌-南京,4,0,4,1,0.70
"20210217","1783","0039003600320046","9600",富邦-北桃園(停),0,4,4,-1,0.70
"20210217","1783","9302","9300",華南永昌-台中,4,0,4,1,0.70
"20210217","1783","8440","8440",摩根大通,3,6,3,-1,0.53
"20210217","1783","1520","1520",瑞士信貸,3,0,3,1,0.53
"20210217","1783","9283","9200",凱基-北門,0,3,3,-1,0.53
"20210217","1783","0039003800310053","9800",元大-崇德,3,0,3,1,0.53
"20210217","1783","0039003800390051","9800",元大-汐止,0,3,3,-1,0.53
"20210217","1783","0039003800390045","9800",元大-草屯,3,0,3,1,0.53
"20210217","1783","0035003300380041","5380",第一金-新興,0,2,2,-1,0.35
"20210217","1783","2187","2180",亞東-台中,2,0,2,1,0.35
"20210217","1783","5323","5320",高橋-內壢,0,2,2,-1,0.35
"20210217","1783","0031003000320046","1020",合庫-西台中,2,0,2,1,0.35
"20210217","1783","0037003000300072","7000",兆豐-寶成,0,2,2,-1,0.35
"20210218","1783","9600","9600",富邦證券,288,0,288,1,32.25
"20210218","1783","0035003900320055","5920",元富-宜蘭,0,10,10,-1,1.12
"20210218","1783","8840","8840",玉山證券,43,0,43,1,4.82
"20210218","1783","0037003000300049","7000",兆豐-北高雄,0,10,10,-1,1.12
"20210218","1783","0039003600310052","9600",富邦-南員林,20,0,20,1,2.24
"20210218","1783","9289","9200",凱基-興隆,0,6,6,-1,0.67
"20210218","1783","9268","9200",凱基-台北,16,0,16,1,1.79
"20210218","1783","0039004100390062","9A00",永豐金-虎尾,0,6,6,-1,0.67
"20210218","1783","9898","9800",元大-新莊,15,0,15,1,1.68
"20210218","1783","1042","1040",臺銀-臺南,0,5,5,-1,0.56
"20210218","1783","1440","1440",美林,22,10,12,1,1.34
"20210218","1783","5320","5320",高橋,0,5,5,-1,0.56
"20210218","1783","6210","6210",新百王,10,0,10,1,1.12
"20210218","1783","8440","8440",摩根大通,1,6,5,-1,0.56
"20210218","1783","0039003200300057","9200",凱基-大里,10,0,10,1,1.12
"20210218","1783","003900380031006d","9800",元大-前金,0,5,5,-1,0.56
"20210218","1783","9655","9600",富邦-板橋,10,1,9,1,1.01
"20210218","1783","5323","5320",高橋-內壢,1,4,3,-1,0.34
"20210218","1783","9226","9200",凱基-汐止,8,0,8,1,0.90
"20210218","1783","0037003000300072","7000",兆豐-寶成,0,3,3,-1,0.34
"20210218","1783","9287","9200",凱基-內湖,8,0,8,1,0.90
"20210218","1783","9278","9200",凱基-永康,0,3,3,-1,0.34
"20210218","1783","9300","9300",華南永昌,8,2,6,1,0.67
"20210218","1783","9302","9300",華南永昌-台中,0,3,3,-1,0.34
"20210218","1783","0039003800390051","9800",元大-汐止,6,0,6,1,0.67
"20210218","1783","0039003600310057","9600",富邦-東花蓮,0,3,3,-1,0.34
"20210218","1783","0035003800350049","5850",統一-員林,5,0,5,1,0.56
"20210218","1783","0039003800310046","9800",元大-福營,0,3,3,-1,0.34
"20210219","1783","8586","8580",聯邦-大業,60,0,60,1,14.18
"20210219","1783","9315","9300",華南永昌-苑裡,0,20,20,-1,4.73
"20210219","1783","9202","9200",凱基-中港,59,0,59,1,13.95
"20210219","1783","9898","9800",元大-新莊,0,15,15,-1,3.55
"20210219","1783","9268","9200",凱基-台北,22,2,20,1,4.73
"20210219","1783","9894","9800",元大-桃興,0,15,15,-1,3.55
"20210219","1783","9105","9100",群益金鼎-高盛,10,0,10,1,2.36
"20210219","1783","0039004100390032","9A00",永豐金-萬盛,2,16,14,-1,3.31
"20210219","1783","9300","9300",華南永昌,8,0,8,1,1.89
"20210219","1783","003800380038004b","8880",國泰-板橋,2,15,13,-1,3.07
"20210219","1783","0038003400350045","8450",康和-澎湖,7,0,7,1,1.65
"20210219","1783","0031003000340043","1040",臺銀-高雄,0,12,12,-1,2.84
"20210219","1783","0039003800310046","9800",元大-福營,9,2,7,1,1.65
"20210219","1783","5856","5850",統一-台中,5,16,11,-1,2.60
"20210219","1783","9867","9800",元大-北成功,6,0,6,1,1.42
"20210219","1783","9654","9600",富邦-永和,0,11,11,-1,2.60
"20210219","1783","0031003100310042","1110",台灣企銀-建成,5,0,5,1,1.18
"20210219","1783","0035003800350067","5850",統一-平鎮,0,10,10,-1,2.36
"20210219","1783","5600","5600",永興,5,0,5,1,1.18
"20210219","1783","9332","9300",華南永昌-楠梓,0,10,10,-1,2.36
"20210219","1783","0036003100310041","6110",台中銀-豐原,5,0,5,1,1.18
"20210219","1783","8840","8840",玉山證券,1,10,9,-1,2.13
"20210219","1783","6385","6380",光和-花壇,5,0,5,1,1.18
"20210219","1783","9226","9200",凱基-汐止,0,8,8,-1,1.89
"20210219","1783","0039003100380042","9100",群益金鼎-板橋,5,0,5,1,1.18
"20210219","1783","0035003900320050","5920",元富-同大,0,7,7,-1,1.65
"20210219","1783","9676","9600",富邦-仁愛,5,0,5,1,1.18
"20210219","1783","1043","1040",臺銀-民權,0,6,6,-1,1.42
"20210222","1783","0039003800390044","9800",元大-左營,21,0,21,1,3.01
"20210222","1783","9676","9600",富邦-仁愛,0,40,40,-1,5.73
"20210222","1783","0039004100390062","9A00",永豐金-虎尾,20,0,20,1,2.87
"20210222","1783","0039003600310052","9600",富邦-南員林,0,16,16,-1,2.29
"20210222","1783","9884","9800",元大-斗信,19,0,19,1,2.72
"20210222","1783","8560","8560",新光,6,21,15,-1,2.15
"20210222","1783","0031003000320043","1020",合庫-自強,18,0,18,1,2.58
"20210222","1783","0039003800390043","9800",元大-板橋,0,15,15,-1,2.15
"20210222","1783","9268","9200",凱基-台北,18,1,17,1,2.44
"20210222","1783","9302","9300",華南永昌-台中,11,25,14,-1,2.01
"20210222","1783","5927","5920",元富-林園,14,0,14,1,2.01
"20210222","1783","0036003100310041","6110",台中銀-豐原,4,16,12,-1,1.72
"20210222","1783","0035003800350048","5850",統一-桃園,13,0,13,1,1.86
"20210222","1783","9894","9800",元大-桃興,0,12,12,-1,1.72
"20210222","1783","1520","1520",瑞士信貸,11,0,11,1,1.58
"20210222","1783","9283","9200",凱基-北門,0,10,10,-1,1.43
"20210222","1783","0035003900320061","5920",元富-松德,10,0,10,1,1.43
"20210222","1783","0039003600350055","9600",富邦-彰化,0,10,10,-1,1.43
"20210222","1783","0035003900320075","5920",元富-世貿,10,0,10,1,1.43
"20210222","1783","6210","6210",新百王,1,10,9,-1,1.29
"20210222","1783","9105","9100",群益金鼎-高盛,10,0,10,1,1.43
"20210222","1783","9108","9100",群益金鼎-海山,0,9,9,-1,1.29
"20210222","1783","9223","9200",凱基-豐中,10,0,10,1,1.43
"20210222","1783","9285","9200",凱基-中壢,0,9,9,-1,1.29
"20210222","1783","9326","9300",華南永昌-南京,10,0,10,1,1.43
"20210222","1783","003500390032007a","5920",元富-文心,0,8,8,-1,1.15
"20210222","1783","0039003800320042","9800",元大-博愛,10,0,10,1,1.43
"20210222","1783","9315","9300",華南永昌-苑裡,2,10,8,-1,1.15
"20210223","1783","0038003400350045","8450",康和-澎湖,12,0,12,1,3.88
"20210223","1783","6385","6380",光和-花壇,0,24,24,-1,7.77
"20210223","1783","0039004100390032","9A00",永豐金-萬盛,9,0,9,1,2.91
"20210223","1783","0039004100390062","9A00",永豐金-虎尾,0,20,20,-1,6.47
"20210223","1783","003900410039004b","9A00",永豐金-三重,9,0,9,1,2.91
"20210223","1783","5927","5920",元富-林園,0,14,14,-1,4.53
"20210223","1783","0031003000320043","1020",合庫-自強,8,0,8,1,2.59
"20210223","1783","003500390032005a","5920",元富-安南,0,10,10,-1,3.24
"20210223","1783","2180","2180",亞東,7,0,7,1,2.27
"20210223","1783","0039003800390064","9800",元大-北屯,0,8,8,-1,2.59
"20210223","1783","9268","9200",凱基-台北,12,5,7,1,2.27
"20210223","1783","8440","8440",摩根大通,4,11,7,-1,2.27
"20210223","1783","9300","9300",華南永昌,7,0,7,1,2.27
"20210223","1783","0039003100330055","9100",群益金鼎-崇德,0,7,7,-1,2.27
"20210223","1783","9835","9800",元大-員林中山,7,0,7,1,2.27
"20210223","1783","0035003900320061","5920",元富-松德,0,6,6,-1,1.94
"20210223","1783","003500390032006d","5920",元富-成功,6,0,6,1,1.94
"20210223","1783","9272","9200",凱基-竹科,0,6,6,-1,1.94
"20210223","1783","0038003800340044","8840",玉山-左營,6,0,6,1,1.94
"20210223","1783","0039003600320045","9600",富邦-樹林,0,5,5,-1,1.62
"20210223","1783","1590","1590",花旗環球,5,0,5,1,1.62
"20210223","1783","8565","8560",新光-桃園,0,4,4,-1,1.29
"20210223","1783","1520","1520",瑞士信貸,5,0,5,1,1.62
"20210223","1783","9302","9300",華南永昌-台中,4,8,4,-1,1.29
"20210223","1783","9252","9200",凱基-嘉義,5,0,5,1,1.62
"20210223","1783","9326","9300",華南永昌-南京,6,10,4,-1,1.29
"20210223","1783","003900410039004a","9A00",永豐金-板新,5,0,5,1,1.62
"20210223","1783","0035003800350055","5850",統一-南京,0,3,3,-1,0.97
"20210224","1783","9853","9800",元大-南屯,40,8,32,1,8.51
"20210224","1783","0039003800310046","9800",元大-福營,0,39,39,-1,10.37
"20210224","1783","0038003400350045","8450",康和-澎湖,26,0,26,1,6.91
"20210224","1783","0039003800390044","9800",元大-左營,0,21,21,-1,5.59
"20210224","1783","9623","9600",富邦-台北,12,0,12,1,3.19
"20210224","1783","9268","9200",凱基-台北,0,19,19,-1,5.05
"20210224","1783","5385","5380",第一金-桃園,12,1,11,1,2.93
"20210224","1783","9884","9800",元大-斗信,0,19,19,-1,5.05
"20210224","1783","9315","9300",華南永昌-苑裡,10,0,10,1,2.66
"20210224","1783","6950","6950",福勝,0,18,18,-1,4.79
"20210224","1783","0039003800300051","9800",元大-南崁,10,0,10,1,2.66
"20210224","1783","0039003800310053","9800",元大-崇德,0,17,17,-1,4.52
"20210224","1783","0039004100390032","9A00",永豐金-萬盛,9,0,9,1,2.39
"20210224","1783","0039003800320042","9800",元大-博愛,1,14,13,-1,3.46
"20210224","1783","003500330038006a","5380",第一金-安和,10,3,7,1,1.86
"20210224","1783","5321","5320",高橋-龍潭,1,12,11,-1,2.93
"20210224","1783","8586","8580",聯邦-大業,7,0,7,1,1.86
"20210224","1783","1233","1230",彰銀-台中,0,5,5,-1,1.33
"20210224","1783","9300","9300",華南永昌,7,1,6,1,1.60
"20210224","1783","5389","5380",第一金-中山,0,5,5,-1,1.33
"20210224","1783","9817","9800",元大-東泰,6,0,6,1,1.60
"20210224","1783","003800380038004b","8880",國泰-板橋,0,5,5,-1,1.33
"20210224","1783","1040","1040",臺銀,5,0,5,1,1.33
"20210224","1783","8562","8560",新光-高雄,1,6,5,-1,1.33
"20210224","1783","0035003300380045","5380",第一金-自由,5,0,5,1,1.33
"20210224","1783","9814","9800",元大-大益,0,4,4,-1,1.06
"20210224","1783","003500390032006d","5920",元富-成功,5,0,5,1,1.33
"20210224","1783","9254","9200",凱基-科園,0,4,4,-1,1.06
"20210225","1783","0039003800310053","9800",元大-崇德,10,0,10,1,9.17
"20210225","1783","0039004100390055","9A00",永豐金-中正,0,10,10,-1,9.17
"20210225","1783","0038003400350045","8450",康和-澎湖,8,0,8,1,7.34
"20210225","1783","003900310038004a","9100",群益金鼎-永和,0,8,8,-1,7.34
"20210225","1783","1115","1110",台灣企銀-太平,5,0,5,1,4.59
"20210225","1783","9858","9800",元大-龍潭,0,8,8,-1,7.34
"20210225","1783","0039003200300047","9200",凱基-彰化,5,0,5,1,4.59
"20210225","1783","0037003000300068","7000",兆豐-三民,0,6,6,-1,5.50
"20210225","1783","9268","9200",凱基-台北,5,2,3,1,2.75
"20210225","1783","9624","9600",富邦-竹北,0,5,5,-1,4.59
"20210225","1783","9800","9800",元大證券,3,0,3,1,2.75
"20210225","1783","0035003900320061","5920",元富-松德,0,4,4,-1,3.67
"20210225","1783","003900380031004d","9800",元大-苗栗,3,0,3,1,2.75
"20210225","1783","0035003800350059","5850",統一-土城,0,4,4,-1,3.67
"20210225","1783","1520","1520",瑞士信貸,2,0,2,1,1.83
"20210225","1783","1440","1440",美林,0,4,4,-1,3.67
"20210225","1783","0038003100350059","8150",台新-新營,2,0,2,1,1.83
"20210225","1783","0039003800390055","9800",元大-大甲,0,4,4,-1,3.67
"20210225","1783","8565","8560",新光-桃園,2,0,2,1,1.83
"20210225","1783","2180","2180",亞東,0,3,3,-1,2.75
"20210225","1783","0039003200310046","9200",凱基-天母,2,0,2,1,1.83
"20210225","1783","6115","6110",台中銀-台北,0,3,3,-1,2.75
"20210225","1783","9296","9200",凱基-頭份,2,0,2,1,1.83
"20210225","1783","8887","8880",國泰-忠孝,0,3,3,-1,2.75
"20210225","1783","9300","9300",華南永昌,2,0,2,1,1.83
"20210225","1783","0039003800310041","9800",元大-鶯歌,0,3,3,-1,2.75
"20210225","1783","0039003600310052","9600",富邦-南員林,11,9,2,1,1.83
"20210225","1783","5385","5380",第一金-桃園,0,2,2,-1,1.83
"20210226","1783","0039004100390055","9A00",永豐金-中正,10,0,10,1,11.76
"20210226","1783","6115","6110",台中銀-台北,0,6,6,-1,7.06
"20210226","1783","9892","9800",元大-屏東,5,0,5,1,5.88
"20210226","1783","9268","9200",凱基-台北,2,8,6,-1,7.06
"20210226","1783","9300","9300",華南永昌,4,0,4,1,4.71
"20210226","1783","9326","9300",華南永昌-南京,1,7,6,-1,7.06
"20210226","1783","0031003000320043","1020",合庫-自強,3,0,3,1,3.53
"20210226","1783","8440","8440",摩根大通,0,4,4,-1,4.71
"20210226","1783","0039003100380045","9100",群益金鼎-南京,3,0,3,1,3.53
"20210226","1783","5385","5380",第一金-桃園,0,3,3,-1,3.53
"20210226","1783","9621","9600",富邦-花蓮,3,0,3,1,3.53
"20210226","1783","1590","1590",花旗環球,0,3,3,-1,3.53
"20210226","1783","0039003600320050","9600",富邦-頭份,3,0,3,1,3.53
"20210226","1783","1440","1440",美林,0,3,3,-1,3.53
"20210226","1783","8561","8560",新光-台中,2,0,2,1,2.35
"20210226","1783","1113","1110",台灣企銀-九如,0,3,3,-1,3.53
"20210226","1783","003500390032005a","5920",元富-安南,2,0,2,1,2.35
"20210226","1783","9302","9300",華南永昌-台中,0,3,3,-1,3.53
"20210226","1783","003700370039005a","7790",國票-安和,2,0,2,1,2.35
"20210226","1783","0039003800310046","9800",元大-福營,0,3,3,-1,3.53
"20210226","1783","0038003100350059","8150",台新-新營,2,0,2,1,2.35
"20210226","1783","1028","1020",合庫-彰化,0,2,2,-1,2.35
"20210226","1783","9189","9100",群益金鼎-桃園,2,0,2,1,2.35
"20210226","1783","1520","1520",瑞士信貸,0,2,2,-1,2.35
"20210226","1783","9817","9800",元大-東泰,2,0,2,1,2.35
"20210226","1783","0037003700390065","7790",國票-南科,0,2,2,-1,2.35
"20210226","1783","0039003800350043","9800",元大-鳳中,2,0,2,1,2.35
"20210226","1783","8455","8450",康和-台中,0,2,2,-1,2.35
"20210104","1783","0035003900320057","5920",元富-吉利,13,0,13,1,13.54
"20210104","1783","0037003000300058","7000",兆豐-永和,0,10,10,-1,10.42
"20210104","1783","5856","5850",統一-台中,10,0,10,1,10.42
"20210104","1783","9622","9600",富邦-園區(停),0,10,10,-1,10.42
"20210104","1783","1115","1110",台灣企銀-太平,5,0,5,1,5.21
"20210104","1783","003500320036004b","5260",美好-富順,0,8,8,-1,8.33
"20210104","1783","9831","9800",元大-四維,5,0,5,1,5.21
"20210104","1783","0039003200300044","9200",凱基-市府,0,3,3,-1,3.13
"20210104","1783","9300","9300",華南永昌,5,0,5,1,5.21
"20210104","1783","9268","9200",凱基-台北,1,4,3,-1,3.13
"20210104","1783","0038003400350046","8450",康和-仁愛,4,0,4,1,4.17
"20210104","1783","9302","9300",華南永昌-台中,0,3,3,-1,3.13
"20210104","1783","9200","9200",凱基,3,0,3,1,3.13
"20210104","1783","0039003600320045","9600",富邦-樹林,0,3,3,-1,3.13
"20210104","1783","0039003800300044","9800",元大-北府,3,0,3,1,3.13
"20210104","1783","9817","9800",元大-東泰,1,4,3,-1,3.13
"20210104","1783","8440","8440",摩根大通,2,0,2,1,2.08
"20210104","1783","003900380039005a","9800",元大-小港,0,3,3,-1,3.13
"20210104","1783","0039003200300046","9200",凱基-站前,2,0,2,1,2.08
"20210104","1783","5386","5380",第一金-彰化,0,2,2,-1,2.08
"20210104","1783","0039003800390046","9800",元大-高雄,2,0,2,1,2.08
"20210104","1783","5266","5260",美好-中壢,0,2,2,-1,2.08
"20210104","1783","003900380039004c","9800",元大-成功,2,0,2,1,2.08
"20210104","1783","0038003100350041","8150",台新-高雄,0,2,2,-1,2.08
"20210104","1783","1520","1520",瑞士信貸,1,0,1,1,1.04
"20210104","1783","8561","8560",新光-台中,0,2,2,-1,2.08
"20210104","1783","1440","1440",美林,2,1,1,1,1.04
"20210104","1783","8888","8880",國泰-敦南,0,2,2,-1,2.08
"20210105","1783","9875","9800",元大-土城永寧,5,0,5,1,5.95
"20210105","1783","0039003800300064","9800",元大-沙鹿,0,12,12,-1,14.29
"20210105","1783","9300","9300",華南永昌,4,0,4,1,4.76
"20210105","1783","0039003800310045","9800",元大-發財,0,9,9,-1,10.71
"20210105","1783","0039003600310048","9600",富邦-新板,4,0,4,1,4.76
"20210105","1783","0039003100380047","9100",群益金鼎-新莊,3,10,7,-1,8.33
"20210105","1783","003500320036004b","5260",美好-富順,5,2,3,1,3.57
"20210105","1783","9862","9800",元大-南京,0,4,4,-1,4.76
"20210105","1783","003500390032005a","5920",元富-安南,3,0,3,1,3.57
"20210105","1783","0039003200310043","9200",凱基-民權,0,3,3,-1,3.57
"20210105","1783","2180","2180",亞東,3,0,3,1,3.57
"20210105","1783","9893","9800",元大-大天母,0,3,3,-1,3.57
"20210105","1783","0038003100350059","8150",台新-新營,3,0,3,1,3.57
"20210105","1783","1440","1440",美林,2,4,2,-1,2.38
"20210105","1783","0038003400350055","8450",康和-台北,2,0,2,1,2.38
"20210105","1783","003800380038004b","8880",國泰-板橋,0,2,2,-1,2.38
"20210105","1783","8560","8560",新光,2,0,2,1,2.38
"20210105","1783","9333","9300",華南永昌-長虹,0,2,2,-1,2.38
"20210105","1783","003900360031004e","9600",富邦-西壢,2,0,2,1,2.38
"20210105","1783","0039003800390064","9800",元大-北屯,0,2,2,-1,2.38
"20210105","1783","0039003800310068","9800",元大-屏東民生,2,0,2,1,2.38
"20210105","1783","003900410039005a","9A00",永豐金-復興,0,2,2,-1,2.38
"20210105","1783","003900380031006d","9800",元大-前金,2,0,2,1,2.38
"20210105","1783","1040","1040",臺銀,0,1,1,-1,1.19
"20210105","1783","9856","9800",元大-花蓮,2,0,2,1,2.38
"20210105","1783","5262","5260",美好-楊梅,0,1,1,-1,1.19
"20210105","1783","7790","7790",國票證券,1,0,1,1,1.19
"20210105","1783","003700370039006e","7790",國票-南京,0,1,1,-1,1.19
"20210106","1783","9875","9800",元大-土城永寧,6,0,6,1,5.45
"20210106","1783","9658","9600",富邦-建國,0,15,15,-1,13.64
"20210106","1783","003500320036004b","5260",美好-富順,5,0,5,1,4.55
"20210106","1783","9268","9200",凱基-台北,2,13,11,-1,10.00
"20210106","1783","003900380031004b","9800",元大-林園,5,0,5,1,4.55
"20210106","1783","0039003100330048","9100",群益金鼎-屏東,0,10,10,-1,9.09
"20210106","1783","003700300030004e","7000",兆豐-埔墘,4,0,4,1,3.64
"20210106","1783","0035003900320045","5920",元富-城中,0,5,5,-1,4.55
"20210106","1783","9300","9300",華南永昌,7,3,4,1,3.64
"20210106","1783","0036003300380044","6380",光和-高雄,0,5,5,-1,4.55
"20210106","1783","0039003800330057","9800",元大-大里德芳,4,0,4,1,3.64
"20210106","1783","9237","9200",凱基-敦北,0,5,5,-1,4.55
"20210106","1783","9317","9300",華南永昌-林口,3,0,3,1,2.73
"20210106","1783","9227","9200",凱基-城中,0,3,3,-1,2.73
"20210106","1783","6450","6450",永全證券,3,0,3,1,2.73
"20210106","1783","1020","1020",合庫證券,0,2,2,-1,1.82
"20210106","1783","8882","8880",國泰-台中,4,1,3,1,2.73
"20210106","1783","0039003200300046","9200",凱基-站前,0,2,2,-1,1.82
"20210106","1783","0039003800390050","9800",元大-敦南,3,0,3,1,2.73
"20210106","1783","9236","9200",凱基-虎尾,0,2,2,-1,1.82
"20210106","1783","1045","1040",臺銀-新竹,2,0,2,1,1.82
"20210106","1783","9833","9800",元大-敦化,0,2,2,-1,1.82
"20210106","1783","003500390032006e","5920",元富-西松,2,0,2,1,1.82
"20210106","1783","0039003800340048","9800",元大-景美,0,2,2,-1,1.82
"20210106","1783","6168","6160",中國信託-嘉義,2,0,2,1,1.82
"20210106","1783","5262","5260",美好-楊梅,0,1,1,-1,0.91
"20210106","1783","5266","5260",美好-中壢,2,0,2,1,1.82
"20210106","1783","1590","1590",花旗環球,0,1,1,-1,0.91
"20210107","1783","8561","8560",新光-台中,10,0,10,1,5.15
"20210107","1783","5263","5260",美好-泰山,1,10,9,-1,4.64
"20210107","1783","5385","5380",第一金-桃園,10,0,10,1,5.15
"20210107","1783","9874","9800",元大-雙和,0,8,8,-1,4.12
"20210107","1783","0039003800300051","9800",元大-南崁,10,0,10,1,5.15
"20210107","1783","6385","6380",光和-花壇,0,5,5,-1,2.58
"20210107","1783","9300","9300",華南永昌,8,0,8,1,4.12
"20210107","1783","6913","6910",德信-新營,0,5,5,-1,2.58
"20210107","1783","0039003800300064","9800",元大-沙鹿,8,0,8,1,4.12
"20210107","1783","0039003600310045","9600",富邦-府城,0,5,5,-1,2.58
"20210107","1783","1440","1440",美林,10,4,6,1,3.09
"20210107","1783","0039003600320045","9600",富邦-樹林,0,5,5,-1,2.58
"20210107","1783","8840","8840",玉山證券,5,0,5,1,2.58
"20210107","1783","003900380031006e","9800",元大-旗山,0,5,5,-1,2.58
"20210107","1783","0039003800310044","9800",元大-南投,5,0,5,1,2.58
"20210107","1783","9859","9800",元大-新竹經國,0,5,5,-1,2.58
"20210107","1783","9875","9800",元大-土城永寧,5,0,5,1,2.58
"20210107","1783","5323","5320",高橋-內壢,0,4,4,-1,2.06
"20210107","1783","1111","1110",台灣企銀-台中,3,0,3,1,1.55
"20210107","1783","0039003200300046","9200",凱基-站前,0,4,4,-1,2.06
"20210107","1783","9829","9800",元大-永康,3,0,3,1,1.55
"20210107","1783","9268","9200",凱基-台北,4,8,4,-1,2.06
"20210107","1783","0039003800340048","9800",元大-景美,3,0,3,1,1.55
"20210107","1783","9888","9800",元大-鑫永和,0,4,4,-1,2.06
"20210107","1783","1023","1020",合庫-高雄,2,0,2,1,1.03
"20210107","1783","5854","5850",統一-城中,0,3,3,-1,1.55
"20210107","1783","5383","5380",第一金-高雄,2,0,2,1,1.03
"20210107","1783","9200","9200",凱基,0,3,3,-1,1.55
"20210108","1783","9285","9200",凱基-中壢,20,0,20,1,14.60
"20210108","1783","6620","6620",口袋證券,0,10,10,-1,7.30
"20210108","1783","0035003900320057","5920",元富-吉利,13,0,13,1,9.49
"20210108","1783","9252","9200",凱基-嘉義,0,7,7,-1,5.11
"20210108","1783","6168","6160",中國信託-嘉義,10,0,10,1,7.30
"20210108","1783","1440","1440",美林,13,19,6,-1,4.38
"20210108","1783","8888","8880",國泰-敦南,8,0,8,1,5.84
"20210108","1783","9303","9300",華南永昌-高雄,0,6,6,-1,4.38
"20210108","1783","9875","9800",元大-土城永寧,4,0,4,1,2.92
"20210108","1783","9812","9800",元大-台中,0,6,6,-1,4.38
"20210108","1783","003500390032006d","5920",元富-成功,7,5,2,1,1.46
"20210108","1783","003900320030004d","9200",凱基-宜蘭,2,7,5,-1,3.65
"20210108","1783","8440","8440",摩根大通,2,0,2,1,1.46
"20210108","1783","0035003900320055","5920",元富-宜蘭,0,3,3,-1,2.19
"20210108","1783","8843","8840",玉山-高雄,2,0,2,1,1.46
"20210108","1783","9317","9300",華南永昌-林口,0,3,3,-1,2.19
"20210108","1783","8880","8880",國泰證券,2,0,2,1,1.46
"20210108","1783","9829","9800",元大-永康,2,5,3,-1,2.19
"20210108","1783","9234","9200",凱基-竹北,2,0,2,1,1.46
"20210108","1783","5960","5960",日茂,0,2,2,-1,1.46
"20210108","1783","0039003800310043","9800",元大-路竹,2,0,2,1,1.46
"20210108","1783","5854","5850",統一-城中,0,2,2,-1,1.46
"20210108","1783","0039004100390068","9A00",永豐金-台南,2,0,2,1,1.46
"20210108","1783","5383","5380",第一金-高雄,0,2,2,-1,1.46
"20210108","1783","9302","9300",華南永昌-台中,1,0,1,1,0.73
"20210108","1783","5323","5320",高橋-內壢,0,2,2,-1,1.46
"20210108","1783","1470","1470",台灣摩根士丹利,1,0,1,1,0.73
"20210108","1783","5265","5260",美好-苗栗,0,2,2,-1,1.46
"20210111","1783","0039003100380047","9100",群益金鼎-新莊,22,0,22,1,9.13
"20210111","1783","1440","1440",美林,1,13,12,-1,4.98
"20210111","1783","7006","7000",兆豐-台南,15,0,15,1,6.22
"20210111","1783","8561","8560",新光-台中,0,11,11,-1,4.56
"20210111","1783","8560","8560",新光,12,2,10,1,4.15
"20210111","1783","003900380033006a","9800",元大-仁愛,0,11,11,-1,4.56
"20210111","1783","8440","8440",摩根大通,7,0,7,1,2.90
"20210111","1783","9187","9100",群益金鼎-彰化,0,10,10,-1,4.15
"20210111","1783","0039003600320043","9600",富邦-東門,6,0,6,1,2.49
"20210111","1783","9268","9200",凱基-台北,3,13,10,-1,4.15
"20210111","1783","0039004100390062","9A00",永豐金-虎尾,6,0,6,1,2.49
"20210111","1783","8881","8880",國泰-高雄,0,8,8,-1,3.32
"20210111","1783","1040","1040",臺銀,5,0,5,1,2.07
"20210111","1783","9817","9800",元大-東泰,4,11,7,-1,2.90
"20210111","1783","0037003700390065","7790",國票-南科,5,0,5,1,2.07
"20210111","1783","8888","8880",國泰-敦南,0,5,5,-1,2.07
"20210111","1783","003900380031004e","9800",元大-金門,5,0,5,1,2.07
"20210111","1783","003500390032006d","5920",元富-成功,0,5,5,-1,2.07
"20210111","1783","0039003800390058","9800",元大-民生,5,0,5,1,2.07
"20210111","1783","9233","9200",凱基-長庚,0,5,5,-1,2.07
"20210111","1783","5382","5380",第一金-台中,3,0,3,1,1.24
"20210111","1783","0039003800320042","9800",元大-博愛,0,5,5,-1,2.07
"20210111","1783","0035003800350044","5850",統一-新台中,4,1,3,1,1.24
"20210111","1783","8157","8150",台新-左楠,0,4,4,-1,1.66
"20210111","1783","5960","5960",日茂,3,0,3,1,1.24
"20210111","1783","0039003800300044","9800",元大-北府,0,4,4,-1,1.66
"20210111","1783","8562","8560",新光-高雄,4,1,3,1,1.24
"20210111","1783","0039004100390058","9A00",永豐金-竹科,0,4,4,-1,1.66
"20210112","1783","9875","9800",元大-土城永寧,10,0,10,1,9.17
"20210112","1783","0038003800340045","8840",玉山-城中,0,5,5,-1,4.59
"20210112","1783","0039003600310052","9600",富邦-南員林,10,1,9,1,8.26
"20210112","1783","5927","5920",元富-林園,0,4,4,-1,3.67
"20210112","1783","5321","5320",高橋-龍潭,8,0,8,1,7.34
"20210112","1783","6385","6380",光和-花壇,0,4,4,-1,3.67
"20210112","1783","9343","9300",華南永昌-頭份,8,0,8,1,7.34
"20210112","1783","7032","7030",致和-佳里,0,4,4,-1,3.67
"20210112","1783","0039003800390053","9800",元大-鹿港,6,0,6,1,5.50
"20210112","1783","1032","1030",土銀-台南,0,3,3,-1,2.75
"20210112","1783","9252","9200",凱基-嘉義,15,10,5,1,4.59
"20210112","1783","1590","1590",花旗環球,0,3,3,-1,2.75
"20210112","1783","1020","1020",合庫證券,4,0,4,1,3.67
"20210112","1783","6383","6380",光和-和美,0,3,3,-1,2.75
"20210112","1783","8440","8440",摩根大通,3,0,3,1,2.75
"20210112","1783","8840","8840",玉山證券,0,3,3,-1,2.75
"20210112","1783","1480","1480",美商高盛,2,0,2,1,1.83
"20210112","1783","1040","1040",臺銀,0,3,3,-1,2.75
"20210112","1783","003500320036004b","5260",美好-富順,2,0,2,1,1.83
"20210112","1783","1233","1230",彰銀-台中,0,2,2,-1,1.83
"20210112","1783","6480","6480",福邦證券,2,0,2,1,1.83
"20210112","1783","1119","1110",台灣企銀-岡山,0,2,2,-1,1.83
"20210112","1783","9108","9100",群益金鼎-海山,2,0,2,1,1.83
"20210112","1783","0031003000340041","1040",臺銀-臺中,0,2,2,-1,1.83
"20210112","1783","0039003800310053","9800",元大-崇德,2,0,2,1,1.83
"20210112","1783","5660","5660",日進,0,2,2,-1,1.83
"20210112","1783","0039004100360031","9A00",永豐金-鳳山,2,0,2,1,1.83
"20210112","1783","6210","6210",新百王,0,2,2,-1,1.83
"20210113","1783","0039004100380046","9A00",永豐金-敦南,16,0,16,1,16.16
"20210113","1783","0035003900320043","5920",元富-潮州,0,5,5,-1,5.05
"20210113","1783","7032","7030",致和-佳里,12,0,12,1,12.12
"20210113","1783","0038003400350041","8450",康和-內湖,0,5,5,-1,5.05
"20210113","1783","0039003800390049","9800",元大-蘆洲,10,0,10,1,10.10
"20210113","1783","0039003800310044","9800",元大-南投,0,5,5,-1,5.05
"20210113","1783","8440","8440",摩根大通,5,0,5,1,5.05
"20210113","1783","003900380031004b","9800",元大-林園,0,5,5,-1,5.05
"20210113","1783","9817","9800",元大-東泰,4,0,4,1,4.04
"20210113","1783","1520","1520",瑞士信貸,0,4,4,-1,4.04
"20210113","1783","0035003900320057","5920",元富-吉利,3,0,3,1,3.03
"20210113","1783","0039004100390032","9A00",永豐金-萬盛,0,4,4,-1,4.04
"20210113","1783","9800","9800",元大證券,3,1,2,1,2.02
"20210113","1783","9226","9200",凱基-汐止,0,3,3,-1,3.03
"20210113","1783","0035003300380045","5380",第一金-自由,2,0,2,1,2.02
"20210113","1783","003500320036004b","5260",美好-富順,0,2,2,-1,2.02
"20210113","1783","0035003800350048","5850",統一-桃園,2,0,2,1,2.02
"20210113","1783","5266","5260",美好-中壢,0,2,2,-1,2.02
"20210113","1783","0038003100350041","8150",台新-高雄,2,0,2,1,2.02
"20210113","1783","1041","1040",臺銀-鳳山,0,2,2,-1,2.02
"20210113","1783","9268","9200",凱基-台北,2,0,2,1,2.02
"20210113","1783","1040","1040",臺銀,0,2,2,-1,2.02
"20210113","1783","9317","9300",華南永昌-林口,2,0,2,1,2.02
"20210113","1783","0039003200300057","9200",凱基-大里,0,2,2,-1,2.02
"20210113","1783","0039003800310056","9800",元大-民雄,2,0,2,1,2.02
"20210113","1783","9300","9300",華南永昌,0,2,2,-1,2.02
"20210113","1783","0039003800330057","9800",元大-大里德芳,2,0,2,1,2.02
"20210113","1783","9326","9300",華南永昌-南京,0,2,2,-1,2.02
"20210114","1783","0035003900320057","5920",元富-吉利,10,0,10,1,12.50
"20210114","1783","003800380038004b","8880",國泰-板橋,0,10,10,-1,12.50
"20210114","1783","0038003100350041","8150",台新-高雄,5,0,5,1,6.25
"20210114","1783","1520","1520",瑞士信貸,0,8,8,-1,10.00
"20210114","1783","9252","9200",凱基-嘉義,5,0,5,1,6.25
"20210114","1783","0039004100390053","9A00",永豐金-南京,0,5,5,-1,6.25
"20210114","1783","0039004100390032","9A00",永豐金-萬盛,4,0,4,1,5.00
"20210114","1783","0038003400350055","8450",康和-台北,0,4,4,-1,5.00
"20210114","1783","003500320036004b","5260",美好-富順,2,0,2,1,2.50
"20210114","1783","8560","8560",新光,0,4,4,-1,5.00
"20210114","1783","5266","5260",美好-中壢,2,0,2,1,2.50
"20210114","1783","0039003200300041","9200",凱基-板橋,0,3,3,-1,3.75
"20210114","1783","003700300030004e","7000",兆豐-埔墘,2,0,2,1,2.50
"20210114","1783","0039003800310045","9800",元大-發財,0,3,3,-1,3.75
"20210114","1783","0039003200310046","9200",凱基-天母,2,0,2,1,2.50
"20210114","1783","0039003800310067","9800",元大-大里,0,3,3,-1,3.75
"20210114","1783","9227","9200",凱基-城中,2,0,2,1,2.50
"20210114","1783","9233","9200",凱基-長庚,0,2,2,-1,2.50
"20210114","1783","9324","9300",華南永昌-岡山,2,0,2,1,2.50
"20210114","1783","9276","9200",凱基-苗栗,0,2,2,-1,2.50
"20210114","1783","003900380031005a","9800",元大-潮州,2,0,2,1,2.50
"20210114","1783","9309","9300",華南永昌-古亭,0,2,2,-1,2.50
"20210114","1783","9893","9800",元大-大天母,2,0,2,1,2.50
"20210114","1783","003900410039004e","9A00",永豐金-桃盛,0,2,2,-1,2.50
"20210114","1783","8156","8150",台新-三民,1,0,1,1,1.25
"20210114","1783","0035003300380044","5380",第一金-忠孝,0,1,1,-1,1.25
"20210114","1783","8150","8150",台新證券,1,0,1,1,1.25
"20210114","1783","0035003800350063","5850",統一-仁愛,0,1,1,-1,1.25
"20210115","1783","9283","9200",凱基-北門,10,0,10,1,8.06
"20210115","1783","1520","1520",瑞士信貸,0,23,23,-1,18.55
"20210115","1783","9315","9300",華南永昌-苑裡,10,0,10,1,8.06
"20210115","1783","6463","6460",大昌-新竹,0,10,10,-1,8.06
"20210115","1783","0039004100380046","9A00",永豐金-敦南,10,0,10,1,8.06
"20210115","1783","0039003800300064","9800",元大-沙鹿,0,6,6,-1,4.84
"20210115","1783","003500320036004b","5260",美好-富順,7,0,7,1,5.65
"20210115","1783","8562","8560",新光-高雄,0,5,5,-1,4.03
"20210115","1783","9875","9800",元大-土城永寧,6,0,6,1,4.84
"20210115","1783","1021","1020",合庫-台中,0,3,3,-1,2.42
"20210115","1783","0031003000320043","1020",合庫-自強,5,0,5,1,4.03
"20210115","1783","003600310036004b","6160",中國信託-高雄,0,3,3,-1,2.42
"20210115","1783","8560","8560",新光,5,0,5,1,4.03
"20210115","1783","0037003000300047","7000",兆豐-麻豆,0,3,3,-1,2.42
"20210115","1783","9800","9800",元大證券,5,0,5,1,4.03
"20210115","1783","8710","8710",陽信,0,3,3,-1,2.42
"20210115","1783","6164","6160",中國信託-文心,3,0,3,1,2.42
"20210115","1783","0039004100360031","9A00",永豐金-鳳山,0,3,3,-1,2.42
"20210115","1783","9616","9600",富邦-岡山,4,1,3,1,2.42
"20210115","1783","0035003900320058","5920",元富-草屯,0,2,2,-1,1.61
"20210115","1783","5323","5320",高橋-內壢,2,0,2,1,1.61
"20210115","1783","6167","6160",中國信託-松江,0,2,2,-1,1.61
"20210115","1783","6450","6450",永全證券,2,0,2,1,1.61
"20210115","1783","6461","6460",大昌-樹林,0,2,2,-1,1.61
"20210115","1783","0039003200300044","9200",凱基-市府,2,0,2,1,1.61
"20210115","1783","0037003000300067","7000",兆豐-南門,0,2,2,-1,1.61
"20210115","1783","9300","9300",華南永昌,2,0,2,1,1.61
"20210115","1783","7032","7030",致和-佳里,0,2,2,-1,1.61
"20210118","1783","1030","1030",土銀,10,0,10,1,7.14
"20210118","1783","003900380039004c","9800",元大-成功,0,14,14,-1,10.00
"20210118","1783","0039003600310046","9600",富邦-中港,6,0,6,1,4.29
"20210118","1783","1520","1520",瑞士信貸,0,8,8,-1,5.71
"20210118","1783","8886","8880",國泰-新莊,5,0,5,1,3.57
"20210118","1783","0039003800330057","9800",元大-大里德芳,0,6,6,-1,4.29
"20210118","1783","9278","9200",凱基-永康,5,0,5,1,3.57
"20210118","1783","0036003100310041","6110",台中銀-豐原,0,5,5,-1,3.57
"20210118","1783","0037003000300045","7000",兆豐-斗南(停),4,0,4,1,2.86
"20210118","1783","9212","9200",凱基-東港,0,5,5,-1,3.57
"20210118","1783","003500320036004b","5260",美好-富順,5,1,4,1,2.86
"20210118","1783","0037003000300056","7000",兆豐-新竹,0,4,4,-1,2.86
"20210118","1783","9300","9300",華南永昌,4,0,4,1,2.86
"20210118","1783","0038003800340045","8840",玉山-城中,0,3,3,-1,2.14
"20210118","1783","0031003000340041","1040",臺銀-臺中,3,0,3,1,2.14
"20210118","1783","9227","9200",凱基-城中,0,2,2,-1,1.43
"20210118","1783","9215","9200",凱基-高美館,6,3,3,1,2.14
"20210118","1783","9862","9800",元大-南京,0,2,2,-1,1.43
"20210118","1783","0039003600310043","9600",富邦-南京,3,0,3,1,2.14
"20210118","1783","5323","5320",高橋-內壢,0,1,1,-1,0.71
"20210118","1783","0035003900320055","5920",元富-宜蘭,2,0,2,1,1.43
"20210118","1783","9208","9200",凱基-桃園,0,1,1,-1,0.71
"20210118","1783","003700300030004e","7000",兆豐-埔墘,2,0,2,1,1.43
"20210118","1783","9369","9300",華南永昌-三重,0,1,1,-1,0.71
"20210118","1783","0037003000300069","7000",兆豐-松德,2,0,2,1,1.43
"20210118","1783","0039003600310050","9600",富邦-和美,0,1,1,-1,0.71
"20210118","1783","1110","1110",台灣企銀,2,0,2,1,1.43
"20210118","1783","0039003600320056","9600",富邦-復興,0,1,1,-1,0.71
"20210119","1783","9105","9100",群益金鼎-高盛,27,0,27,1,16.56
"20210119","1783","0039003800310053","9800",元大-崇德,0,20,20,-1,12.27
"20210119","1783","0039004100390055","9A00",永豐金-中正,11,0,11,1,6.75
"20210119","1783","1520","1520",瑞士信貸,0,16,16,-1,9.82
"20210119","1783","0039003800300064","9800",元大-沙鹿,6,0,6,1,3.68
"20210119","1783","9202","9200",凱基-中港,0,8,8,-1,4.91
"20210119","1783","6450","6450",永全證券,4,0,4,1,2.45
"20210119","1783","9268","9200",凱基-台北,0,8,8,-1,4.91
"20210119","1783","9875","9800",元大-土城永寧,4,0,4,1,2.45
"20210119","1783","9343","9300",華南永昌-頭份,0,6,6,-1,3.68
"20210119","1783","8157","8150",台新-左楠,3,0,3,1,1.84
"20210119","1783","9817","9800",元大-東泰,0,6,6,-1,3.68
"20210119","1783","0039003600310045","9600",富邦-府城,3,0,3,1,1.84
"20210119","1783","9655","9600",富邦-板橋,0,4,4,-1,2.45
"20210119","1783","0039003800390050","9800",元大-敦南,3,0,3,1,1.84
"20210119","1783","1233","1230",彰銀-台中,0,3,3,-1,1.84
"20210119","1783","9303","9300",華南永昌-高雄,2,0,2,1,1.23
"20210119","1783","0035003900320055","5920",元富-宜蘭,1,3,2,-1,1.23
"20210119","1783","1110","1110",台灣企銀,2,0,2,1,1.23
"20210119","1783","8885","8880",國泰-桃園,0,2,2,-1,1.23
"20210119","1783","0037003000300069","7000",兆豐-松德,2,0,2,1,1.23
"20210119","1783","9289","9200",凱基-興隆,0,2,2,-1,1.23
"20210119","1783","8882","8880",國泰-台中,2,0,2,1,1.23
"20210119","1783","9302","9300",華南永昌-台中,0,2,2,-1,1.23
"20210119","1783","0039004100380046","9A00",永豐金-敦南,2,0,2,1,1.23
"20210119","1783","0039003800310061","9800",元大-歸仁,0,2,2,-1,1.23
"20210119","1783","0035003900320056","5920",元富-民權(停),1,0,1,1,0.61
"20210119","1783","0039003800330057","9800",元大-大里德芳,0,2,2,-1,1.23
"20210120","1783","8560","8560",新光,11,2,9,1,4.66
"20210120","1783","0039003600320045","9600",富邦-樹林,0,20,20,-1,10.36
"20210120","1783","6385","6380",光和-花壇,5,0,5,1,2.59
"20210120","1783","1520","1520",瑞士信貸,0,19,19,-1,9.84
"20210120","1783","5382","5380",第一金-台中,5,0,5,1,2.59
"20210120","1783","0037003000330042","7030",致和-崇德,0,10,10,-1,5.18
"20210120","1783","1110","1110",台灣企銀,3,0,3,1,1.55
"20210120","1783","0039003800300064","9800",元大-沙鹿,0,10,10,-1,5.18
"20210120","1783","6164","6160",中國信託-文心,2,0,2,1,1.04
"20210120","1783","0038003800380041","8880",國泰-館前,0,9,9,-1,4.66
"20210120","1783","003500320036004b","5260",美好-富順,4,2,2,1,1.04
"20210120","1783","0038003100350042","8150",台新-台中,0,8,8,-1,4.15
"20210120","1783","0031003000320041","1020",合庫-新竹,2,0,2,1,1.04
"20210120","1783","8440","8440",摩根大通,0,7,7,-1,3.63
"20210120","1783","9300","9300",華南永昌,2,0,2,1,1.04
"20210120","1783","0039003600320058","9600",富邦-文化,0,7,7,-1,3.63
"20210120","1783","0039003600310045","9600",富邦-府城,2,0,2,1,1.04
"20210120","1783","9852","9800",元大-永春,0,7,7,-1,3.63
"20210120","1783","9634","9600",富邦-羅東,2,0,2,1,1.04
"20210120","1783","0039003100380046","9100",群益金鼎-新店,0,6,6,-1,3.11
"20210120","1783","003900380031006e","9800",元大-旗山,2,0,2,1,1.04
"20210120","1783","9252","9200",凱基-嘉義,1,7,6,-1,3.11
"20210120","1783","003900380033005a","9800",元大-鳳山,2,0,2,1,1.04
"20210120","1783","9651","9600",富邦-民生(停),0,5,5,-1,2.59
"20210120","1783","0039003800390050","9800",元大-敦南,2,0,2,1,1.04
"20210120","1783","0037003000300072","7000",兆豐-寶成,0,4,4,-1,2.07
"20210120","1783","0039004100380039","9A00",永豐金-敦北,2,0,2,1,1.04
"20210120","1783","5922","5920",元富-新店,0,3,3,-1,1.55
"20210121","1783","8560","8560",新光,15,0,15,1,10.34
"20210121","1783","7032","7030",致和-佳里,0,12,12,-1,8.28
"20210121","1783","9268","9200",凱基-台北,8,2,6,1,4.14
"20210121","1783","1030","1030",土銀,0,10,10,-1,6.90
"20210121","1783","1110","1110",台灣企銀,2,0,2,1,1.38
"20210121","1783","8159","8150",台新-台南,0,10,10,-1,6.90
"20210121","1783","9300","9300",華南永昌,2,0,2,1,1.38
"20210121","1783","5600","5600",永興,0,6,6,-1,4.14
"20210121","1783","0039003600310053","9600",富邦-景美,2,0,2,1,1.38
"20210121","1783","5382","5380",第一金-台中,0,4,4,-1,2.76
"20210121","1783","0039003800390045","9800",元大-草屯,2,0,2,1,1.38
"20210121","1783","7009","7000",兆豐-景美,0,4,4,-1,2.76
"20210121","1783","0037003000300057","7000",兆豐-城中,1,0,1,1,0.69
"20210121","1783","9859","9800",元大-新竹經國,0,4,4,-1,2.76
"20210121","1783","003900310038004a","9100",群益金鼎-永和,1,0,1,1,0.69
"20210121","1783","0037003000300052","7000",兆豐-小港,0,3,3,-1,2.07
"20210121","1783","9205","9200",凱基-三重,1,0,1,1,0.69
"20210121","1783","6462","6460",大昌-安康,0,3,3,-1,2.07
"20210121","1783","0039003600320055","9600",富邦-縣政,1,0,1,1,0.69
"20210121","1783","9223","9200",凱基-豐中,0,3,3,-1,2.07
"20210121","1783","003900380039005a","9800",元大-小港,1,0,1,1,0.69
"20210121","1783","9329","9300",華南永昌-朴子,0,3,3,-1,2.07
"20210121","1783","8881","8880",國泰-高雄,0,0,0,1,0.00
"20210121","1783","0039003600330042","9600",富邦-北宜蘭(停),0,3,3,-1,2.07
"20210121","1783","9303","9300",華南永昌-高雄,0,0,0,1,0.00
"20210121","1783","9693","9600",富邦-新營,0,3,3,-1,2.07
"20210121","1783","9337","9300",華南永昌-內壢,0,0,0,1,0.00
"20210121","1783","0039004100390068","9A00",永豐金-台南,0,3,3,-1,2.07
"20210122","1783","7032","7030",致和-佳里,15,0,15,1,11.45
"20210122","1783","8560","8560",新光,2,20,18,-1,13.74
"20210122","1783","0035003300380059","5380",第一金-中壢,10,0,10,1,7.63
"20210122","1783","0035003900320055","5920",元富-宜蘭,0,10,10,-1,7.63
"20210122","1783","1440","1440",美林,7,0,7,1,5.34
"20210122","1783","0038003400350044","8450",康和-板橋,0,4,4,-1,3.05
"20210122","1783","9211","9200",凱基-台南,5,0,5,1,3.82
"20210122","1783","8840","8840",玉山證券,0,4,4,-1,3.05
"20210122","1783","003900310038004a","9100",群益金鼎-永和,4,0,4,1,3.05
"20210122","1783","0039003800310056","9800",元大-民雄,0,4,4,-1,3.05
"20210122","1783","9856","9800",元大-花蓮,4,0,4,1,3.05
"20210122","1783","0039003200300045","9200",凱基-東門,0,3,3,-1,2.29
"20210122","1783","0039003800390045","9800",元大-草屯,4,0,4,1,3.05
"20210122","1783","0039003200300048","9200",凱基-基隆,0,3,3,-1,2.29
"20210122","1783","0037003000300052","7000",兆豐-小港,3,0,3,1,2.29
"20210122","1783","0039003600320045","9600",富邦-樹林,0,3,3,-1,2.29
"20210122","1783","9316","9300",華南永昌-淡水,2,0,2,1,1.53
"20210122","1783","0039003800390065","9800",元大-中和,0,3,3,-1,2.29
"20210122","1783","9858","9800",元大-龍潭,2,0,2,1,1.53
"20210122","1783","0031003000340044","1040",臺銀-金山,0,2,2,-1,1.53
"20210122","1783","1590","1590",花旗環球,1,0,1,1,0.76
"20210122","1783","9362","9300",華南永昌-苗栗,0,2,2,-1,1.53
"20210122","1783","1040","1040",臺銀,1,0,1,1,0.76
"20210122","1783","9817","9800",元大-東泰,0,2,2,-1,1.53
"20210122","1783","0035003300380057","5380",第一金-華江,1,0,1,1,0.76
"20210122","1783","9893","9800",元大-大天母,0,2,2,-1,1.53
"20210122","1783","9108","9100",群益金鼎-海山,1,0,1,1,0.76
"20210122","1783","0039004100390065","9A00",永豐金-高雄,0,2,2,-1,1.53
"20210125","1783","5929","5920",元富-台南,10,0,10,1,11.24
"20210125","1783","5267","5260",美好-基隆,0,17,17,-1,19.10
"20210125","1783","0039003800300064","9800",元大-沙鹿,7,0,7,1,7.87
"20210125","1783","0039004100390031","9A00",永豐金-松山,0,6,6,-1,6.74
"20210125","1783","0039003800310046","9800",元大-福營,6,0,6,1,6.74
"20210125","1783","0039004100390055","9A00",永豐金-中正,0,6,6,-1,6.74
"20210125","1783","5323","5320",高橋-內壢,3,0,3,1,3.37
"20210125","1783","9211","9200",凱基-台南,0,5,5,-1,5.62
"20210125","1783","003500390032006e","5920",元富-西松,2,0,2,1,2.25
"20210125","1783","0039003100330055","9100",群益金鼎-崇德,0,3,3,-1,3.37
"20210125","1783","0035003800350055","5850",統一-南京,2,0,2,1,2.25
"20210125","1783","9303","9300",華南永昌-高雄,0,3,3,-1,3.37
"20210125","1783","0037003000300045","7000",兆豐-斗南(停),2,0,2,1,2.25
"20210125","1783","9347","9300",華南永昌-敦南,0,3,3,-1,3.37
"20210125","1783","003900310038004a","9100",群益金鼎-永和,2,0,2,1,2.25
"20210125","1783","003500320036004b","5260",美好-富順,0,2,2,-1,2.25
"20210125","1783","0039003600310050","9600",富邦-和美,2,0,2,1,2.25
"20210125","1783","0037003000300069","7000",兆豐-松德,0,2,2,-1,2.25
"20210125","1783","9897","9800",元大-土城,2,0,2,1,2.25
"20210125","1783","003700300030004e","7000",兆豐-埔墘,0,2,2,-1,2.25
"20210125","1783","1520","1520",瑞士信貸,1,0,1,1,1.12
"20210125","1783","0038003800340048","8840",玉山-新竹,0,2,2,-1,2.25
"20210125","1783","1470","1470",台灣摩根士丹利,1,0,1,1,1.12
"20210125","1783","003900380031004e","9800",元大-金門,0,2,2,-1,2.25
"20210125","1783","1440","1440",美林,1,0,1,1,1.12
"20210125","1783","5850","5850",統一,0,1,1,-1,1.12
"20210125","1783","003500330038006a","5380",第一金-安和,1,0,1,1,1.12
"20210125","1783","5321","5320",高橋-龍潭,0,1,1,-1,1.12
"20210126","1783","9300","9300",華南永昌,2,0,2,1,4.26
"20210126","1783","1440","1440",美林,0,5,5,-1,10.64
"20210126","1783","9647","9600",富邦-新竹,2,0,2,1,4.26
"20210126","1783","003900380034004b","9800",元大-館前,0,5,5,-1,10.64
"20210126","1783","9817","9800",元大-東泰,2,0,2,1,4.26
"20210126","1783","8849","8840",玉山-景美,0,4,4,-1,8.51
"20210126","1783","8150","8150",台新證券,1,0,1,1,2.13
"20210126","1783","003900310038004a","9100",群益金鼎-永和,0,4,4,-1,8.51
"20210126","1783","7790","7790",國票證券,1,0,1,1,2.13
"20210126","1783","9899","9800",元大-淡水,0,4,4,-1,8.51
"20210126","1783","6163","6160",中國信託-永康,1,0,1,1,2.13
"20210126","1783","5320","5320",高橋,0,3,3,-1,6.38
"20210126","1783","0039003100330067","9100",群益金鼎-三重,1,0,1,1,2.13
"20210126","1783","1041","1040",臺銀-鳳山,0,2,2,-1,4.26
"20210126","1783","0039003600310047","9600",富邦-成功,1,0,1,1,2.13
"20210126","1783","9858","9800",元大-龍潭,0,2,2,-1,4.26
"20210126","1783","003900360032004c","9600",富邦-雙和,1,0,1,1,2.13
"20210126","1783","0039004100390050","9A00",永豐金-竹北,0,2,2,-1,4.26
"20210126","1783","9655","9600",富邦-板橋,1,0,1,1,2.13
"20210126","1783","8881","8880",國泰-高雄,0,1,1,-1,2.13
"20210126","1783","0039003800300064","9800",元大-沙鹿,1,0,1,1,2.13
"20210126","1783","0038003800340042","8840",玉山-台中,0,1,1,-1,2.13
"20210126","1783","0039003800310046","9800",元大-福營,1,0,1,1,2.13
"20210126","1783","5384","5380",第一金-台南,0,1,1,-1,2.13
"20210126","1783","9853","9800",元大-南屯,1,0,1,1,2.13
"20210126","1783","9268","9200",凱基-台北,1,2,1,-1,2.13
"20210126","1783","003900410039004b","9A00",永豐金-三重,1,0,1,1,2.13
"20210126","1783","9679","9600",富邦-延吉(停),0,1,1,-1,2.13
"20210127","1783","9600","9600",富邦證券,15,0,15,1,15.46
"20210127","1783","0039003800300064","9800",元大-沙鹿,0,8,8,-1,8.25
"20210127","1783","0037003700390065","7790",國票-南科,10,0,10,1,10.31
"20210127","1783","0039003800310056","9800",元大-民雄,0,8,8,-1,8.25
"20210127","1783","5859","5850",統一-屏東,10,0,10,1,10.31
"20210127","1783","9863","9800",元大-和平,0,6,6,-1,6.19
"20210127","1783","0039003200310046","9200",凱基-天母,2,0,2,1,2.06
"20210127","1783","9322","9300",華南永昌-公誠,0,5,5,-1,5.15
"20210127","1783","0039003100380044","9100",群益金鼎-東門,1,0,1,1,1.03
"20210127","1783","0039003800320043","9800",元大-六合,0,5,5,-1,5.15
"20210127","1783","003900310038004a","9100",群益金鼎-永和,1,0,1,1,1.03
"20210127","1783","9837","9800",元大-北港,0,4,4,-1,4.12
"20210127","1783","9655","9600",富邦-板橋,1,0,1,1,1.03
"20210127","1783","7008","7000",兆豐-三重,0,3,3,-1,3.09
"20210127","1783","9814","9800",元大-大益,1,0,1,1,1.03
"20210127","1783","0039003100380047","9100",群益金鼎-新莊,3,6,3,-1,3.09
"20210127","1783","9838","9800",元大-豐原,1,0,1,1,1.03
"20210127","1783","9623","9600",富邦-台北,0,3,3,-1,3.09
"20210127","1783","0038003800380041","8880",國泰-館前,0,0,0,1,0.00
"20210127","1783","003900360032004a","9600",富邦-三峽,0,3,3,-1,3.09
"20210127","1783","5920","5920",元富,0,0,0,1,0.00
"20210127","1783","0035003800350055","5850",統一-南京,0,2,2,-1,2.06
"20210127","1783","5850","5850",統一,0,0,0,1,0.00
"20210127","1783","1520","1520",瑞士信貸,0,2,2,-1,2.06
"20210127","1783","8150","8150",台新證券,0,0,0,1,0.00
"20210127","1783","1470","1470",台灣摩根士丹利,0,2,2,-1,2.06
"20210127","1783","0039003600310045","9600",富邦-府城,0,0,0,1,0.00
"20210127","1783","9268","9200",凱基-台北,0,2,2,-1,2.06
"20210128","1783","9600","9600",富邦證券,89,0,89,1,35.74
"20210128","1783","9893","9800",元大-大天母,0,20,20,-1,8.03
"20210128","1783","9302","9300",華南永昌-台中,5,0,5,1,2.01
"20210128","1783","0039003600310052","9600",富邦-南員林,0,10,10,-1,4.02
"20210128","1783","9300","9300",華南永昌,4,0,4,1,1.61
"20210128","1783","1520","1520",瑞士信貸,0,6,6,-1,2.41
"20210128","1783","0039003100380047","9100",群益金鼎-新莊,6,3,3,1,1.20
"20210128","1783","003500380035004d","5850",統一-士林,0,5,5,-1,2.01
"20210128","1783","0039003200310046","9200",凱基-天母,2,0,2,1,0.80
"20210128","1783","003900310038004a","9100",群益金鼎-永和,0,5,5,-1,2.01
"20210128","1783","003500390032006c","5920",元富-大裕,1,0,1,1,0.40
"20210128","1783","0039003800350043","9800",元大-鳳中,0,5,5,-1,2.01
"20210128","1783","9205","9200",凱基-三重,1,0,1,1,0.40
"20210128","1783","0037003000300070","7000",兆豐-復興,0,4,4,-1,1.61
"20210128","1783","9377","9300",華南永昌-虎尾,1,0,1,1,0.40
"20210128","1783","0039003600310048","9600",富邦-新板,0,4,4,-1,1.61
"20210128","1783","0039003600330041","9600",富邦-八德,1,0,1,1,0.40
"20210128","1783","1440","1440",美林,0,3,3,-1,1.20
"20210128","1783","9814","9800",元大-大益,1,0,1,1,0.40
"20210128","1783","0039003600320045","9600",富邦-樹林,0,3,3,-1,1.20
"20210128","1783","003900380031007a","9800",元大-大統,1,0,1,1,0.40
"20210128","1783","9651","9600",富邦-民生(停),0,3,3,-1,1.20
"20210128","1783","0039003800320042","9800",元大-博愛,1,0,1,1,0.40
"20210128","1783","9837","9800",元大-北港,0,3,3,-1,1.20
"20210128","1783","9838","9800",元大-豐原,1,0,1,1,0.40
"20210128","1783","003900310038004b","9100",群益金鼎-東湖,0,3,3,-1,1.20
"20210128","1783","5929","5920",元富-台南,0,0,0,1,0.00
"20210128","1783","5382","5380",第一金-台中,0,2,2,-1,0.80
"20210129","1783","0035003900320057","5920",元富-吉利,169,0,169,1,35.14
"20210129","1783","9302","9300",華南永昌-台中,0,7,7,-1,1.46
"20210129","1783","0039003100380047","9100",群益金鼎-新莊,7,0,7,1,1.46
"20210129","1783","5386","5380",第一金-彰化,0,6,6,-1,1.25
"20210129","1783","003900380039006d","9800",元大-信義,5,0,5,1,1.04
"20210129","1783","1590","1590",花旗環球,0,5,5,-1,1.04
"20210129","1783","0039004100390038","9A00",永豐金-大園,5,0,5,1,1.04
"20210129","1783","0035003800350055","5850",統一-南京,0,5,5,-1,1.04
"20210129","1783","0037003000300046","7000",兆豐-虎尾,4,0,4,1,0.83
"20210129","1783","6463","6460",大昌-新竹,0,5,5,-1,1.04
"20210129","1783","0039003800390064","9800",元大-北屯,3,0,3,1,0.62
"20210129","1783","8440","8440",摩根大通,0,5,5,-1,1.04
"20210129","1783","9300","9300",華南永昌,2,0,2,1,0.42
"20210129","1783","9268","9200",凱基-台北,0,5,5,-1,1.04
"20210129","1783","0037003700390065","7790",國票-南科,2,0,2,1,0.42
"20210129","1783","5266","5260",美好-中壢,0,4,4,-1,0.83
"20210129","1783","8884","8880",國泰-台南,2,0,2,1,0.42
"20210129","1783","0037003000300052","7000",兆豐-小港,0,4,4,-1,0.83
"20210129","1783","9837","9800",元大-北港,2,0,2,1,0.42
"20210129","1783","003900360031004d","9600",富邦-木柵,0,4,4,-1,0.83
"20210129","1783","0039003800390045","9800",元大-草屯,2,0,2,1,0.42
"20210129","1783","0039003800350043","9800",元大-鳳中,0,4,4,-1,0.83
"20210129","1783","0037003000300043","7000",兆豐-來福,1,0,1,1,0.21
"20210129","1783","1470","1470",台灣摩根士丹利,0,3,3,-1,0.62
"20210129","1783","0037003700390050","7790",國票-九鼎,1,0,1,1,0.21
"20210129","1783","1111","1110",台灣企銀-台中,0,3,3,-1,0.62
"20210129","1783","9189","9100",群益金鼎-桃園,1,0,1,1,0.21
"20210129","1783","003900380031004b","9800",元大-林園,0,3,3,-1,0.62
"20201201","1783","003500390032005a","5920",元富-安南,10,0,10,1,8.77
"20201201","1783","0035003900320053","5920",元富-基隆,0,10,10,-1,8.77
"20201201","1783","9817","9800",元大-東泰,10,0,10,1,8.77
"20201201","1783","0039003100380047","9100",群益金鼎-新莊,0,10,10,-1,8.77
"20201201","1783","8886","8880",國泰-新莊,5,0,5,1,4.39
"20201201","1783","0039003800390046","9800",元大-高雄,0,9,9,-1,7.89
"20201201","1783","0039003800310046","9800",元大-福營,5,0,5,1,4.39
"20201201","1783","9359","9300",華南永昌-中正,0,8,8,-1,7.02
"20201201","1783","0039003800310047","9800",元大-彰化,5,0,5,1,4.39
"20201201","1783","0039003100380069","9100",群益金鼎-竹南,0,6,6,-1,5.26
"20201201","1783","9300","9300",華南永昌,4,0,4,1,3.51
"20201201","1783","0035003900320069","5920",元富-中港,0,5,5,-1,4.39
"20201201","1783","0039004100390055","9A00",永豐金-中正,4,0,4,1,3.51
"20201201","1783","5320","5320",高橋,0,5,5,-1,4.39
"20201201","1783","5384","5380",第一金-台南,3,0,3,1,2.63
"20201201","1783","003900410039004a","9A00",永豐金-板新,0,5,5,-1,4.39
"20201201","1783","0031003000320043","1020",合庫-自強,3,0,3,1,2.63
"20201201","1783","9333","9300",華南永昌-長虹,0,3,3,-1,2.63
"20201201","1783","9837","9800",元大-北港,3,0,3,1,2.63
"20201201","1783","1440","1440",美林,1,3,2,-1,1.75
"20201201","1783","7006","7000",兆豐-台南,2,0,2,1,1.75
"20201201","1783","0037003700390065","7790",國票-南科,0,2,2,-1,1.75
"20201201","1783","0039003800300043","9800",元大-斗六,2,0,2,1,1.75
"20201201","1783","003700370039004a","7790",國票-北高雄,0,2,2,-1,1.75
"20201201","1783","0035003900320061","5920",元富-松德,1,0,1,1,0.88
"20201201","1783","8564","8560",新光-台南,0,2,2,-1,1.75
"20201201","1783","1520","1520",瑞士信貸,1,0,1,1,0.88
"20201201","1783","9134","9100",群益金鼎-開元,0,2,2,-1,1.75
"20201202","1783","0039003100380047","9100",群益金鼎-新莊,13,0,13,1,8.78
"20201202","1783","0039003600310043","9600",富邦-南京,0,20,20,-1,13.51
"20201202","1783","9315","9300",華南永昌-苑裡,10,0,10,1,6.76
"20201202","1783","0039003100380069","9100",群益金鼎-竹南,0,17,17,-1,11.49
"20201202","1783","0039003800390043","9800",元大-板橋,10,0,10,1,6.76
"20201202","1783","9268","9200",凱基-台北,4,18,14,-1,9.46
"20201202","1783","9817","9800",元大-東泰,6,0,6,1,4.05
"20201202","1783","0039003600310050","9600",富邦-和美,0,9,9,-1,6.08
"20201202","1783","8886","8880",國泰-新莊,5,0,5,1,3.38
"20201202","1783","6950","6950",福勝,0,6,6,-1,4.05
"20201202","1783","9233","9200",凱基-長庚,5,0,5,1,3.38
"20201202","1783","0039003800310047","9800",元大-彰化,0,5,5,-1,3.38
"20201202","1783","003900380031006a","9800",元大-士林,5,0,5,1,3.38
"20201202","1783","0039003800310072","9800",元大-屏南,0,5,5,-1,3.38
"20201202","1783","0035003900320065","5920",元富-古亭,4,0,4,1,2.70
"20201202","1783","8456","8450",康和-新竹,0,4,4,-1,2.70
"20201202","1783","0039003800310046","9800",元大-福營,4,0,4,1,2.70
"20201202","1783","0037003700390065","7790",國票-南科,0,3,3,-1,2.03
"20201202","1783","0039004100390055","9A00",永豐金-中正,4,0,4,1,2.70
"20201202","1783","9625","9600",富邦-竹東,0,3,3,-1,2.03
"20201202","1783","9363","9300",華南永昌-彰化,3,0,3,1,2.03
"20201202","1783","9686","9600",富邦-宜蘭,0,3,3,-1,2.03
"20201202","1783","0039003800300043","9800",元大-斗六,3,0,3,1,2.03
"20201202","1783","5927","5920",元富-林園,0,2,2,-1,1.35
"20201202","1783","8560","8560",新光,2,0,2,1,1.35
"20201202","1783","5320","5320",高橋,0,2,2,-1,1.35
"20201202","1783","0039003200310046","9200",凱基-天母,2,0,2,1,1.35
"20201202","1783","5960","5960",日茂,0,2,2,-1,1.35
"20201203","1783","1520","1520",瑞士信貸,7,0,7,1,8.97
"20201203","1783","7750","7750",北城證券,0,10,10,-1,12.82
"20201203","1783","8886","8880",國泰-新莊,5,0,5,1,6.41
"20201203","1783","0039003600310058","9600",富邦-大墩,0,5,5,-1,6.41
"20201203","1783","7035","7030",致和-東門,4,0,4,1,5.13
"20201203","1783","9636","9600",富邦-中壢,0,5,5,-1,6.41
"20201203","1783","0035003900320057","5920",元富-吉利,4,0,4,1,5.13
"20201203","1783","003900380033005a","9800",元大-鳳山,0,5,5,-1,6.41
"20201203","1783","0035003900320065","5920",元富-古亭,3,0,3,1,3.85
"20201203","1783","2184","2180",亞東-新竹,0,2,2,-1,2.56
"20201203","1783","1440","1440",美林,5,2,3,1,3.85
"20201203","1783","1115","1110",台灣企銀-太平,0,2,2,-1,2.56
"20201203","1783","9814","9800",元大-大益,3,0,3,1,3.85
"20201203","1783","003700300030005a","7000",兆豐-高雄,0,2,2,-1,2.56
"20201203","1783","0039004100390055","9A00",永豐金-中正,3,0,3,1,3.85
"20201203","1783","0039003600310052","9600",富邦-南員林,0,2,2,-1,2.56
"20201203","1783","0037003000300045","7000",兆豐-斗南(停),2,0,2,1,2.56
"20201203","1783","0039003600310057","9600",富邦-東花蓮,0,2,2,-1,2.56
"20201203","1783","0039003100380042","9100",群益金鼎-板橋,2,0,2,1,2.56
"20201203","1783","9817","9800",元大-東泰,0,2,2,-1,2.56
"20201203","1783","9300","9300",華南永昌,2,0,2,1,2.56
"20201203","1783","003900380034004b","9800",元大-館前,0,2,2,-1,2.56
"20201203","1783","9386","9300",華南永昌-東昇,2,0,2,1,2.56
"20201203","1783","003900380039004c","9800",元大-成功,1,3,2,-1,2.56
"20201203","1783","0039003800300064","9800",元大-沙鹿,2,0,2,1,2.56
"20201203","1783","0037003000300052","7000",兆豐-小港,0,1,1,-1,1.28
"20201203","1783","0035003900320069","5920",元富-中港,1,0,1,1,1.28
"20201203","1783","0035003800350044","5850",統一-新台中,0,1,1,-1,1.28
"20201204","1783","0039004100390032","9A00",永豐金-萬盛,9,0,9,1,8.57
"20201204","1783","0039003800310045","9800",元大-發財,1,10,9,-1,8.57
"20201204","1783","0035003900320065","5920",元富-古亭,6,0,6,1,5.71
"20201204","1783","1440","1440",美林,0,6,6,-1,5.71
"20201204","1783","0035003900320043","5920",元富-潮州,5,0,5,1,4.76
"20201204","1783","9359","9300",華南永昌-中正,0,6,6,-1,5.71
"20201204","1783","8886","8880",國泰-新莊,5,0,5,1,4.76
"20201204","1783","003900360031004d","9600",富邦-木柵,0,6,6,-1,5.71
"20201204","1783","9287","9200",凱基-內湖,5,0,5,1,4.76
"20201204","1783","8456","8450",康和-新竹,0,5,5,-1,4.76
"20201204","1783","0039003600320058","9600",富邦-文化,4,0,4,1,3.81
"20201204","1783","9604","9600",富邦-陽明,0,5,5,-1,4.76
"20201204","1783","1470","1470",台灣摩根士丹利,3,0,3,1,2.86
"20201204","1783","0035003900320055","5920",元富-宜蘭,0,3,3,-1,2.86
"20201204","1783","9268","9200",凱基-台北,3,0,3,1,2.86
"20201204","1783","9834","9800",元大-中壢,0,3,3,-1,2.86
"20201204","1783","0039003800310046","9800",元大-福營,3,0,3,1,2.86
"20201204","1783","6164","6160",中國信託-文心,0,2,2,-1,1.90
"20201204","1783","0039003800320042","9800",元大-博愛,3,0,3,1,2.86
"20201204","1783","6450","6450",永全證券,0,2,2,-1,1.90
"20201204","1783","7790","7790",國票證券,2,0,2,1,1.90
"20201204","1783","9105","9100",群益金鼎-高盛,0,2,2,-1,1.90
"20201204","1783","8882","8880",國泰-台中,2,0,2,1,1.90
"20201204","1783","0039003200310047","9200",凱基-五股,1,3,2,-1,1.90
"20201204","1783","9833","9800",元大-敦化,2,0,2,1,1.90
"20201204","1783","9322","9300",華南永昌-公誠,0,2,2,-1,1.90
"20201204","1783","9858","9800",元大-龍潭,2,0,2,1,1.90
"20201204","1783","003900360032004b","9600",富邦-中和,0,2,2,-1,1.90
"20201207","1783","9315","9300",華南永昌-苑裡,10,0,10,1,8.20
"20201207","1783","0039003600310043","9600",富邦-南京,0,11,11,-1,9.02
"20201207","1783","0031003000320043","1020",合庫-自強,5,0,5,1,4.10
"20201207","1783","6163","6160",中國信託-永康,0,10,10,-1,8.20
"20201207","1783","0039003800310046","9800",元大-福營,5,0,5,1,4.10
"20201207","1783","9326","9300",華南永昌-南京,0,10,10,-1,8.20
"20201207","1783","0035003900320065","5920",元富-古亭,4,0,4,1,3.28
"20201207","1783","0038003400350058","8450",康和-屏東,0,6,6,-1,4.92
"20201207","1783","0039003100380047","9100",群益金鼎-新莊,3,0,3,1,2.46
"20201207","1783","9679","9600",富邦-延吉(停),0,5,5,-1,4.10
"20201207","1783","9252","9200",凱基-嘉義,3,0,3,1,2.46
"20201207","1783","0039003800370041","9800",元大-楊梅,0,5,5,-1,4.10
"20201207","1783","0039004100390032","9A00",永豐金-萬盛,3,0,3,1,2.46
"20201207","1783","0039003100380057","9100",群益金鼎-忠孝,1,5,4,-1,3.28
"20201207","1783","9874","9800",元大-雙和,2,0,2,1,1.64
"20201207","1783","9268","9200",凱基-台北,0,4,4,-1,3.28
"20201207","1783","1045","1040",臺銀-新竹,2,0,2,1,1.64
"20201207","1783","9834","9800",元大-中壢,0,4,4,-1,3.28
"20201207","1783","5266","5260",美好-中壢,2,0,2,1,1.64
"20201207","1783","5602","5600",永興-水湳,0,3,3,-1,2.46
"20201207","1783","6114","6110",台中銀-員林,2,0,2,1,1.64
"20201207","1783","9366","9300",華南永昌-豐原,0,3,3,-1,2.46
"20201207","1783","0037003000300047","7000",兆豐-麻豆,2,0,2,1,1.64
"20201207","1783","0039004100390065","9A00",永豐金-高雄,0,3,3,-1,2.46
"20201207","1783","9103","9100",群益金鼎-松山,2,0,2,1,1.64
"20201207","1783","9223","9200",凱基-豐中,0,2,2,-1,1.64
"20201207","1783","0039003200310046","9200",凱基-天母,2,0,2,1,1.64
"20201207","1783","9278","9200",凱基-永康,0,2,2,-1,1.64
"20201208","1783","0035003900320057","5920",元富-吉利,15,0,15,1,14.15
"20201208","1783","003900410039004c","9A00",永豐金-台中,0,19,19,-1,17.92
"20201208","1783","003500320036004b","5260",美好-富順,14,0,14,1,13.21
"20201208","1783","0037003700390076","7790",國票-台中,0,10,10,-1,9.43
"20201208","1783","003500380035004d","5850",統一-士林,6,0,6,1,5.66
"20201208","1783","9377","9300",華南永昌-虎尾,0,10,10,-1,9.43
"20201208","1783","8886","8880",國泰-新莊,5,0,5,1,4.72
"20201208","1783","0039003800320041","9800",元大-羅東,0,5,5,-1,4.72
"20201208","1783","9300","9300",華南永昌,5,0,5,1,4.72
"20201208","1783","6385","6380",光和-花壇,0,4,4,-1,3.77
"20201208","1783","0035003900320065","5920",元富-古亭,4,0,4,1,3.77
"20201208","1783","9268","9200",凱基-台北,3,7,4,-1,3.77
"20201208","1783","1119","1110",台灣企銀-岡山,4,0,4,1,3.77
"20201208","1783","0039003800390049","9800",元大-蘆洲,0,4,4,-1,3.77
"20201208","1783","1440","1440",美林,3,0,3,1,2.83
"20201208","1783","5660","5660",日進,0,3,3,-1,2.83
"20201208","1783","0035003900320049","5920",元富-嘉義,2,0,2,1,1.89
"20201208","1783","9888","9800",元大-鑫永和,0,3,3,-1,2.83
"20201208","1783","0031003000340041","1040",臺銀-臺中,2,0,2,1,1.89
"20201208","1783","0039004100390038","9A00",永豐金-大園,0,3,3,-1,2.83
"20201208","1783","7030","7030",致和證券,2,0,2,1,1.89
"20201208","1783","0036003300380041","6380",光和-嘉義,0,2,2,-1,1.89
"20201208","1783","9209","9200",凱基-岡山,2,0,2,1,1.89
"20201208","1783","6114","6110",台中銀-員林,0,1,1,-1,0.94
"20201208","1783","9276","9200",凱基-苗栗,2,0,2,1,1.89
"20201208","1783","0035003900320076","5920",元富-桃園,0,1,1,-1,0.94
"20201208","1783","9306","9300",華南永昌-台南,2,0,2,1,1.89
"20201208","1783","003500390032004d","5920",元富-彰化,0,1,1,-1,0.94
"20201209","1783","9268","9200",凱基-台北,16,2,14,1,8.92
"20201209","1783","0039003800310069","9800",元大-西螺,0,15,15,-1,9.55
"20201209","1783","003500320036004b","5260",美好-富順,10,0,10,1,6.37
"20201209","1783","0039003600310043","9600",富邦-南京,0,13,13,-1,8.28
"20201209","1783","0035003900320065","5920",元富-古亭,6,0,6,1,3.82
"20201209","1783","1031","1030",土銀-台中,0,12,12,-1,7.64
"20201209","1783","0031003000320043","1020",合庫-自強,5,0,5,1,3.18
"20201209","1783","2184","2180",亞東-新竹,0,11,11,-1,7.01
"20201209","1783","7032","7030",致和-佳里,5,0,5,1,3.18
"20201209","1783","0039003800310043","9800",元大-路竹,0,10,10,-1,6.37
"20201209","1783","8842","8840",玉山-新莊,5,0,5,1,3.18
"20201209","1783","1042","1040",臺銀-臺南,0,6,6,-1,3.82
"20201209","1783","8886","8880",國泰-新莊,5,0,5,1,3.18
"20201209","1783","0038003800340045","8840",玉山-城中,0,6,6,-1,3.82
"20201209","1783","1650","1650",新加坡商瑞銀,4,0,4,1,2.55
"20201209","1783","7001","7000",兆豐-嘉義,0,5,5,-1,3.18
"20201209","1783","9300","9300",華南永昌,4,0,4,1,2.55
"20201209","1783","0037003000300052","7000",兆豐-小港,0,5,5,-1,3.18
"20201209","1783","9363","9300",華南永昌-彰化,4,0,4,1,2.55
"20201209","1783","9223","9200",凱基-豐中,0,5,5,-1,3.18
"20201209","1783","0039003800310047","9800",元大-彰化,4,0,4,1,2.55
"20201209","1783","9625","9600",富邦-竹東,0,5,5,-1,3.18
"20201209","1783","1045","1040",臺銀-新竹,3,0,3,1,1.91
"20201209","1783","8150","8150",台新證券,1,5,4,-1,2.55
"20201209","1783","0039003800310068","9800",元大-屏東民生,3,0,3,1,1.91
"20201209","1783","0039004100380046","9A00",永豐金-敦南,0,4,4,-1,2.55
"20201209","1783","0039004100390069","9A00",永豐金-新店,3,0,3,1,1.91
"20201209","1783","0039003800310061","9800",元大-歸仁,0,3,3,-1,1.91
"20201210","1783","0039003800390050","9800",元大-敦南,10,0,10,1,9.80
"20201210","1783","003900360035004b","9600",富邦-台中,1,17,16,-1,15.69
"20201210","1783","9300","9300",華南永昌,7,0,7,1,6.86
"20201210","1783","9184","9100",群益金鼎-台中,0,5,5,-1,4.90
"20201210","1783","1440","1440",美林,9,3,6,1,5.88
"20201210","1783","0039004100300030","9A00",永豐金證券,0,5,5,-1,4.90
"20201210","1783","7032","7030",致和-佳里,5,0,5,1,4.90
"20201210","1783","0039004100390061","9A00",永豐金-苓雅,0,5,5,-1,4.90
"20201210","1783","0039003800390043","9800",元大-板橋,5,0,5,1,4.90
"20201210","1783","9268","9200",凱基-台北,3,7,4,-1,3.92
"20201210","1783","0039003100380047","9100",群益金鼎-新莊,5,2,3,1,2.94
"20201210","1783","0031003200360058","1260",宏遠-新化,0,3,3,-1,2.94
"20201210","1783","6912","6910",德信-中正,2,0,2,1,1.96
"20201210","1783","9209","9200",凱基-岡山,0,3,3,-1,2.94
"20201210","1783","5385","5380",第一金-桃園,2,0,2,1,1.96
"20201210","1783","9252","9200",凱基-嘉義,0,3,3,-1,2.94
"20201210","1783","0035003900320065","5920",元富-古亭,2,0,2,1,1.96
"20201210","1783","9814","9800",元大-大益,0,3,3,-1,2.94
"20201210","1783","5929","5920",元富-台南,2,0,2,1,1.96
"20201210","1783","003900380031006d","9800",元大-前金,0,3,3,-1,2.94
"20201210","1783","003800340035004a","8450",康和-高雄,2,0,2,1,1.96
"20201210","1783","003700300030005a","7000",兆豐-高雄,0,2,2,-1,1.96
"20201210","1783","9306","9300",華南永昌-台南,2,0,2,1,1.96
"20201210","1783","5387","5380",第一金-澎湖,0,2,2,-1,1.96
"20201210","1783","9672","9600",富邦-員林,2,0,2,1,1.96
"20201210","1783","0037003700390063","7790",國票-敦北法人,0,2,2,-1,1.96
"20201210","1783","9817","9800",元大-東泰,2,0,2,1,1.96
"20201210","1783","8440","8440",摩根大通,0,2,2,-1,1.96
"20201211","1783","9800","9800",元大證券,6,0,6,1,4.44
"20201211","1783","9863","9800",元大-和平,0,15,15,-1,11.11
"20201211","1783","0039003200300041","9200",凱基-板橋,4,0,4,1,2.96
"20201211","1783","003900380031005a","9800",元大-潮州,0,12,12,-1,8.89
"20201211","1783","0037003700390045","7790",國票-南崁,3,0,3,1,2.22
"20201211","1783","1440","1440",美林,0,11,11,-1,8.15
"20201211","1783","9686","9600",富邦-宜蘭,5,2,3,1,2.22
"20201211","1783","0031003100310045","1110",台灣企銀-桃園,0,10,10,-1,7.41
"20201211","1783","9834","9800",元大-中壢,3,0,3,1,2.22
"20201211","1783","5323","5320",高橋-內壢,0,10,10,-1,7.41
"20201211","1783","003700300030004e","7000",兆豐-埔墘,2,0,2,1,1.48
"20201211","1783","0039003800350043","9800",元大-鳳中,0,7,7,-1,5.19
"20201211","1783","9302","9300",華南永昌-台中,2,0,2,1,1.48
"20201211","1783","9202","9200",凱基-中港,0,6,6,-1,4.44
"20201211","1783","9672","9600",富邦-員林,2,0,2,1,1.48
"20201211","1783","5384","5380",第一金-台南,0,4,4,-1,2.96
"20201211","1783","9697","9600",富邦-虎尾,2,0,2,1,1.48
"20201211","1783","0035003300380041","5380",第一金-新興,0,3,3,-1,2.22
"20201211","1783","0039003800320042","9800",元大-博愛,2,0,2,1,1.48
"20201211","1783","0039003600320052","9600",富邦-園區,0,3,3,-1,2.22
"20201211","1783","0039003800340048","9800",元大-景美,2,0,2,1,1.48
"20201211","1783","9874","9800",元大-雙和,0,3,3,-1,2.22
"20201211","1783","5389","5380",第一金-中山,1,0,1,1,0.74
"20201211","1783","9817","9800",元大-東泰,0,2,2,-1,1.48
"20201211","1783","0031003200360051","1260",宏遠-高雄,1,0,1,1,0.74
"20201211","1783","003900380034004b","9800",元大-館前,0,2,2,-1,1.48
"20201211","1783","6162","6160",中國信託-忠孝,1,0,1,1,0.74
"20201211","1783","0039003800390051","9800",元大-汐止,0,2,2,-1,1.48
"20201214","1783","9208","9200",凱基-桃園,5,0,5,1,4.76
"20201214","1783","9801","9800",元大-城東,0,10,10,-1,9.52
"20201214","1783","9268","9200",凱基-台北,12,8,4,1,3.81
"20201214","1783","0038003800380041","8880",國泰-館前,0,7,7,-1,6.67
"20201214","1783","0031003000340043","1040",臺銀-高雄,3,0,3,1,2.86
"20201214","1783","9692","9600",富邦-嘉義,0,7,7,-1,6.67
"20201214","1783","0035003900320044","5920",元富-大昌,3,0,3,1,2.86
"20201214","1783","0039003800310045","9800",元大-發財,0,5,5,-1,4.76
"20201214","1783","003500320036004b","5260",美好-富順,3,0,3,1,2.86
"20201214","1783","003900380034004b","9800",元大-館前,0,4,4,-1,3.81
"20201214","1783","003700300030005a","7000",兆豐-高雄,3,0,3,1,2.86
"20201214","1783","0038003100350059","8150",台新-新營,1,4,3,-1,2.86
"20201214","1783","9103","9100",群益金鼎-松山,3,0,3,1,2.86
"20201214","1783","0039003200300048","9200",凱基-基隆,0,3,3,-1,2.86
"20201214","1783","0039003200300044","9200",凱基-市府,3,0,3,1,2.86
"20201214","1783","0037003000300073","7000",兆豐-岡山,0,2,2,-1,1.90
"20201214","1783","9300","9300",華南永昌,3,0,3,1,2.86
"20201214","1783","8152","8150",台新-新莊,0,2,2,-1,1.90
"20201214","1783","1520","1520",瑞士信貸,2,0,2,1,1.90
"20201214","1783","5383","5380",第一金-高雄,0,1,1,-1,0.95
"20201214","1783","0039003100330067","9100",群益金鼎-三重,2,0,2,1,1.90
"20201214","1783","0035003800350044","5850",統一-新台中,0,1,1,-1,0.95
"20201214","1783","5850","5850",統一,1,0,1,1,0.95
"20201214","1783","6464","6460",大昌-新店,0,1,1,-1,0.95
"20201214","1783","5660","5660",日進,1,0,1,1,0.95
"20201214","1783","0037003000300045","7000",兆豐-斗南(停),0,1,1,-1,0.95
"20201214","1783","5389","5380",第一金-中山,1,0,1,1,0.95
"20201214","1783","7795","7790",國票-南港,0,1,1,-1,0.95
"20201215","1783","0039003800350043","9800",元大-鳳中,10,0,10,1,11.90
"20201215","1783","9651","9600",富邦-民生(停),0,10,10,-1,11.90
"20201215","1783","9105","9100",群益金鼎-高盛,5,0,5,1,5.95
"20201215","1783","9268","9200",凱基-台北,0,7,7,-1,8.33
"20201215","1783","8560","8560",新光,4,0,4,1,4.76
"20201215","1783","9359","9300",華南永昌-中正,0,7,7,-1,8.33
"20201215","1783","1520","1520",瑞士信貸,3,0,3,1,3.57
"20201215","1783","5602","5600",永興-水湳,0,5,5,-1,5.95
"20201215","1783","0038003100350041","8150",台新-高雄,3,0,3,1,3.57
"20201215","1783","0035003900320041","5920",元富-緯城,0,4,4,-1,4.76
"20201215","1783","9300","9300",華南永昌,3,0,3,1,3.57
"20201215","1783","6380","6380",光和,0,3,3,-1,3.57
"20201215","1783","003900360031004d","9600",富邦-木柵,3,0,3,1,3.57
"20201215","1783","9227","9200",凱基-城中,0,3,3,-1,3.57
"20201215","1783","003700300030004e","7000",兆豐-埔墘,2,0,2,1,2.38
"20201215","1783","9636","9600",富邦-中壢,0,3,3,-1,3.57
"20201215","1783","003500320036004b","5260",美好-富順,2,0,2,1,2.38
"20201215","1783","8888","8880",國泰-敦南,0,2,2,-1,2.38
"20201215","1783","5262","5260",美好-楊梅,1,0,1,1,1.19
"20201215","1783","0039003100380047","9100",群益金鼎-新莊,2,4,2,-1,2.38
"20201215","1783","6912","6910",德信-中正,1,0,1,1,1.19
"20201215","1783","0039003600320058","9600",富邦-文化,0,2,2,-1,2.38
"20201215","1783","8440","8440",摩根大通,1,0,1,1,1.19
"20201215","1783","003900380034004b","9800",元大-館前,0,2,2,-1,2.38
"20201215","1783","0038003800340048","8840",玉山-新竹,1,0,1,1,1.19
"20201215","1783","5927","5920",元富-林園,0,1,1,-1,1.19
"20201215","1783","003800380038004b","8880",國泰-板橋,1,0,1,1,1.19
"20201215","1783","6461","6460",大昌-樹林,0,1,1,-1,1.19
"20201216","1783","5385","5380",第一金-桃園,11,0,11,1,10.38
"20201216","1783","9308","9300",華南永昌-麻豆,0,7,7,-1,6.60
"20201216","1783","0035003800350050","5850",統一-板橋,5,0,5,1,4.72
"20201216","1783","8565","8560",新光-桃園,0,5,5,-1,4.72
"20201216","1783","9268","9200",凱基-台北,8,3,5,1,4.72
"20201216","1783","9834","9800",元大-中壢,0,5,5,-1,4.72
"20201216","1783","6460","6460",大昌,4,0,4,1,3.77
"20201216","1783","0035003900320041","5920",元富-緯城,0,4,4,-1,3.77
"20201216","1783","9186","9100",群益金鼎-新竹,4,0,4,1,3.77
"20201216","1783","8150","8150",台新證券,0,4,4,-1,3.77
"20201216","1783","9332","9300",華南永昌-楠梓,4,0,4,1,3.77
"20201216","1783","0039003200300041","9200",凱基-板橋,0,4,4,-1,3.77
"20201216","1783","1520","1520",瑞士信貸,3,0,3,1,2.83
"20201216","1783","9252","9200",凱基-嘉義,1,5,4,-1,3.77
"20201216","1783","1440","1440",美林,3,0,3,1,2.83
"20201216","1783","0039003100380043","9100",群益金鼎-古亭,0,3,3,-1,2.83
"20201216","1783","9300","9300",華南永昌,3,0,3,1,2.83
"20201216","1783","0039003600330041","9600",富邦-八德,0,3,3,-1,2.83
"20201216","1783","9654","9600",富邦-永和,3,0,3,1,2.83
"20201216","1783","0039003800380042","9800",元大-桃園,0,3,3,-1,2.83
"20201216","1783","1233","1230",彰銀-台中,2,0,2,1,1.89
"20201216","1783","0035003900320059","5920",元富-埔里,0,2,2,-1,1.89
"20201216","1783","8880","8880",國泰證券,2,0,2,1,1.89
"20201216","1783","0035003800350055","5850",統一-南京,0,2,2,-1,1.89
"20201216","1783","0039003600320043","9600",富邦-東門,2,0,2,1,1.89
"20201216","1783","6950","6950",福勝,0,2,2,-1,1.89
"20201216","1783","0039003800310047","9800",元大-彰化,2,0,2,1,1.89
"20201216","1783","0037003000300047","7000",兆豐-麻豆,0,2,2,-1,1.89
"20201217","1783","9654","9600",富邦-永和,5,0,5,1,7.58
"20201217","1783","0039003600310052","9600",富邦-南員林,0,5,5,-1,7.58
"20201217","1783","9103","9100",群益金鼎-松山,4,0,4,1,6.06
"20201217","1783","9252","9200",凱基-嘉義,0,4,4,-1,6.06
"20201217","1783","1590","1590",花旗環球,2,0,2,1,3.03
"20201217","1783","003500320036004b","5260",美好-富順,0,3,3,-1,4.55
"20201217","1783","5323","5320",高橋-內壢,3,1,2,1,3.03
"20201217","1783","8440","8440",摩根大通,0,3,3,-1,4.55
"20201217","1783","9332","9300",華南永昌-楠梓,2,0,2,1,3.03
"20201217","1783","9817","9800",元大-東泰,0,3,3,-1,4.55
"20201217","1783","0039003800330047","9800",元大-上新莊,2,0,2,1,3.03
"20201217","1783","1233","1230",彰銀-台中,0,2,2,-1,3.03
"20201217","1783","0039003800350043","9800",元大-鳳中,2,0,2,1,3.03
"20201217","1783","003700300030004b","7000",兆豐-新營,0,2,2,-1,3.03
"20201217","1783","0039003800390044","9800",元大-左營,2,0,2,1,3.03
"20201217","1783","003700300030004e","7000",兆豐-埔墘,0,2,2,-1,3.03
"20201217","1783","5384","5380",第一金-台南,1,0,1,1,1.52
"20201217","1783","9217","9200",凱基-松山,0,2,2,-1,3.03
"20201217","1783","5383","5380",第一金-高雄,1,0,1,1,1.52
"20201217","1783","9268","9200",凱基-台北,1,3,2,-1,3.03
"20201217","1783","003500380035004d","5850",統一-士林,1,0,1,1,1.52
"20201217","1783","9319","9300",華南永昌-鶯歌,0,2,2,-1,3.03
"20201217","1783","1041","1040",臺銀-鳳山,1,0,1,1,1.52
"20201217","1783","9692","9600",富邦-嘉義,0,2,2,-1,3.03
"20201217","1783","1470","1470",台灣摩根士丹利,1,0,1,1,1.52
"20201217","1783","9863","9800",元大-和平,0,2,2,-1,3.03
"20201217","1783","0038003100350042","8150",台新-台中,1,0,1,1,1.52
"20201217","1783","003900380036004b","9800",元大-基隆孝二,0,2,2,-1,3.03
"20201218","1783","7798","7790",國票-內壢,10,0,10,1,16.67
"20201218","1783","9266","9200",凱基-新豐,0,5,5,-1,8.33
"20201218","1783","003900380030004b","9800",元大-竹科,5,0,5,1,8.33
"20201218","1783","9300","9300",華南永昌,0,5,5,-1,8.33
"20201218","1783","003900380031006a","9800",元大-士林,5,0,5,1,8.33
"20201218","1783","0039003200300041","9200",凱基-板橋,0,4,4,-1,6.67
"20201218","1783","0039003100330055","9100",群益金鼎-崇德,3,0,3,1,5.00
"20201218","1783","9616","9600",富邦-岡山,0,4,4,-1,6.67
"20201218","1783","0039003100380047","9100",群益金鼎-新莊,3,0,3,1,5.00
"20201218","1783","003500320036004b","5260",美好-富順,0,3,3,-1,5.00
"20201218","1783","8560","8560",新光,2,0,2,1,3.33
"20201218","1783","8440","8440",摩根大通,0,3,3,-1,5.00
"20201218","1783","003800380038004b","8880",國泰-板橋,2,0,2,1,3.33
"20201218","1783","9322","9300",華南永昌-公誠,0,3,3,-1,5.00
"20201218","1783","9875","9800",元大-土城永寧,2,0,2,1,3.33
"20201218","1783","9672","9600",富邦-員林,0,3,3,-1,5.00
"20201218","1783","0039004100360031","9A00",永豐金-鳳山,3,1,2,1,3.33
"20201218","1783","0039003800390067","9800",元大-嘉義,0,3,3,-1,5.00
"20201218","1783","003500390032006c","5920",元富-大裕,1,0,1,1,1.67
"20201218","1783","0038003800340048","8840",玉山-新竹,0,2,2,-1,3.33
"20201218","1783","5389","5380",第一金-中山,1,0,1,1,1.67
"20201218","1783","9871","9800",元大-忠孝,0,2,2,-1,3.33
"20201218","1783","1470","1470",台灣摩根士丹利,1,0,1,1,1.67
"20201218","1783","5265","5260",美好-苗栗,0,1,1,-1,1.67
"20201218","1783","5323","5320",高橋-內壢,1,0,1,1,1.67
"20201218","1783","1480","1480",美商高盛,0,1,1,-1,1.67
"20201218","1783","9103","9100",群益金鼎-松山,1,0,1,1,1.67
"20201218","1783","1440","1440",美林,0,1,1,-1,1.67
"20201221","1783","0035003800350055","5850",統一-南京,13,0,13,1,12.75
"20201221","1783","0037003000300058","7000",兆豐-永和,0,10,10,-1,9.80
"20201221","1783","9655","9600",富邦-板橋,10,0,10,1,9.80
"20201221","1783","9187","9100",群益金鼎-彰化,0,10,10,-1,9.80
"20201221","1783","9300","9300",華南永昌,6,0,6,1,5.88
"20201221","1783","0031003000340041","1040",臺銀-臺中,0,6,6,-1,5.88
"20201221","1783","1440","1440",美林,9,5,4,1,3.92
"20201221","1783","6110","6110",台中銀,0,6,6,-1,5.88
"20201221","1783","5323","5320",高橋-內壢,3,0,3,1,2.94
"20201221","1783","0036003300380041","6380",光和-嘉義,0,5,5,-1,4.90
"20201221","1783","1590","1590",花旗環球,3,0,3,1,2.94
"20201221","1783","0039003200300056","9200",凱基-新店,0,5,5,-1,4.90
"20201221","1783","0039003800310049","9800",元大-天母,3,0,3,1,2.94
"20201221","1783","0037003000300052","7000",兆豐-小港,0,4,4,-1,3.92
"20201221","1783","9875","9800",元大-土城永寧,3,0,3,1,2.94
"20201221","1783","9268","9200",凱基-台北,0,4,4,-1,3.92
"20201221","1783","8440","8440",摩根大通,2,0,2,1,1.96
"20201221","1783","9874","9800",元大-雙和,0,4,4,-1,3.92
"20201221","1783","9103","9100",群益金鼎-松山,2,0,2,1,1.96
"20201221","1783","9324","9300",華南永昌-岡山,0,3,3,-1,2.94
"20201221","1783","0039003100330055","9100",群益金鼎-崇德,2,0,2,1,1.96
"20201221","1783","5260","5260",美好,0,2,2,-1,1.96
"20201221","1783","0039003600310058","9600",富邦-大墩,2,0,2,1,1.96
"20201221","1783","0038003100350041","8150",台新-高雄,0,2,2,-1,1.96
"20201221","1783","9659","9600",富邦-高雄,2,0,2,1,1.96
"20201221","1783","003900320030004e","9200",凱基-湖口,0,2,2,-1,1.96
"20201221","1783","003900380030004b","9800",元大-竹科,2,0,2,1,1.96
"20201221","1783","9366","9300",華南永昌-豐原,0,2,2,-1,1.96
"20201222","1783","0039003800390064","9800",元大-北屯,15,0,15,1,10.79
"20201222","1783","9134","9100",群益金鼎-開元,0,20,20,-1,14.39
"20201222","1783","9187","9100",群益金鼎-彰化,10,0,10,1,7.19
"20201222","1783","8560","8560",新光,0,13,13,-1,9.35
"20201222","1783","9237","9200",凱基-敦北,9,0,9,1,6.47
"20201222","1783","003500380035004d","5850",統一-士林,0,6,6,-1,4.32
"20201222","1783","003900380030004b","9800",元大-竹科,7,0,7,1,5.04
"20201222","1783","9268","9200",凱基-台北,7,13,6,-1,4.32
"20201222","1783","9875","9800",元大-土城永寧,6,0,6,1,4.32
"20201222","1783","0039003800320042","9800",元大-博愛,0,6,6,-1,4.32
"20201222","1783","8886","8880",國泰-新莊,5,0,5,1,3.60
"20201222","1783","9686","9600",富邦-宜蘭,0,5,5,-1,3.60
"20201222","1783","0039004100390068","9A00",永豐金-台南,5,0,5,1,3.60
"20201222","1783","0039003800330057","9800",元大-大里德芳,0,5,5,-1,3.60
"20201222","1783","003800340035004a","8450",康和-高雄,4,0,4,1,2.88
"20201222","1783","9863","9800",元大-和平,0,5,5,-1,3.60
"20201222","1783","9252","9200",凱基-嘉義,4,0,4,1,2.88
"20201222","1783","6461","6460",大昌-樹林,0,4,4,-1,2.88
"20201222","1783","9300","9300",華南永昌,4,0,4,1,2.88
"20201222","1783","0031003000340044","1040",臺銀-金山,0,3,3,-1,2.16
"20201222","1783","7750","7750",北城證券,3,0,3,1,2.16
"20201222","1783","9692","9600",富邦-嘉義,0,3,3,-1,2.16
"20201222","1783","9211","9200",凱基-台南,3,0,3,1,2.16
"20201222","1783","8882","8880",國泰-台中,0,2,2,-1,1.44
"20201222","1783","9859","9800",元大-新竹經國,3,0,3,1,2.16
"20201222","1783","0039003100330067","9100",群益金鼎-三重,0,2,2,-1,1.44
"20201222","1783","003900380039005a","9800",元大-小港,3,0,3,1,2.16
"20201222","1783","0039004100390063","9A00",永豐金-永康,0,2,2,-1,1.44
"20201223","1783","0039003100380075","9100",群益金鼎-瑞豐,10,0,10,1,7.94
"20201223","1783","003900380031004e","9800",元大-金門,0,10,10,-1,7.94
"20201223","1783","0039003800310065","9800",元大-佳里,10,0,10,1,7.94
"20201223","1783","9863","9800",元大-和平,0,10,10,-1,7.94
"20201223","1783","003800380038004b","8880",國泰-板橋,8,0,8,1,6.35
"20201223","1783","9878","9800",元大-金華,0,10,10,-1,7.94
"20201223","1783","0039003100330048","9100",群益金鼎-屏東,8,0,8,1,6.35
"20201223","1783","0039003600310045","9600",富邦-府城,0,8,8,-1,6.35
"20201223","1783","9300","9300",華南永昌,6,0,6,1,4.76
"20201223","1783","9362","9300",華南永昌-苗栗,0,6,6,-1,4.76
"20201223","1783","8886","8880",國泰-新莊,5,0,5,1,3.97
"20201223","1783","8459","8450",康和-嘉義,0,4,4,-1,3.17
"20201223","1783","9135","9100",群益金鼎-東大,3,0,3,1,2.38
"20201223","1783","9672","9600",富邦-員林,0,4,4,-1,3.17
"20201223","1783","0031003200360055","1260",宏遠-館前,2,0,2,1,1.59
"20201223","1783","1440","1440",美林,1,4,3,-1,2.38
"20201223","1783","1119","1110",台灣企銀-岡山,2,0,2,1,1.59
"20201223","1783","1520","1520",瑞士信貸,0,3,3,-1,2.38
"20201223","1783","003500390032004e","5920",元富-虎尾,2,0,2,1,1.59
"20201223","1783","5384","5380",第一金-台南,0,3,3,-1,2.38
"20201223","1783","8560","8560",新光,2,0,2,1,1.59
"20201223","1783","9268","9200",凱基-台北,0,3,3,-1,2.38
"20201223","1783","8561","8560",新光-台中,2,0,2,1,1.59
"20201223","1783","0039003600310048","9600",富邦-新板,0,3,3,-1,2.38
"20201223","1783","9655","9600",富邦-板橋,2,0,2,1,1.59
"20201223","1783","9817","9800",元大-東泰,0,3,3,-1,2.38
"20201223","1783","9801","9800",元大-城東,2,0,2,1,1.59
"20201223","1783","003500330038006a","5380",第一金-安和,0,2,2,-1,1.59
"20201224","1783","6385","6380",光和-花壇,10,0,10,1,6.62
"20201224","1783","003900380030004b","9800",元大-竹科,0,15,15,-1,9.93
"20201224","1783","0039004100390068","9A00",永豐金-台南,8,0,8,1,5.30
"20201224","1783","2184","2180",亞東-新竹,0,13,13,-1,8.61
"20201224","1783","003500320036004b","5260",美好-富順,7,0,7,1,4.64
"20201224","1783","0039004100390052","9A00",永豐金-信義,0,10,10,-1,6.62
"20201224","1783","9300","9300",華南永昌,6,0,6,1,3.97
"20201224","1783","0039003100380047","9100",群益金鼎-新莊,8,17,9,-1,5.96
"20201224","1783","5263","5260",美好-泰山,5,0,5,1,3.31
"20201224","1783","9835","9800",元大-員林中山,0,6,6,-1,3.97
"20201224","1783","003700300030005a","7000",兆豐-高雄,5,0,5,1,3.31
"20201224","1783","9105","9100",群益金鼎-高盛,0,5,5,-1,3.31
"20201224","1783","8886","8880",國泰-新莊,5,0,5,1,3.31
"20201224","1783","0039003100330055","9100",群益金鼎-崇德,0,5,5,-1,3.31
"20201224","1783","8888","8880",國泰-敦南,5,0,5,1,3.31
"20201224","1783","9621","9600",富邦-花蓮,0,5,5,-1,3.31
"20201224","1783","5854","5850",統一-城中,4,0,4,1,2.65
"20201224","1783","0031003200360051","1260",宏遠-高雄,0,3,3,-1,1.99
"20201224","1783","9252","9200",凱基-嘉義,4,0,4,1,2.65
"20201224","1783","1520","1520",瑞士信貸,0,3,3,-1,1.99
"20201224","1783","9817","9800",元大-東泰,4,0,4,1,2.65
"20201224","1783","9317","9300",華南永昌-林口,0,3,3,-1,1.99
"20201224","1783","0036003000310064","6010",(牛牛牛)亞-鑫豐,3,0,3,1,1.99
"20201224","1783","003900380039004c","9800",元大-成功,0,3,3,-1,1.99
"20201224","1783","0039004100360031","9A00",永豐金-鳳山,3,0,3,1,1.99
"20201224","1783","0039003800390050","9800",元大-敦南,2,5,3,-1,1.99
"20201224","1783","0039004100390045","9A00",永豐金-板橋,3,0,3,1,1.99
"20201224","1783","5960","5960",日茂,0,2,2,-1,1.32
"20201225","1783","9278","9200",凱基-永康,5,0,5,1,6.76
"20201225","1783","9655","9600",富邦-板橋,0,10,10,-1,13.51
"20201225","1783","9300","9300",華南永昌,5,0,5,1,6.76
"20201225","1783","9363","9300",華南永昌-彰化,0,7,7,-1,9.46
"20201225","1783","9875","9800",元大-土城永寧,5,0,5,1,6.76
"20201225","1783","003700300030005a","7000",兆豐-高雄,0,5,5,-1,6.76
"20201225","1783","0036003000310064","6010",(牛牛牛)亞-鑫豐,3,0,3,1,4.05
"20201225","1783","0039003100380047","9100",群益金鼎-新莊,2,7,5,-1,6.76
"20201225","1783","9138","9100",群益金鼎-中港,2,0,2,1,2.70
"20201225","1783","003800340035004a","8450",康和-高雄,0,4,4,-1,5.41
"20201225","1783","9274","9200",凱基-鳳山,2,0,2,1,2.70
"20201225","1783","0039003600330041","9600",富邦-八德,0,3,3,-1,4.05
"20201225","1783","9623","9600",富邦-台北,2,0,2,1,2.70
"20201225","1783","0039003800320041","9800",元大-羅東,0,3,3,-1,4.05
"20201225","1783","0039003600320042","9600",富邦-二林,2,0,2,1,2.70
"20201225","1783","0035003800350063","5850",統一-仁愛,0,2,2,-1,2.70
"20201225","1783","9817","9800",元大-東泰,2,0,2,1,2.70
"20201225","1783","0035003900320042","5920",元富-永和,0,2,2,-1,2.70
"20201225","1783","9835","9800",元大-員林中山,2,0,2,1,2.70
"20201225","1783","0031003200360055","1260",宏遠-館前,0,2,2,-1,2.70
"20201225","1783","0039004100390068","9A00",永豐金-台南,2,0,2,1,2.70
"20201225","1783","9891","9800",元大-永和,0,2,2,-1,2.70
"20201225","1783","1590","1590",花旗環球,1,0,1,1,1.35
"20201225","1783","8150","8150",台新證券,0,2,2,-1,2.70
"20201225","1783","1520","1520",瑞士信貸,1,0,1,1,1.35
"20201225","1783","5263","5260",美好-泰山,0,1,1,-1,1.35
"20201225","1783","0031003200360069","1260",宏遠-光隆,1,0,1,1,1.35
"20201225","1783","1480","1480",美商高盛,0,1,1,-1,1.35
"20201228","1783","1113","1110",台灣企銀-九如,10,0,10,1,10.75
"20201228","1783","003700300030005a","7000",兆豐-高雄,0,8,8,-1,8.60
"20201228","1783","1440","1440",美林,9,0,9,1,9.68
"20201228","1783","0039003600320044","9600",富邦-新莊,0,6,6,-1,6.45
"20201228","1783","1520","1520",瑞士信貸,6,0,6,1,6.45
"20201228","1783","9835","9800",元大-員林中山,0,6,6,-1,6.45
"20201228","1783","0037003000300068","7000",兆豐-三民,6,0,6,1,6.45
"20201228","1783","5262","5260",美好-楊梅,0,5,5,-1,5.38
"20201228","1783","9300","9300",華南永昌,6,0,6,1,6.45
"20201228","1783","0039003100330048","9100",群益金鼎-屏東,0,5,5,-1,5.38
"20201228","1783","0039004100390058","9A00",永豐金-竹科,5,0,5,1,5.38
"20201228","1783","9274","9200",凱基-鳳山,2,7,5,-1,5.38
"20201228","1783","1590","1590",花旗環球,4,0,4,1,4.30
"20201228","1783","9317","9300",華南永昌-林口,0,5,5,-1,5.38
"20201228","1783","9268","9200",凱基-台北,5,1,4,1,4.30
"20201228","1783","0039003600320042","9600",富邦-二林,0,5,5,-1,5.38
"20201228","1783","8157","8150",台新-左楠,2,0,2,1,2.15
"20201228","1783","9672","9600",富邦-員林,0,5,5,-1,5.38
"20201228","1783","0039003800310044","9800",元大-南投,2,0,2,1,2.15
"20201228","1783","9369","9300",華南永昌-三重,0,4,4,-1,4.30
"20201228","1783","1041","1040",臺銀-鳳山,1,0,1,1,1.08
"20201228","1783","003900360031004d","9600",富邦-木柵,0,3,3,-1,3.23
"20201228","1783","1040","1040",臺銀,1,0,1,1,1.08
"20201228","1783","1119","1110",台灣企銀-岡山,0,2,2,-1,2.15
"20201228","1783","0031003000320041","1020",合庫-新竹,1,0,1,1,1.08
"20201228","1783","8840","8840",玉山證券,0,2,2,-1,2.15
"20201228","1783","1480","1480",美商高盛,1,0,1,1,1.08
"20201228","1783","8843","8840",玉山-高雄,0,2,2,-1,2.15
"20201229","1783","9300","9300",華南永昌,17,2,15,1,12.10
"20201229","1783","9366","9300",華南永昌-豐原,0,12,12,-1,9.68
"20201229","1783","9875","9800",元大-土城永寧,9,0,9,1,7.26
"20201229","1783","6460","6460",大昌,0,7,7,-1,5.65
"20201229","1783","003900380031006d","9800",元大-前金,7,0,7,1,5.65
"20201229","1783","9636","9600",富邦-中壢,0,7,7,-1,5.65
"20201229","1783","003900380039004c","9800",元大-成功,5,0,5,1,4.03
"20201229","1783","0039003800320042","9800",元大-博愛,0,5,5,-1,4.03
"20201229","1783","9268","9200",凱基-台北,6,2,4,1,3.23
"20201229","1783","9878","9800",元大-金華,0,5,5,-1,4.03
"20201229","1783","0039003800300044","9800",元大-北府,4,0,4,1,3.23
"20201229","1783","003900380039006a","9800",元大-樹林,0,5,5,-1,4.03
"20201229","1783","1590","1590",花旗環球,3,0,3,1,2.42
"20201229","1783","8455","8450",康和-台中,0,4,4,-1,3.23
"20201229","1783","6160","6160",中國信託,2,0,2,1,1.61
"20201229","1783","8560","8560",新光,0,4,4,-1,3.23
"20201229","1783","5854","5850",統一-城中,2,0,2,1,1.61
"20201229","1783","003500390032005a","5920",元富-安南,2,5,3,-1,2.42
"20201229","1783","1520","1520",瑞士信貸,2,0,2,1,1.61
"20201229","1783","5268","5260",美好-台南,0,3,3,-1,2.42
"20201229","1783","7750","7750",北城證券,2,0,2,1,1.61
"20201229","1783","0039003800300064","9800",元大-沙鹿,0,3,3,-1,2.42
"20201229","1783","8561","8560",新光-台中,2,0,2,1,1.61
"20201229","1783","0039003800390051","9800",元大-汐止,0,3,3,-1,2.42
"20201229","1783","0039003100380047","9100",群益金鼎-新莊,5,3,2,1,1.61
"20201229","1783","5923","5920",元富-三重,0,2,2,-1,1.61
"20201229","1783","9817","9800",元大-東泰,2,0,2,1,1.61
"20201229","1783","0039003600310053","9600",富邦-景美,0,2,2,-1,1.61
"20201230","1783","8560","8560",新光,16,0,16,1,14.29
"20201230","1783","0039003800300051","9800",元大-南崁,0,25,25,-1,22.32
"20201230","1783","0035003900320057","5920",元富-吉利,13,0,13,1,11.61
"20201230","1783","003500330038004d","5380",第一金-嘉義,0,9,9,-1,8.04
"20201230","1783","9875","9800",元大-土城永寧,9,0,9,1,8.04
"20201230","1783","0035003900320075","5920",元富-世貿,0,5,5,-1,4.46
"20201230","1783","0035003800350055","5850",統一-南京,8,0,8,1,7.14
"20201230","1783","0038003800340042","8840",玉山-台中,0,5,5,-1,4.46
"20201230","1783","9268","9200",凱基-台北,8,0,8,1,7.14
"20201230","1783","9359","9300",華南永昌-中正,0,5,5,-1,4.46
"20201230","1783","1520","1520",瑞士信貸,4,0,4,1,3.57
"20201230","1783","0039003100380047","9100",群益金鼎-新莊,1,5,4,-1,3.57
"20201230","1783","1480","1480",美商高盛,4,0,4,1,3.57
"20201230","1783","0031003100310042","1110",台灣企銀-建成,0,2,2,-1,1.79
"20201230","1783","0038003100350042","8150",台新-台中,4,0,4,1,3.57
"20201230","1783","003500390032006d","5920",元富-成功,0,2,2,-1,1.79
"20201230","1783","9300","9300",華南永昌,4,0,4,1,3.57
"20201230","1783","5382","5380",第一金-台中,0,2,2,-1,1.79
"20201230","1783","003900380039004c","9800",元大-成功,3,0,3,1,2.68
"20201230","1783","0037003700390072","7790",國票-桃園,0,2,2,-1,1.79
"20201230","1783","2181","2180",亞東-板橋,2,0,2,1,1.79
"20201230","1783","0039003600310046","9600",富邦-中港,0,2,2,-1,1.79
"20201230","1783","8440","8440",摩根大通,2,0,2,1,1.79
"20201230","1783","9817","9800",元大-東泰,0,2,2,-1,1.79
"20201230","1783","003800380038004b","8880",國泰-板橋,2,0,2,1,1.79
"20201230","1783","9867","9800",元大-北成功,0,2,2,-1,1.79
"20201230","1783","0039003800310049","9800",元大-天母,2,0,2,1,1.79
"20201230","1783","0039003800390055","9800",元大-大甲,0,2,2,-1,1.79
"20201231","1783","9268","9200",凱基-台北,19,4,15,1,13.16
"20201231","1783","003500390032006c","5920",元富-大裕,0,10,10,-1,8.77
"20201231","1783","9300","9300",華南永昌,10,0,10,1,8.77
"20201231","1783","0035003800350055","5850",統一-南京,0,8,8,-1,7.02
"20201231","1783","0039003800300064","9800",元大-沙鹿,10,0,10,1,8.77
"20201231","1783","9817","9800",元大-東泰,0,8,8,-1,7.02
"20201231","1783","9303","9300",華南永昌-高雄,7,0,7,1,6.14
"20201231","1783","0035003800350048","5850",統一-桃園,0,7,7,-1,6.14
"20201231","1783","003900320030004d","9200",凱基-宜蘭,6,0,6,1,5.26
"20201231","1783","9105","9100",群益金鼎-高盛,0,5,5,-1,4.39
"20201231","1783","0039003100330048","9100",群益金鼎-屏東,5,0,5,1,4.39
"20201231","1783","0039003800390050","9800",元大-敦南,0,5,5,-1,4.39
"20201231","1783","0039003100380047","9100",群益金鼎-新莊,4,0,4,1,3.51
"20201231","1783","003500320036004b","5260",美好-富順,0,4,4,-1,3.51
"20201231","1783","003900380039004c","9800",元大-成功,4,0,4,1,3.51
"20201231","1783","0036003000310064","6010",(牛牛牛)亞-鑫豐,0,4,4,-1,3.51
"20201231","1783","0035003900320055","5920",元富-宜蘭,3,0,3,1,2.63
"20201231","1783","9252","9200",凱基-嘉義,0,4,4,-1,3.51
"20201231","1783","0035003300380045","5380",第一金-自由,2,0,2,1,1.75
"20201231","1783","0039003100380044","9100",群益金鼎-東門,0,3,3,-1,2.63
"20201231","1783","0039003800310056","9800",元大-民雄,2,0,2,1,1.75
"20201231","1783","0039003800390061","9800",元大-苑裡,0,3,3,-1,2.63
"20201231","1783","0039003800390057","9800",元大-豐原站前,2,0,2,1,1.75
"20201231","1783","5660","5660",日進,0,2,2,-1,1.75
"20201231","1783","8885","8880",國泰-桃園,1,0,1,1,0.88
"20201231","1783","6950","6950",福勝,0,2,2,-1,1.75
"20201231","1783","1520","1520",瑞士信貸,1,0,1,1,0.88
"20201231","1783","0037003000300043","7000",兆豐-來福,0,2,2,-1,1.75
"20201102","1783","9268","9200",凱基-台北,14,7,7,1,10.94
"20201102","1783","1470","1470",台灣摩根士丹利,0,8,8,-1,12.50
"20201102","1783","9892","9800",元大-屏東,7,0,7,1,10.94
"20201102","1783","0037003700390072","7790",國票-桃園,0,2,2,-1,3.13
"20201102","1783","2187","2180",亞東-台中,6,0,6,1,9.38
"20201102","1783","7034","7030",致和-金華,0,2,2,-1,3.13
"20201102","1783","0039004100390038","9A00",永豐金-大園,4,0,4,1,6.25
"20201102","1783","003500390032006e","5920",元富-西松,1,3,2,-1,3.13
"20201102","1783","8842","8840",玉山-新莊,2,0,2,1,3.13
"20201102","1783","0038003100350042","8150",台新-台中,0,2,2,-1,3.13
"20201102","1783","9134","9100",群益金鼎-開元,2,0,2,1,3.13
"20201102","1783","0038003100350059","8150",台新-新營,0,2,2,-1,3.13
"20201102","1783","9229","9200",凱基-中山,2,0,2,1,3.13
"20201102","1783","8880","8880",國泰證券,0,2,2,-1,3.13
"20201102","1783","9326","9300",華南永昌-南京,1,0,1,1,1.56
"20201102","1783","8882","8880",國泰-台中,0,2,2,-1,3.13
"20201102","1783","1520","1520",瑞士信貸,1,0,1,1,1.56
"20201102","1783","0039003100380047","9100",群益金鼎-新莊,0,2,2,-1,3.13
"20201102","1783","003500390032006d","5920",元富-成功,1,0,1,1,1.56
"20201102","1783","9817","9800",元大-東泰,0,2,2,-1,3.13
"20201102","1783","0035003900320065","5920",元富-古亭,1,0,1,1,1.56
"20201102","1783","003900380039006a","9800",元大-樹林,0,2,2,-1,3.13
"20201102","1783","0038003400350044","8450",康和-板橋,1,0,1,1,1.56
"20201102","1783","0035003800350044","5850",統一-新台中,1,2,1,-1,1.56
"20201102","1783","9257","9200",凱基-林口,1,0,1,1,1.56
"20201102","1783","003500330038006a","5380",第一金-安和,0,1,1,-1,1.56
"20201102","1783","0039003600310043","9600",富邦-南京,1,0,1,1,1.56
"20201102","1783","5387","5380",第一金-澎湖,0,1,1,-1,1.56
"20201103","1783","9268","9200",凱基-台北,5,1,4,1,12.12
"20201103","1783","9302","9300",華南永昌-台中,0,3,3,-1,9.09
"20201103","1783","0039003800390065","9800",元大-中和,3,0,3,1,9.09
"20201103","1783","0035003900320061","5920",元富-松德,0,2,2,-1,6.06
"20201103","1783","9326","9300",華南永昌-南京,2,0,2,1,6.06
"20201103","1783","9257","9200",凱基-林口,0,2,2,-1,6.06
"20201103","1783","9377","9300",華南永昌-虎尾,2,0,2,1,6.06
"20201103","1783","0039003600320045","9600",富邦-樹林,0,2,2,-1,6.06
"20201103","1783","003900380031006e","9800",元大-旗山,2,0,2,1,6.06
"20201103","1783","9817","9800",元大-東泰,0,2,2,-1,6.06
"20201103","1783","9672","9600",富邦-員林,1,0,1,1,3.03
"20201103","1783","0039003800390047","9800",元大-大同,0,2,2,-1,6.06
"20201103","1783","0037003000300047","7000",兆豐-麻豆,1,0,1,1,3.03
"20201103","1783","1233","1230",彰銀-台中,0,1,1,-1,3.03
"20201103","1783","5323","5320",高橋-內壢,1,0,1,1,3.03
"20201103","1783","5386","5380",第一金-彰化,0,1,1,-1,3.03
"20201103","1783","1590","1590",花旗環球,1,0,1,1,3.03
"20201103","1783","6381","6380",光和-溪湖,0,1,1,-1,3.03
"20201103","1783","1520","1520",瑞士信貸,1,0,1,1,3.03
"20201103","1783","003600310036004b","6160",中國信託-高雄,0,1,1,-1,3.03
"20201103","1783","0035003800350044","5850",統一-新台中,1,0,1,1,3.03
"20201103","1783","0036003000310064","6010",(牛牛牛)亞-鑫豐,0,1,1,-1,3.03
"20201103","1783","7790","7790",國票證券,1,0,1,1,3.03
"20201103","1783","0035003900320053","5920",元富-基隆,0,1,1,-1,3.03
"20201103","1783","9625","9600",富邦-竹東,1,0,1,1,3.03
"20201103","1783","003700300030005a","7000",兆豐-高雄,0,1,1,-1,3.03
"20201103","1783","9800","9800",元大證券,1,0,1,1,3.03
"20201103","1783","0037003700390065","7790",國票-南科,0,1,1,-1,3.03
"20201104","1783","9268","9200",凱基-台北,14,7,7,1,10.00
"20201104","1783","003900360031004e","9600",富邦-西壢,0,10,10,-1,14.29
"20201104","1783","9817","9800",元大-東泰,6,0,6,1,8.57
"20201104","1783","9869","9800",元大-新盛,0,10,10,-1,14.29
"20201104","1783","003500330038006a","5380",第一金-安和,4,1,3,1,4.29
"20201104","1783","1470","1470",台灣摩根士丹利,0,4,4,-1,5.71
"20201104","1783","5961","5960",日茂-埔里,2,0,2,1,2.86
"20201104","1783","6462","6460",大昌-安康,0,3,3,-1,4.29
"20201104","1783","9105","9100",群益金鼎-高盛,2,0,2,1,2.86
"20201104","1783","5322","5320",高橋-中壢,0,3,3,-1,4.29
"20201104","1783","9208","9200",凱基-桃園,2,0,2,1,2.86
"20201104","1783","8885","8880",國泰-桃園,0,2,2,-1,2.86
"20201104","1783","9623","9600",富邦-台北,2,0,2,1,2.86
"20201104","1783","003900360035004b","9600",富邦-台中,0,2,2,-1,2.86
"20201104","1783","0037003000300049","7000",兆豐-北高雄,1,0,1,1,1.43
"20201104","1783","0039003800390051","9800",元大-汐止,0,2,2,-1,2.86
"20201104","1783","0038003100350041","8150",台新-高雄,1,0,1,1,1.43
"20201104","1783","0037003000300047","7000",兆豐-麻豆,0,1,1,-1,1.43
"20201104","1783","1022","1020",合庫-台南,1,0,1,1,1.43
"20201104","1783","0035003900320050","5920",元富-同大,0,1,1,-1,1.43
"20201104","1783","0038003800340046","8840",玉山-桃園,1,0,1,1,1.43
"20201104","1783","0035003900320044","5920",元富-大昌,0,1,1,-1,1.43
"20201104","1783","0039003100330059","9100",群益金鼎-館前,1,0,1,1,1.43
"20201104","1783","1440","1440",美林,0,1,1,-1,1.43
"20201104","1783","9206","9200",凱基-高雄,1,0,1,1,1.43
"20201104","1783","9211","9200",凱基-台南,0,1,1,-1,1.43
"20201104","1783","9316","9300",華南永昌-淡水,1,0,1,1,1.43
"20201104","1783","9322","9300",華南永昌-公誠,0,1,1,-1,1.43
"20201105","1783","8880","8880",國泰證券,8,0,8,1,12.31
"20201105","1783","0039003800330056","9800",元大-竹南,0,6,6,-1,9.23
"20201105","1783","5384","5380",第一金-台南,4,0,4,1,6.15
"20201105","1783","0039003100380075","9100",群益金鼎-瑞豐,0,5,5,-1,7.69
"20201105","1783","0039003600310045","9600",富邦-府城,4,0,4,1,6.15
"20201105","1783","0035003900320042","5920",元富-永和,0,4,4,-1,6.15
"20201105","1783","5323","5320",高橋-內壢,2,0,2,1,3.08
"20201105","1783","9817","9800",元大-東泰,0,4,4,-1,6.15
"20201105","1783","6114","6110",台中銀-員林,2,0,2,1,3.08
"20201105","1783","0031003200360048","1260",宏遠-中和,0,3,3,-1,4.62
"20201105","1783","9134","9100",群益金鼎-開元,2,0,2,1,3.08
"20201105","1783","9283","9200",凱基-北門,1,4,3,-1,4.62
"20201105","1783","5603","5600",永興-台中,1,0,1,1,1.54
"20201105","1783","9666","9600",富邦-南屯,0,3,3,-1,4.62
"20201105","1783","7033","7030",致和-府前,1,0,1,1,1.54
"20201105","1783","003500330038006a","5380",第一金-安和,0,2,2,-1,3.08
"20201105","1783","0039003200310059","9200",凱基-東勢,1,0,1,1,1.54
"20201105","1783","1040","1040",臺銀,0,2,2,-1,3.08
"20201105","1783","9268","9200",凱基-台北,2,1,1,1,1.54
"20201105","1783","0035003800350052","5850",統一-汐止,0,2,2,-1,3.08
"20201105","1783","0039003600320056","9600",富邦-復興,1,0,1,1,1.54
"20201105","1783","0035003900320050","5920",元富-同大,0,2,2,-1,3.08
"20201105","1783","5265","5260",美好-苗栗,0,0,0,1,0.00
"20201105","1783","0036003000310064","6010",(牛牛牛)亞-鑫豐,0,2,2,-1,3.08
"20201105","1783","8888","8880",國泰-敦南,0,0,0,1,0.00
"20201105","1783","0037003700390065","7790",國票-南科,0,2,2,-1,3.08
"20201105","1783","9334","9300",華南永昌-世貿,0,0,0,1,0.00
"20201105","1783","003900380033006a","9800",元大-仁愛,0,2,2,-1,3.08
"20201106","1783","0035003900320057","5920",元富-吉利,11,0,11,1,12.22
"20201106","1783","0039003600310048","9600",富邦-新板,0,10,10,-1,11.11
"20201106","1783","0039003100330059","9100",群益金鼎-館前,10,0,10,1,11.11
"20201106","1783","0038003800380041","8880",國泰-館前,0,5,5,-1,5.56
"20201106","1783","9315","9300",華南永昌-苑裡,10,0,10,1,11.11
"20201106","1783","1021","1020",合庫-台中,0,5,5,-1,5.56
"20201106","1783","9268","9200",凱基-台北,9,2,7,1,7.78
"20201106","1783","9349","9300",華南永昌-板橋,0,4,4,-1,4.44
"20201106","1783","0039003800330057","9800",元大-大里德芳,3,0,3,1,3.33
"20201106","1783","0039003800390065","9800",元大-中和,1,4,3,-1,3.33
"20201106","1783","7795","7790",國票-南港,2,0,2,1,2.22
"20201106","1783","5269","5260",美好-台中,0,2,2,-1,2.22
"20201106","1783","0038003800340044","8840",玉山-左營,2,0,2,1,2.22
"20201106","1783","6451","6450",永全-南崁,0,1,1,-1,1.11
"20201106","1783","9287","9200",凱基-內湖,2,0,2,1,2.22
"20201106","1783","0039003100380045","9100",群益金鼎-南京,0,1,1,-1,1.11
"20201106","1783","9817","9800",元大-東泰,2,0,2,1,2.22
"20201106","1783","0039003600310058","9600",富邦-大墩,0,1,1,-1,1.11
"20201106","1783","0039003800310047","9800",元大-彰化,2,0,2,1,2.22
"20201106","1783","9655","9600",富邦-板橋,0,1,1,-1,1.11
"20201106","1783","0039003800330047","9800",元大-上新莊,2,0,2,1,2.22
"20201106","1783","0039003800300043","9800",元大-斗六,0,1,1,-1,1.11
"20201106","1783","1034","1030",土銀-嘉義,1,0,1,1,1.11
"20201106","1783","003900380031006d","9800",元大-前金,0,1,1,-1,1.11
"20201106","1783","003500320036004b","5260",美好-富順,1,0,1,1,1.11
"20201106","1783","9893","9800",元大-大天母,0,1,1,-1,1.11
"20201106","1783","0035003900320071","5920",元富-屏東,1,0,1,1,1.11
"20201106","1783","003900380039004e","9800",元大-內湖,0,1,1,-1,1.11
"20201109","1783","0039004100390038","9A00",永豐金-大園,20,0,20,1,18.52
"20201109","1783","9302","9300",華南永昌-台中,0,10,10,-1,9.26
"20201109","1783","9268","9200",凱基-台北,12,5,7,1,6.48
"20201109","1783","9623","9600",富邦-台北,1,10,9,-1,8.33
"20201109","1783","9233","9200",凱基-長庚,3,0,3,1,2.78
"20201109","1783","0039003800310061","9800",元大-歸仁,0,6,6,-1,5.56
"20201109","1783","003900360035004b","9600",富邦-台中,3,0,3,1,2.78
"20201109","1783","9695","9600",富邦-民雄(停),0,5,5,-1,4.63
"20201109","1783","003900380039005a","9800",元大-小港,3,0,3,1,2.78
"20201109","1783","9856","9800",元大-花蓮,0,5,5,-1,4.63
"20201109","1783","1520","1520",瑞士信貸,2,0,2,1,1.85
"20201109","1783","0035003300380050","5380",第一金-路竹,0,4,4,-1,3.70
"20201109","1783","8880","8880",國泰證券,2,0,2,1,1.85
"20201109","1783","8888","8880",國泰-敦南,0,3,3,-1,2.78
"20201109","1783","9134","9100",群益金鼎-開元,2,0,2,1,1.85
"20201109","1783","9898","9800",元大-新莊,0,3,3,-1,2.78
"20201109","1783","0039003800310047","9800",元大-彰化,2,0,2,1,1.85
"20201109","1783","0039003800390051","9800",元大-汐止,0,3,3,-1,2.78
"20201109","1783","003900410039004a","9A00",永豐金-板新,2,0,2,1,1.85
"20201109","1783","0035003900320075","5920",元富-世貿,0,2,2,-1,1.85
"20201109","1783","0035003900320071","5920",元富-屏東,1,0,1,1,0.93
"20201109","1783","0036003000310064","6010",(牛牛牛)亞-鑫豐,0,2,2,-1,1.85
"20201109","1783","1440","1440",美林,4,3,1,1,0.93
"20201109","1783","0035003800350044","5850",統一-新台中,0,2,2,-1,1.85
"20201109","1783","5660","5660",日進,1,0,1,1,0.93
"20201109","1783","1560","1560",港商野村,0,2,2,-1,1.85
"20201109","1783","0037003000300043","7000",兆豐-來福,1,0,1,1,0.93
"20201109","1783","0031003000320045","1020",合庫-桃園,0,2,2,-1,1.85
"20201110","1783","9315","9300",華南永昌-苑裡,20,0,20,1,9.48
"20201110","1783","2184","2180",亞東-新竹,0,28,28,-1,13.27
"20201110","1783","9101","9100",群益金鼎-敦南,10,0,10,1,4.74
"20201110","1783","9209","9200",凱基-岡山,1,20,19,-1,9.00
"20201110","1783","0039003800330057","9800",元大-大里德芳,9,0,9,1,4.27
"20201110","1783","1440","1440",美林,1,17,16,-1,7.58
"20201110","1783","1233","1230",彰銀-台中,5,0,5,1,2.37
"20201110","1783","9268","9200",凱基-台北,14,27,13,-1,6.16
"20201110","1783","0037003000300058","7000",兆豐-永和,5,0,5,1,2.37
"20201110","1783","0035003900320079","5920",元富-花蓮,0,11,11,-1,5.21
"20201110","1783","9672","9600",富邦-員林,5,0,5,1,2.37
"20201110","1783","9677","9600",富邦-三重,0,11,11,-1,5.21
"20201110","1783","9894","9800",元大-桃興,5,0,5,1,2.37
"20201110","1783","0039003600310045","9600",富邦-府城,0,10,10,-1,4.74
"20201110","1783","1021","1020",合庫-台中,4,0,4,1,1.90
"20201110","1783","9856","9800",元大-花蓮,0,9,9,-1,4.27
"20201110","1783","0039003600320042","9600",富邦-二林,4,0,4,1,1.90
"20201110","1783","0038003400350044","8450",康和-板橋,2,7,5,-1,2.37
"20201110","1783","5322","5320",高橋-中壢,3,0,3,1,1.42
"20201110","1783","9693","9600",富邦-新營,0,4,4,-1,1.90
"20201110","1783","9105","9100",群益金鼎-高盛,3,0,3,1,1.42
"20201110","1783","0039003800340045","9800",元大-南勢角,0,4,4,-1,1.90
"20201110","1783","0039003800390041","9800",元大-北投,3,0,3,1,1.42
"20201110","1783","0031003200360055","1260",宏遠-館前,0,3,3,-1,1.42
"20201110","1783","0039004100380046","9A00",永豐金-敦南,3,0,3,1,1.42
"20201110","1783","003900320031004d","9200",凱基-八德,0,3,3,-1,1.42
"20201110","1783","9208","9200",凱基-桃園,2,0,2,1,0.95
"20201110","1783","1560","1560",港商野村,0,2,2,-1,0.95
"20201111","1783","0039003800300043","9800",元大-斗六,6,0,6,1,5.50
"20201111","1783","9856","9800",元大-花蓮,0,13,13,-1,11.93
"20201111","1783","9211","9200",凱基-台南,4,1,3,1,2.75
"20201111","1783","8560","8560",新光,0,5,5,-1,4.59
"20201111","1783","9268","9200",凱基-台北,7,4,3,1,2.75
"20201111","1783","0039003200300047","9200",凱基-彰化,0,5,5,-1,4.59
"20201111","1783","1520","1520",瑞士信貸,2,0,2,1,1.83
"20201111","1783","003900320030005a","9200",凱基-台東,0,5,5,-1,4.59
"20201111","1783","9319","9300",華南永昌-鶯歌,2,0,2,1,1.83
"20201111","1783","2184","2180",亞東-新竹,0,4,4,-1,3.67
"20201111","1783","9322","9300",華南永昌-公誠,2,0,2,1,1.83
"20201111","1783","0035003900320071","5920",元富-屏東,0,4,4,-1,3.67
"20201111","1783","0035003800350044","5850",統一-新台中,1,0,1,1,0.92
"20201111","1783","9897","9800",元大-土城,0,4,4,-1,3.67
"20201111","1783","6463","6460",大昌-新竹,1,0,1,1,0.92
"20201111","1783","0035003900320050","5920",元富-同大,0,3,3,-1,2.75
"20201111","1783","0037003000300055","7000",兆豐-桃鶯,1,0,1,1,0.92
"20201111","1783","0039003100380067","9100",群益金鼎-大甲,0,3,3,-1,2.75
"20201111","1783","0038003100350041","8150",台新-高雄,1,0,1,1,0.92
"20201111","1783","9317","9300",華南永昌-林口,0,3,3,-1,2.75
"20201111","1783","0038003800340046","8840",玉山-桃園,1,0,1,1,0.92
"20201111","1783","9604","9600",富邦-陽明,0,3,3,-1,2.75
"20201111","1783","0039003200300057","9200",凱基-大里,1,0,1,1,0.92
"20201111","1783","0039003800310061","9800",元大-歸仁,0,3,3,-1,2.75
"20201111","1783","9816","9800",元大-新竹,1,0,1,1,0.92
"20201111","1783","5384","5380",第一金-台南,0,2,2,-1,1.83
"20201111","1783","9833","9800",元大-敦化,1,0,1,1,0.92
"20201111","1783","5857","5850",統一-新竹,0,2,2,-1,1.83
"20201112","1783","5922","5920",元富-新店,7,0,7,1,10.00
"20201112","1783","0039003800310053","9800",元大-崇德,0,10,10,-1,14.29
"20201112","1783","003500330038006a","5380",第一金-安和,3,0,3,1,4.29
"20201112","1783","003900380031004d","9800",元大-苗栗,0,5,5,-1,7.14
"20201112","1783","0039003200300041","9200",凱基-板橋,3,0,3,1,4.29
"20201112","1783","9838","9800",元大-豐原,0,3,3,-1,4.29
"20201112","1783","9654","9600",富邦-永和,3,0,3,1,4.29
"20201112","1783","9856","9800",元大-花蓮,0,3,3,-1,4.29
"20201112","1783","0039003800300043","9800",元大-斗六,3,0,3,1,4.29
"20201112","1783","5263","5260",美好-泰山,0,2,2,-1,2.86
"20201112","1783","003900410039004a","9A00",永豐金-板新,3,0,3,1,4.29
"20201112","1783","0039003800320043","9800",元大-六合,0,2,2,-1,2.86
"20201112","1783","8560","8560",新光,2,0,2,1,2.86
"20201112","1783","9853","9800",元大-南屯,0,2,2,-1,2.86
"20201112","1783","9817","9800",元大-東泰,2,0,2,1,2.86
"20201112","1783","0037003000300047","7000",兆豐-麻豆,0,1,1,-1,1.43
"20201112","1783","9874","9800",元大-雙和,2,0,2,1,2.86
"20201112","1783","1021","1020",合庫-台中,0,1,1,-1,1.43
"20201112","1783","0038003100350059","8150",台新-新營,1,0,1,1,1.43
"20201112","1783","003500380035005a","5850",統一-松江,0,1,1,-1,1.43
"20201112","1783","0037003700390050","7790",國票-九鼎,1,0,1,1,1.43
"20201112","1783","5262","5260",美好-楊梅,0,1,1,-1,1.43
"20201112","1783","8842","8840",玉山-新莊,1,0,1,1,1.43
"20201112","1783","1480","1480",美商高盛,0,1,1,-1,1.43
"20201112","1783","9100","9100",群益金鼎,1,0,1,1,1.43
"20201112","1783","8880","8880",國泰證券,0,1,1,-1,1.43
"20201112","1783","9131","9100",群益金鼎-民權,1,0,1,1,1.43
"20201112","1783","8888","8880",國泰-敦南,0,1,1,-1,1.43
"20201113","1783","0039003600310045","9600",富邦-府城,8,0,8,1,6.56
"20201113","1783","9324","9300",華南永昌-岡山,0,12,12,-1,9.84
"20201113","1783","1520","1520",瑞士信貸,7,0,7,1,5.74
"20201113","1783","0035003900320044","5920",元富-大昌,0,5,5,-1,4.10
"20201113","1783","1560","1560",港商野村,6,0,6,1,4.92
"20201113","1783","003500330038006a","5380",第一金-安和,0,5,5,-1,4.10
"20201113","1783","8156","8150",台新-三民,5,0,5,1,4.10
"20201113","1783","6114","6110",台中銀-員林,0,5,5,-1,4.10
"20201113","1783","9257","9200",凱基-林口,4,0,4,1,3.28
"20201113","1783","9623","9600",富邦-台北,1,6,5,-1,4.10
"20201113","1783","0039003800390044","9800",元大-左營,3,0,3,1,2.46
"20201113","1783","9838","9800",元大-豐原,0,5,5,-1,4.10
"20201113","1783","1440","1440",美林,2,0,2,1,1.64
"20201113","1783","1021","1020",合庫-台中,0,4,4,-1,3.28
"20201113","1783","0039003800380043","9800",元大-三重,2,0,2,1,1.64
"20201113","1783","9208","9200",凱基-桃園,0,4,4,-1,3.28
"20201113","1783","8710","8710",陽信,1,0,1,1,0.82
"20201113","1783","9369","9300",華南永昌-三重,0,4,4,-1,3.28
"20201113","1783","8888","8880",國泰-敦南,2,1,1,1,0.82
"20201113","1783","8581","8580",聯邦-高雄,0,3,3,-1,2.46
"20201113","1783","0039003200310046","9200",凱基-天母,1,0,1,1,0.82
"20201113","1783","0039003200300041","9200",凱基-板橋,0,3,3,-1,2.46
"20201113","1783","9268","9200",凱基-台北,5,4,1,1,0.82
"20201113","1783","0035003900320079","5920",元富-花蓮,0,2,2,-1,1.64
"20201113","1783","9655","9600",富邦-板橋,1,0,1,1,0.82
"20201113","1783","0036003000310064","6010",(牛牛牛)亞-鑫豐,0,2,2,-1,1.64
"20201113","1783","9871","9800",元大-忠孝,1,0,1,1,0.82
"20201113","1783","0038003100350059","8150",台新-新營,0,2,2,-1,1.64
"20201116","1783","9800","9800",元大證券,25,0,25,1,11.96
"20201116","1783","9315","9300",華南永昌-苑裡,0,20,20,-1,9.57
"20201116","1783","6385","6380",光和-花壇,24,0,24,1,11.48
"20201116","1783","8842","8840",玉山-新莊,0,13,13,-1,6.22
"20201116","1783","8886","8880",國泰-新莊,10,0,10,1,4.78
"20201116","1783","9285","9200",凱基-中壢,0,13,13,-1,6.22
"20201116","1783","9813","9800",元大-八德,10,0,10,1,4.78
"20201116","1783","9672","9600",富邦-員林,0,10,10,-1,4.78
"20201116","1783","6167","6160",中國信託-松江,8,1,7,1,3.35
"20201116","1783","0039003800310053","9800",元大-崇德,0,10,10,-1,4.78
"20201116","1783","1520","1520",瑞士信貸,6,0,6,1,2.87
"20201116","1783","2187","2180",亞東-台中,0,8,8,-1,3.83
"20201116","1783","0039003600320047","9600",富邦-斗六,6,0,6,1,2.87
"20201116","1783","9257","9200",凱基-林口,0,7,7,-1,3.35
"20201116","1783","1042","1040",臺銀-臺南,5,0,5,1,2.39
"20201116","1783","1440","1440",美林,1,7,6,-1,2.87
"20201116","1783","0038003100350041","8150",台新-高雄,5,0,5,1,2.39
"20201116","1783","5323","5320",高橋-內壢,0,4,4,-1,1.91
"20201116","1783","9208","9200",凱基-桃園,10,5,5,1,2.39
"20201116","1783","8882","8880",國泰-台中,0,4,4,-1,1.91
"20201116","1783","7791","7790",國票-台東,4,0,4,1,1.91
"20201116","1783","0039003600320042","9600",富邦-二林,0,4,4,-1,1.91
"20201116","1783","1590","1590",花旗環球,3,0,3,1,1.44
"20201116","1783","5263","5260",美好-泰山,0,3,3,-1,1.44
"20201116","1783","9278","9200",凱基-永康,3,0,3,1,1.44
"20201116","1783","0039003100380045","9100",群益金鼎-南京,0,3,3,-1,1.44
"20201116","1783","0031003000330043","1030",土銀-白河,2,0,2,1,0.96
"20201116","1783","003900380031006e","9800",元大-旗山,0,3,3,-1,1.44
"20201117","1783","9268","9200",凱基-台北,15,3,12,1,11.65
"20201117","1783","0039003100330059","9100",群益金鼎-館前,0,10,10,-1,9.71
"20201117","1783","9343","9300",華南永昌-頭份,10,0,10,1,9.71
"20201117","1783","9838","9800",元大-豐原,0,10,10,-1,9.71
"20201117","1783","6385","6380",光和-花壇,5,0,5,1,4.85
"20201117","1783","5922","5920",元富-新店,0,7,7,-1,6.80
"20201117","1783","0037003000300050","7000",兆豐-南京,5,0,5,1,4.85
"20201117","1783","0039003800330057","9800",元大-大里德芳,0,7,7,-1,6.80
"20201117","1783","0039003600320046","9600",富邦-北桃園(停),5,0,5,1,4.85
"20201117","1783","0039003100330049","9100",群益金鼎-萬華,0,5,5,-1,4.85
"20201117","1783","0039003800310046","9800",元大-福營,5,0,5,1,4.85
"20201117","1783","0038003400350055","8450",康和-台北,0,3,3,-1,2.91
"20201117","1783","1480","1480",美商高盛,3,0,3,1,2.91
"20201117","1783","0039003100380043","9100",群益金鼎-古亭,0,3,3,-1,2.91
"20201117","1783","8848","8840",玉山-嘉義,3,0,3,1,2.91
"20201117","1783","0035003300380057","5380",第一金-華江,0,2,2,-1,1.94
"20201117","1783","0039003800300043","9800",元大-斗六,3,0,3,1,2.91
"20201117","1783","6167","6160",中國信託-松江,1,3,2,-1,1.94
"20201117","1783","003900380031006e","9800",元大-旗山,3,0,3,1,2.91
"20201117","1783","6110","6110",台中銀,0,2,2,-1,1.94
"20201117","1783","5387","5380",第一金-澎湖,2,0,2,1,1.94
"20201117","1783","9377","9300",華南永昌-虎尾,0,2,2,-1,1.94
"20201117","1783","1440","1440",美林,3,1,2,1,1.94
"20201117","1783","0039003600310045","9600",富邦-府城,0,2,2,-1,1.94
"20201117","1783","0035003900320045","5920",元富-城中,2,0,2,1,1.94
"20201117","1783","9817","9800",元大-東泰,0,2,2,-1,1.94
"20201117","1783","9647","9600",富邦-新竹,2,0,2,1,1.94
"20201117","1783","0039003800390050","9800",元大-敦南,0,2,2,-1,1.94
"20201118","1783","9343","9300",華南永昌-頭份,10,0,10,1,13.51
"20201118","1783","9302","9300",華南永昌-台中,0,5,5,-1,6.76
"20201118","1783","0039003800310046","9800",元大-福營,10,0,10,1,13.51
"20201118","1783","8380","8380",安泰,0,4,4,-1,5.41
"20201118","1783","9211","9200",凱基-台南,6,0,6,1,8.11
"20201118","1783","9208","9200",凱基-桃園,0,4,4,-1,5.41
"20201118","1783","0039003800390044","9800",元大-左營,6,0,6,1,8.11
"20201118","1783","0039003800390045","9800",元大-草屯,0,4,4,-1,5.41
"20201118","1783","1520","1520",瑞士信貸,5,0,5,1,6.76
"20201118","1783","1043","1040",臺銀-民權,0,3,3,-1,4.05
"20201118","1783","9659","9600",富邦-高雄,6,1,5,1,6.76
"20201118","1783","8848","8840",玉山-嘉義,0,3,3,-1,4.05
"20201118","1783","1470","1470",台灣摩根士丹利,3,0,3,1,4.05
"20201118","1783","9233","9200",凱基-長庚,0,3,3,-1,4.05
"20201118","1783","1560","1560",港商野村,2,0,2,1,2.70
"20201118","1783","0039003800300065","9800",元大-清水,0,3,3,-1,4.05
"20201118","1783","1440","1440",美林,2,0,2,1,2.70
"20201118","1783","6381","6380",光和-溪湖,0,2,2,-1,2.70
"20201118","1783","5850","5850",統一,1,0,1,1,1.35
"20201118","1783","6167","6160",中國信託-松江,0,2,2,-1,2.70
"20201118","1783","6912","6910",德信-中正,1,0,1,1,1.35
"20201118","1783","1028","1020",合庫-彰化,0,2,2,-1,2.70
"20201118","1783","6465","6460",大昌-桃園,1,0,1,1,1.35
"20201118","1783","0039003200300044","9200",凱基-市府,0,2,2,-1,2.70
"20201118","1783","0035003900320057","5920",元富-吉利,1,0,1,1,1.35
"20201118","1783","9215","9200",凱基-高美館,0,2,2,-1,2.70
"20201118","1783","003700370039005a","7790",國票-安和,1,0,1,1,1.35
"20201118","1783","9283","9200",凱基-北門,0,2,2,-1,2.70
"20201119","1783","9211","9200",凱基-台南,9,0,9,1,10.98
"20201119","1783","1262","1260",宏遠-桃園,0,6,6,-1,7.32
"20201119","1783","9343","9300",華南永昌-頭份,6,0,6,1,7.32
"20201119","1783","0038003100350042","8150",台新-台中,0,4,4,-1,4.88
"20201119","1783","0039003800310046","9800",元大-福營,5,0,5,1,6.10
"20201119","1783","5322","5320",高橋-中壢,0,3,3,-1,3.66
"20201119","1783","0039003600310052","9600",富邦-南員林,4,0,4,1,4.88
"20201119","1783","003800380038004b","8880",國泰-板橋,0,3,3,-1,3.66
"20201119","1783","1520","1520",瑞士信貸,3,0,3,1,3.66
"20201119","1783","9233","9200",凱基-長庚,0,3,3,-1,3.66
"20201119","1783","0038003800340043","8840",玉山-南京東路,3,0,3,1,3.66
"20201119","1783","9283","9200",凱基-北門,0,3,3,-1,3.66
"20201119","1783","9105","9100",群益金鼎-高盛,3,0,3,1,3.66
"20201119","1783","9316","9300",華南永昌-淡水,0,3,3,-1,3.66
"20201119","1783","9268","9200",凱基-台北,8,5,3,1,3.66
"20201119","1783","9838","9800",元大-豐原,0,3,3,-1,3.66
"20201119","1783","5384","5380",第一金-台南,2,0,2,1,2.44
"20201119","1783","5850","5850",統一,0,2,2,-1,2.44
"20201119","1783","0039003200310047","9200",凱基-五股,2,0,2,1,2.44
"20201119","1783","6167","6160",中國信託-松江,0,2,2,-1,2.44
"20201119","1783","0039003800300043","9800",元大-斗六,2,0,2,1,2.44
"20201119","1783","6913","6910",德信-新營,0,2,2,-1,2.44
"20201119","1783","9874","9800",元大-雙和,2,0,2,1,2.44
"20201119","1783","0037003700390057","7790",國票-彰化,0,2,2,-1,2.44
"20201119","1783","0039004100390055","9A00",永豐金-中正,2,0,2,1,2.44
"20201119","1783","0038003100350059","8150",台新-新營,0,2,2,-1,2.44
"20201119","1783","8560","8560",新光,1,0,1,1,1.22
"20201119","1783","9134","9100",群益金鼎-開元,0,2,2,-1,2.44
"20201120","1783","6163","6160",中國信託-永康,10,0,10,1,9.62
"20201120","1783","5320","5320",高橋,0,6,6,-1,5.77
"20201120","1783","9211","9200",凱基-台南,10,0,10,1,9.62
"20201120","1783","9266","9200",凱基-新豐,0,6,6,-1,5.77
"20201120","1783","9800","9800",元大證券,10,0,10,1,9.62
"20201120","1783","0039003600320047","9600",富邦-斗六,0,6,6,-1,5.77
"20201120","1783","1440","1440",美林,7,1,6,1,5.77
"20201120","1783","0035003900320079","5920",元富-花蓮,0,5,5,-1,4.81
"20201120","1783","0035003900320057","5920",元富-吉利,6,0,6,1,5.77
"20201120","1783","0038003100350041","8150",台新-高雄,0,5,5,-1,4.81
"20201120","1783","1520","1520",瑞士信貸,5,0,5,1,4.81
"20201120","1783","0039003100380063","9100",群益金鼎-鳳山,0,4,4,-1,3.85
"20201120","1783","9268","9200",凱基-台北,4,0,4,1,3.85
"20201120","1783","9623","9600",富邦-台北,0,4,4,-1,3.85
"20201120","1783","9343","9300",華南永昌-頭份,4,0,4,1,3.85
"20201120","1783","0039004100390055","9A00",永豐金-中正,0,4,4,-1,3.85
"20201120","1783","1031","1030",土銀-台中,2,0,2,1,1.92
"20201120","1783","5386","5380",第一金-彰化,0,3,3,-1,2.88
"20201120","1783","1261","1260",宏遠-民生,2,0,2,1,1.92
"20201120","1783","9654","9600",富邦-永和,0,3,3,-1,2.88
"20201120","1783","5323","5320",高橋-內壢,4,2,2,1,1.92
"20201120","1783","003900380031006e","9800",元大-旗山,0,3,3,-1,2.88
"20201120","1783","6385","6380",光和-花壇,2,0,2,1,1.92
"20201120","1783","9856","9800",元大-花蓮,0,3,3,-1,2.88
"20201120","1783","6451","6450",永全-南崁,2,0,2,1,1.92
"20201120","1783","5660","5660",日進,0,2,2,-1,1.92
"20201120","1783","0037003700390072","7790",國票-桃園,1,0,1,1,0.96
"20201120","1783","0037003700390056","7790",國票-天祥,0,2,2,-1,1.92
"20201123","1783","9268","9200",凱基-台北,17,1,16,1,14.16
"20201123","1783","9208","9200",凱基-桃園,0,9,9,-1,7.96
"20201123","1783","9189","9100",群益金鼎-桃園,8,0,8,1,7.08
"20201123","1783","0038003100350042","8150",台新-台中,0,8,8,-1,7.08
"20201123","1783","9813","9800",元大-八德,5,0,5,1,4.42
"20201123","1783","9654","9600",富邦-永和,0,7,7,-1,6.19
"20201123","1783","0039004100390055","9A00",永豐金-中正,5,0,5,1,4.42
"20201123","1783","9858","9800",元大-龍潭,0,7,7,-1,6.19
"20201123","1783","1440","1440",美林,7,3,4,1,3.54
"20201123","1783","1233","1230",彰銀-台中,0,5,5,-1,4.42
"20201123","1783","0038003100350041","8150",台新-高雄,4,0,4,1,3.54
"20201123","1783","0037003700390075","7790",國票-長城,0,5,5,-1,4.42
"20201123","1783","6385","6380",光和-花壇,3,0,3,1,2.65
"20201123","1783","003900310038004a","9100",群益金鼎-永和,0,5,5,-1,4.42
"20201123","1783","1520","1520",瑞士信貸,3,0,3,1,2.65
"20201123","1783","0039003600320046","9600",富邦-北桃園(停),0,5,5,-1,4.42
"20201123","1783","9874","9800",元大-雙和,3,0,3,1,2.65
"20201123","1783","9655","9600",富邦-板橋,0,5,5,-1,4.42
"20201123","1783","0039003800390065","9800",元大-中和,3,0,3,1,2.65
"20201123","1783","2184","2180",亞東-新竹,0,4,4,-1,3.54
"20201123","1783","0039003100380047","9100",群益金鼎-新莊,4,2,2,1,1.77
"20201123","1783","6160","6160",中國信託,0,2,2,-1,1.77
"20201123","1783","0039003600310052","9600",富邦-南員林,2,0,2,1,1.77
"20201123","1783","1021","1020",合庫-台中,0,2,2,-1,1.77
"20201123","1783","1040","1040",臺銀,1,0,1,1,0.88
"20201123","1783","6451","6450",永全-南崁,0,2,2,-1,1.77
"20201123","1783","1590","1590",花旗環球,1,0,1,1,0.88
"20201123","1783","8380","8380",安泰,0,2,2,-1,1.77
"20201124","1783","0039003800310046","9800",元大-福營,17,0,17,1,13.60
"20201124","1783","0039003200300057","9200",凱基-大里,0,20,20,-1,16.00
"20201124","1783","0039004100390055","9A00",永豐金-中正,13,0,13,1,10.40
"20201124","1783","0035003900320041","5920",元富-緯城,0,10,10,-1,8.00
"20201124","1783","8886","8880",國泰-新莊,10,0,10,1,8.00
"20201124","1783","0038003100350042","8150",台新-台中,0,10,10,-1,8.00
"20201124","1783","9287","9200",凱基-內湖,5,0,5,1,4.00
"20201124","1783","9189","9100",群益金鼎-桃園,0,8,8,-1,6.40
"20201124","1783","0039004100390061","9A00",永豐金-苓雅,5,0,5,1,4.00
"20201124","1783","9817","9800",元大-東泰,0,6,6,-1,4.80
"20201124","1783","0035003300380050","5380",第一金-路竹,4,0,4,1,3.20
"20201124","1783","8156","8150",台新-三民,0,5,5,-1,4.00
"20201124","1783","0039003600320044","9600",富邦-新莊,4,0,4,1,3.20
"20201124","1783","0038003800380041","8880",國泰-館前,0,5,5,-1,4.00
"20201124","1783","0035003900320055","5920",元富-宜蘭,3,0,3,1,2.40
"20201124","1783","1440","1440",美林,0,3,3,-1,2.40
"20201124","1783","0035003900320069","5920",元富-中港,3,0,3,1,2.40
"20201124","1783","0036003300380041","6380",光和-嘉義,0,3,3,-1,2.40
"20201124","1783","1040","1040",臺銀,3,0,3,1,2.40
"20201124","1783","0039003800390051","9800",元大-汐止,0,3,3,-1,2.40
"20201124","1783","9655","9600",富邦-板橋,2,0,2,1,1.60
"20201124","1783","9268","9200",凱基-台北,0,2,2,-1,1.60
"20201124","1783","0039003800300043","9800",元大-斗六,2,0,2,1,1.60
"20201124","1783","0039003800390043","9800",元大-板橋,0,2,2,-1,1.60
"20201124","1783","1042","1040",臺銀-臺南,1,0,1,1,0.80
"20201124","1783","0031003100310042","1110",台灣企銀-建成,0,1,1,-1,0.80
"20201124","1783","6385","6380",光和-花壇,1,0,1,1,0.80
"20201124","1783","6164","6160",中國信託-文心,0,1,1,-1,0.80
"20201125","1783","0035003900320055","5920",元富-宜蘭,7,0,7,1,5.60
"20201125","1783","9211","9200",凱基-台南,0,14,14,-1,11.20
"20201125","1783","9834","9800",元大-中壢,6,0,6,1,4.80
"20201125","1783","1440","1440",美林,1,14,13,-1,10.40
"20201125","1783","0039004100390055","9A00",永豐金-中正,6,0,6,1,4.80
"20201125","1783","9208","9200",凱基-桃園,0,8,8,-1,6.40
"20201125","1783","1031","1030",土銀-台中,5,0,5,1,4.00
"20201125","1783","9278","9200",凱基-永康,0,8,8,-1,6.40
"20201125","1783","8886","8880",國泰-新莊,5,0,5,1,4.00
"20201125","1783","8440","8440",摩根大通,1,6,5,-1,4.00
"20201125","1783","9268","9200",凱基-台北,9,4,5,1,4.00
"20201125","1783","0039004100390038","9A00",永豐金-大園,0,5,5,-1,4.00
"20201125","1783","0039003600320044","9600",富邦-新莊,5,0,5,1,4.00
"20201125","1783","5460","5460",寶盛,0,4,4,-1,3.20
"20201125","1783","0039003800310046","9800",元大-福營,4,0,4,1,3.20
"20201125","1783","003500390032006c","5920",元富-大裕,0,3,3,-1,2.40
"20201125","1783","1520","1520",瑞士信貸,3,0,3,1,2.40
"20201125","1783","0039003800310053","9800",元大-崇德,0,3,3,-1,2.40
"20201125","1783","0039003800300043","9800",元大-斗六,3,0,3,1,2.40
"20201125","1783","9831","9800",元大-四維,0,3,3,-1,2.40
"20201125","1783","9817","9800",元大-東泰,3,0,3,1,2.40
"20201125","1783","0031003200360058","1260",宏遠-新化,0,2,2,-1,1.60
"20201125","1783","0039003200300046","9200",凱基-站前,2,0,2,1,1.60
"20201125","1783","6913","6910",德信-新營,0,2,2,-1,1.60
"20201125","1783","1020","1020",合庫證券,1,0,1,1,0.80
"20201125","1783","9288","9200",凱基-埔墘,0,2,2,-1,1.60
"20201125","1783","6385","6380",光和-花壇,1,0,1,1,0.80
"20201125","1783","0039003600310052","9600",富邦-南員林,0,2,2,-1,1.60
"20201126","1783","1520","1520",瑞士信貸,15,0,15,1,14.29
"20201126","1783","8380","8380",安泰,0,10,10,-1,9.52
"20201126","1783","0039003800310046","9800",元大-福營,6,0,6,1,5.71
"20201126","1783","0035003900320050","5920",元富-同大,0,6,6,-1,5.71
"20201126","1783","0039003600320043","9600",富邦-東門,5,0,5,1,4.76
"20201126","1783","9252","9200",凱基-嘉義,0,6,6,-1,5.71
"20201126","1783","1590","1590",花旗環球,4,0,4,1,3.81
"20201126","1783","9268","9200",凱基-台北,12,18,6,-1,5.71
"20201126","1783","003700370039004a","7790",國票-北高雄,2,0,2,1,1.90
"20201126","1783","0035003900320059","5920",元富-埔里,0,5,5,-1,4.76
"20201126","1783","9623","9600",富邦-台北,2,0,2,1,1.90
"20201126","1783","003900380031006e","9800",元大-旗山,0,3,3,-1,2.86
"20201126","1783","9672","9600",富邦-員林,2,0,2,1,1.90
"20201126","1783","9856","9800",元大-花蓮,0,3,3,-1,2.86
"20201126","1783","9835","9800",元大-員林中山,2,0,2,1,1.90
"20201126","1783","5263","5260",美好-泰山,0,2,2,-1,1.90
"20201126","1783","0035003900320042","5920",元富-永和,1,0,1,1,0.95
"20201126","1783","8440","8440",摩根大通,1,3,2,-1,1.90
"20201126","1783","6165","6160",中國信託-新竹,1,0,1,1,0.95
"20201126","1783","003900310038004b","9100",群益金鼎-東湖,0,2,2,-1,1.90
"20201126","1783","9233","9200",凱基-長庚,1,0,1,1,0.95
"20201126","1783","9202","9200",凱基-中港,0,2,2,-1,1.90
"20201126","1783","9343","9300",華南永昌-頭份,1,0,1,1,0.95
"20201126","1783","003900380033004b","9800",元大-學甲,0,2,2,-1,1.90
"20201126","1783","0039003600320052","9600",富邦-園區,1,0,1,1,0.95
"20201126","1783","003900380039004e","9800",元大-內湖,0,2,2,-1,1.90
"20201126","1783","0039003800310061","9800",元大-歸仁,1,0,1,1,0.95
"20201126","1783","5266","5260",美好-中壢,0,1,1,-1,0.95
"20201127","1783","0039003600320043","9600",富邦-東門,12,0,12,1,19.05
"20201127","1783","003900320030005a","9200",凱基-台東,0,5,5,-1,7.94
"20201127","1783","1520","1520",瑞士信貸,6,0,6,1,9.52
"20201127","1783","9359","9300",華南永昌-中正,1,6,5,-1,7.94
"20201127","1783","0039003800390044","9800",元大-左營,5,0,5,1,7.94
"20201127","1783","0039003800310053","9800",元大-崇德,0,5,5,-1,7.94
"20201127","1783","9252","9200",凱基-嘉義,5,1,4,1,6.35
"20201127","1783","0031003000320043","1020",合庫-自強,0,3,3,-1,4.76
"20201127","1783","0039003800310067","9800",元大-大里,3,0,3,1,4.76
"20201127","1783","8440","8440",摩根大通,1,4,3,-1,4.76
"20201127","1783","0035003900320069","5920",元富-中港,2,0,2,1,3.17
"20201127","1783","9672","9600",富邦-員林,0,3,3,-1,4.76
"20201127","1783","1040","1040",臺銀,1,0,1,1,1.59
"20201127","1783","5263","5260",美好-泰山,0,2,2,-1,3.17
"20201127","1783","5925","5920",元富-台中,1,0,1,1,1.59
"20201127","1783","0037003700390057","7790",國票-彰化,0,2,2,-1,3.17
"20201127","1783","0035003900320063","5920",元富-烏日,1,0,1,1,1.59
"20201127","1783","8846","8840",玉山-板橋,0,2,2,-1,3.17
"20201127","1783","6385","6380",光和-花壇,1,0,1,1,1.59
"20201127","1783","8881","8880",國泰-高雄,0,2,2,-1,3.17
"20201127","1783","9268","9200",凱基-台北,1,0,1,1,1.59
"20201127","1783","1440","1440",美林,0,1,1,-1,1.59
"20201127","1783","9658","9600",富邦-建國,1,0,1,1,1.59
"20201127","1783","1114","1110",台灣企銀-嘉義,0,1,1,-1,1.59
"20201127","1783","0039003200300047","9200",凱基-彰化,0,0,0,1,0.00
"20201127","1783","003500380035006d","5850",統一-竹南,0,1,1,-1,1.59
"20201127","1783","0039003100330059","9100",群益金鼎-館前,0,0,0,1,0.00
"20201127","1783","0035003800350049","5850",統一-員林,0,1,1,-1,1.59
"20201130","1783","0035003900320057","5920",元富-吉利,10,0,10,1,10.42
"20201130","1783","9871","9800",元大-忠孝,0,10,10,-1,10.42
"20201130","1783","8886","8880",國泰-新莊,10,0,10,1,10.42
"20201130","1783","9359","9300",華南永昌-中正,0,8,8,-1,8.33
"20201130","1783","0039004100390055","9A00",永豐金-中正,7,0,7,1,7.29
"20201130","1783","9813","9800",元大-八德,0,7,7,-1,7.29
"20201130","1783","9268","9200",凱基-台北,8,2,6,1,6.25
"20201130","1783","003900380039005a","9800",元大-小港,0,6,6,-1,6.25
"20201130","1783","0039003600310046","9600",富邦-中港,6,0,6,1,6.25
"20201130","1783","003900380033004e","9800",元大-大安,0,5,5,-1,5.21
"20201130","1783","9858","9800",元大-龍潭,6,0,6,1,6.25
"20201130","1783","0039003800390051","9800",元大-汐止,0,5,5,-1,5.21
"20201130","1783","1520","1520",瑞士信貸,4,0,4,1,4.17
"20201130","1783","7791","7790",國票-台東,0,4,4,-1,4.17
"20201130","1783","8157","8150",台新-左楠,4,0,4,1,4.17
"20201130","1783","003700300030005a","7000",兆豐-高雄,0,4,4,-1,4.17
"20201130","1783","9317","9300",華南永昌-林口,3,0,3,1,3.13
"20201130","1783","0031003200360048","1260",宏遠-中和,0,2,2,-1,2.08
"20201130","1783","0035003800350048","5850",統一-桃園,2,0,2,1,2.08
"20201130","1783","8585","8580",聯邦-三重,0,2,2,-1,2.08
"20201130","1783","5383","5380",第一金-高雄,2,0,2,1,2.08
"20201130","1783","9186","9100",群益金鼎-新竹,0,2,2,-1,2.08
"20201130","1783","0039003200320048","9200",凱基-復興,2,0,2,1,2.08
"20201130","1783","003900320030004e","9200",凱基-湖口,0,2,2,-1,2.08
"20201130","1783","9377","9300",華南永昌-虎尾,2,0,2,1,2.08
"20201130","1783","0039003600330042","9600",富邦-北宜蘭(停),0,2,2,-1,2.08
"20201130","1783","003900360032004b","9600",富邦-中和,2,0,2,1,2.08
"20201130","1783","9672","9600",富邦-員林,0,2,2,-1,2.08
"20201005","1783","1470","1470",台灣摩根士丹利,29,16,13,1,8.72
"20201005","1783","8560","8560",新光,0,10,10,-1,6.71
"20201005","1783","9268","9200",凱基-台北,35,22,13,1,8.72
"20201005","1783","1520","1520",瑞士信貸,3,11,8,-1,5.37
"20201005","1783","0035003300380041","5380",第一金-新興,5,0,5,1,3.36
"20201005","1783","1440","1440",美林,0,7,7,-1,4.70
"20201005","1783","1480","1480",美商高盛,4,0,4,1,2.68
"20201005","1783","5266","5260",美好-中壢,0,5,5,-1,3.36
"20201005","1783","9817","9800",元大-東泰,4,0,4,1,2.68
"20201005","1783","003700370039007a","7790",國票-博愛,0,5,5,-1,3.36
"20201005","1783","0037003700390050","7790",國票-九鼎,4,2,2,1,1.34
"20201005","1783","6165","6160",中國信託-新竹,0,4,4,-1,2.68
"20201005","1783","9894","9800",元大-桃興,2,0,2,1,1.34
"20201005","1783","9252","9200",凱基-嘉義,0,4,4,-1,2.68
"20201005","1783","9672","9600",富邦-員林,1,0,1,1,0.67
"20201005","1783","0039003800310061","9800",元大-歸仁,0,4,4,-1,2.68
"20201005","1783","8159","8150",台新-台南,1,0,1,1,0.67
"20201005","1783","8440","8440",摩根大通,1,4,3,-1,2.01
"20201005","1783","9285","9200",凱基-中壢,1,0,1,1,0.67
"20201005","1783","8581","8580",聯邦-高雄,0,3,3,-1,2.01
"20201005","1783","9369","9300",華南永昌-三重,1,0,1,1,0.67
"20201005","1783","9647","9600",富邦-新竹,0,3,3,-1,2.01
"20201005","1783","0039003600320056","9600",富邦-復興,1,0,1,1,0.67
"20201005","1783","5260","5260",美好,0,2,2,-1,1.34
"20201005","1783","9899","9800",元大-淡水,1,0,1,1,0.67
"20201005","1783","9233","9200",凱基-長庚,0,2,2,-1,1.34
"20201005","1783","9131","9100",群益金鼎-民權,0,0,0,1,0.00
"20201005","1783","9316","9300",華南永昌-淡水,0,2,2,-1,1.34
"20201006","1783","1470","1470",台灣摩根士丹利,14,0,14,1,13.08
"20201006","1783","7080","7080",石橋證券,0,10,10,-1,9.35
"20201006","1783","5857","5850",統一-新竹,14,0,14,1,13.08
"20201006","1783","003900380031006a","9800",元大-士林,0,9,9,-1,8.41
"20201006","1783","0035003900320044","5920",元富-大昌,12,0,12,1,11.21
"20201006","1783","9817","9800",元大-東泰,4,10,6,-1,5.61
"20201006","1783","0039003800310068","9800",元大-屏東民生,5,0,5,1,4.67
"20201006","1783","0039003100330049","9100",群益金鼎-萬華,0,5,5,-1,4.67
"20201006","1783","0039003800310072","9800",元大-屏南,5,0,5,1,4.67
"20201006","1783","9283","9200",凱基-北門,0,5,5,-1,4.67
"20201006","1783","1480","1480",美商高盛,3,0,3,1,2.80
"20201006","1783","8440","8440",摩根大通,0,4,4,-1,3.74
"20201006","1783","9800","9800",元大證券,3,1,2,1,1.87
"20201006","1783","9835","9800",元大-員林中山,0,3,3,-1,2.80
"20201006","1783","1560","1560",港商野村,1,0,1,1,0.93
"20201006","1783","003900380039005a","9800",元大-小港,0,3,3,-1,2.80
"20201006","1783","0037003700390075","7790",國票-長城,1,0,1,1,0.93
"20201006","1783","0039004100390078","9A00",永豐金-桃園,0,3,3,-1,2.80
"20201006","1783","9188","9100",群益金鼎-三民,1,0,1,1,0.93
"20201006","1783","1021","1020",合庫-台中,0,2,2,-1,1.87
"20201006","1783","0039003100380047","9100",群益金鼎-新莊,3,2,1,1,0.93
"20201006","1783","0037003000300070","7000",兆豐-復興,0,2,2,-1,1.87
"20201006","1783","0039003200310053","9200",凱基-幸福,1,0,1,1,0.93
"20201006","1783","6162","6160",中國信託-忠孝,0,2,2,-1,1.87
"20201006","1783","9333","9300",華南永昌-長虹,1,0,1,1,0.93
"20201006","1783","9252","9200",凱基-嘉義,0,2,2,-1,1.87
"20201006","1783","9692","9600",富邦-嘉義,1,0,1,1,0.93
"20201006","1783","0039003800300064","9800",元大-沙鹿,0,2,2,-1,1.87
"20201007","1783","5857","5850",統一-新竹,11,0,11,1,12.22
"20201007","1783","8883","8880",國泰-松江,0,11,11,-1,12.22
"20201007","1783","6950","6950",福勝,10,0,10,1,11.11
"20201007","1783","0039004100390045","9A00",永豐金-板橋,0,10,10,-1,11.11
"20201007","1783","9268","9200",凱基-台北,9,3,6,1,6.67
"20201007","1783","9800","9800",元大證券,4,10,6,-1,6.67
"20201007","1783","1480","1480",美商高盛,5,0,5,1,5.56
"20201007","1783","003900380031004e","9800",元大-金門,0,5,5,-1,5.56
"20201007","1783","0039003800380056","9800",元大-長庚,5,0,5,1,5.56
"20201007","1783","8440","8440",摩根大通,0,4,4,-1,4.44
"20201007","1783","0038003100350041","8150",台新-高雄,4,0,4,1,4.44
"20201007","1783","0039004100390052","9A00",永豐金-信義,0,4,4,-1,4.44
"20201007","1783","9817","9800",元大-東泰,4,0,4,1,4.44
"20201007","1783","8565","8560",新光-桃園,0,3,3,-1,3.33
"20201007","1783","1520","1520",瑞士信貸,2,0,2,1,2.22
"20201007","1783","9647","9600",富邦-新竹,0,3,3,-1,3.33
"20201007","1783","9359","9300",華南永昌-中正,2,0,2,1,2.22
"20201007","1783","0035003800350052","5850",統一-汐止,0,2,2,-1,2.22
"20201007","1783","5382","5380",第一金-台中,1,0,1,1,1.11
"20201007","1783","0035003300380057","5380",第一金-華江,0,2,2,-1,2.22
"20201007","1783","1470","1470",台灣摩根士丹利,2,1,1,1,1.11
"20201007","1783","5323","5320",高橋-內壢,0,2,2,-1,2.22
"20201007","1783","0035003900320049","5920",元富-嘉義,1,0,1,1,1.11
"20201007","1783","9622","9600",富邦-園區(停),0,2,2,-1,2.22
"20201007","1783","8842","8840",玉山-新莊,1,0,1,1,1.11
"20201007","1783","0039003800310061","9800",元大-歸仁,0,2,2,-1,2.22
"20201007","1783","9331","9300",華南永昌-鳳山,1,0,1,1,1.11
"20201007","1783","0039004100360031","9A00",永豐金-鳳山,0,2,2,-1,2.22
"20201008","1783","0035003900320044","5920",元富-大昌,6,0,6,1,7.79
"20201008","1783","9636","9600",富邦-中壢,0,10,10,-1,12.99
"20201008","1783","9817","9800",元大-東泰,6,0,6,1,7.79
"20201008","1783","5266","5260",美好-中壢,0,7,7,-1,9.09
"20201008","1783","9651","9600",富邦-民生(停),5,0,5,1,6.49
"20201008","1783","8440","8440",摩根大通,0,5,5,-1,6.49
"20201008","1783","1480","1480",美商高盛,3,0,3,1,3.90
"20201008","1783","8843","8840",玉山-高雄,0,3,3,-1,3.90
"20201008","1783","9252","9200",凱基-嘉義,3,0,3,1,3.90
"20201008","1783","0035003300380057","5380",第一金-華江,0,2,2,-1,2.60
"20201008","1783","0039003600310044","9600",富邦-忠孝,3,0,3,1,3.90
"20201008","1783","0038003800340046","8840",玉山-桃園,0,2,2,-1,2.60
"20201008","1783","9800","9800",元大證券,3,0,3,1,3.90
"20201008","1783","9268","9200",凱基-台北,2,4,2,-1,2.60
"20201008","1783","003700300030005a","7000",兆豐-高雄,5,3,2,1,2.60
"20201008","1783","0039003600310058","9600",富邦-大墩,0,2,2,-1,2.60
"20201008","1783","1470","1470",台灣摩根士丹利,2,0,2,1,2.60
"20201008","1783","9661","9600",富邦-新店,0,2,2,-1,2.60
"20201008","1783","5925","5920",元富-台中,1,0,1,1,1.30
"20201008","1783","9813","9800",元大-八德,0,2,2,-1,2.60
"20201008","1783","0035003800350044","5850",統一-新台中,1,0,1,1,1.30
"20201008","1783","0039003800310044","9800",元大-南投,0,2,2,-1,2.60
"20201008","1783","0036003000310064","6010",(牛牛牛)亞-鑫豐,1,0,1,1,1.30
"20201008","1783","0039003800320046","9800",元大-忠孝鼎富,0,2,2,-1,2.60
"20201008","1783","8380","8380",安泰,1,0,1,1,1.30
"20201008","1783","0039003800330042","9800",元大-林森,0,2,2,-1,2.60
"20201008","1783","0035003900320079","5920",元富-花蓮,1,0,1,1,1.30
"20201008","1783","9894","9800",元大-桃興,0,2,2,-1,2.60
"20201012","1783","7032","7030",致和-佳里,14,0,14,1,14.58
"20201012","1783","0039004100390078","9A00",永豐金-桃園,0,12,12,-1,12.50
"20201012","1783","9229","9200",凱基-中山,10,0,10,1,10.42
"20201012","1783","9651","9600",富邦-民生(停),5,15,10,-1,10.42
"20201012","1783","9302","9300",華南永昌-台中,8,0,8,1,8.33
"20201012","1783","0039003800310061","9800",元大-歸仁,0,7,7,-1,7.29
"20201012","1783","5386","5380",第一金-彰化,4,0,4,1,4.17
"20201012","1783","8440","8440",摩根大通,0,4,4,-1,4.17
"20201012","1783","003900380034004b","9800",元大-館前,4,0,4,1,4.17
"20201012","1783","9672","9600",富邦-員林,0,4,4,-1,4.17
"20201012","1783","0035003800350067","5850",統一-平鎮,2,0,2,1,2.08
"20201012","1783","9897","9800",元大-土城,0,4,4,-1,4.17
"20201012","1783","9184","9100",群益金鼎-台中,2,0,2,1,2.08
"20201012","1783","003900380039004c","9800",元大-成功,0,4,4,-1,4.17
"20201012","1783","9252","9200",凱基-嘉義,2,0,2,1,2.08
"20201012","1783","9636","9600",富邦-中壢,0,3,3,-1,3.13
"20201012","1783","9306","9300",華南永昌-台南,2,0,2,1,2.08
"20201012","1783","1038","1030",土銀-和平,0,2,2,-1,2.08
"20201012","1783","9858","9800",元大-龍潭,2,0,2,1,2.08
"20201012","1783","9647","9600",富邦-新竹,0,2,2,-1,2.08
"20201012","1783","0039003800390050","9800",元大-敦南,2,0,2,1,2.08
"20201012","1783","9186","9100",群益金鼎-新竹,0,1,1,-1,1.04
"20201012","1783","003700300030005a","7000",兆豐-高雄,3,2,1,1,1.04
"20201012","1783","5385","5380",第一金-桃園,0,1,1,-1,1.04
"20201012","1783","8561","8560",新光-台中,1,0,1,1,1.04
"20201012","1783","5323","5320",高橋-內壢,0,1,1,-1,1.04
"20201012","1783","6012","6010",(牛牛牛)亞-網路,1,0,1,1,1.04
"20201012","1783","0036003000310064","6010",(牛牛牛)亞-鑫豐,0,1,1,-1,1.04
"20201013","1783","1470","1470",台灣摩根士丹利,12,0,12,1,11.21
"20201013","1783","003500390032006c","5920",元富-大裕,0,12,12,-1,11.21
"20201013","1783","8560","8560",新光,12,0,12,1,11.21
"20201013","1783","9627","9600",富邦-內湖,0,10,10,-1,9.35
"20201013","1783","9300","9300",華南永昌,7,0,7,1,6.54
"20201013","1783","003500380035004a","5850",統一-三重,0,5,5,-1,4.67
"20201013","1783","0031003000340043","1040",臺銀-高雄,4,0,4,1,3.74
"20201013","1783","8156","8150",台新-三民,0,5,5,-1,4.67
"20201013","1783","7032","7030",致和-佳里,4,0,4,1,3.74
"20201013","1783","0039003600320044","9600",富邦-新莊,0,5,5,-1,4.67
"20201013","1783","1440","1440",美林,3,0,3,1,2.80
"20201013","1783","0039003600360046","9600",富邦-左營,0,5,5,-1,4.67
"20201013","1783","0037003700390075","7790",國票-長城,2,0,2,1,1.87
"20201013","1783","9862","9800",元大-南京,0,5,5,-1,4.67
"20201013","1783","0039003100330048","9100",群益金鼎-屏東,2,0,2,1,1.87
"20201013","1783","9258","9200",凱基-羅東,0,3,3,-1,2.80
"20201013","1783","6160","6160",中國信託,1,0,1,1,0.93
"20201013","1783","0031003200360048","1260",宏遠-中和,0,2,2,-1,1.87
"20201013","1783","1560","1560",港商野村,1,0,1,1,0.93
"20201013","1783","5385","5380",第一金-桃園,0,2,2,-1,1.87
"20201013","1783","0036003300380041","6380",光和-嘉義,1,0,1,1,0.93
"20201013","1783","8440","8440",摩根大通,1,3,2,-1,1.87
"20201013","1783","7030","7030",致和證券,1,0,1,1,0.93
"20201013","1783","003900380031004d","9800",元大-苗栗,0,2,2,-1,1.87
"20201013","1783","8157","8150",台新-左楠,1,0,1,1,0.93
"20201013","1783","0039003800390043","9800",元大-板橋,0,2,2,-1,1.87
"20201013","1783","8842","8840",玉山-新莊,1,0,1,1,0.93
"20201013","1783","0039003800390045","9800",元大-草屯,0,2,2,-1,1.87
"20201014","1783","9268","9200",凱基-台北,22,2,20,1,14.49
"20201014","1783","0039003800310070","9800",元大-松山,0,30,30,-1,21.74
"20201014","1783","8440","8440",摩根大通,18,0,18,1,13.04
"20201014","1783","0035003900320043","5920",元富-潮州,0,10,10,-1,7.25
"20201014","1783","1470","1470",台灣摩根士丹利,12,0,12,1,8.70
"20201014","1783","9108","9100",群益金鼎-海山,0,8,8,-1,5.80
"20201014","1783","5857","5850",統一-新竹,10,0,10,1,7.25
"20201014","1783","8581","8580",聯邦-高雄,0,6,6,-1,4.35
"20201014","1783","1440","1440",美林,10,2,8,1,5.80
"20201014","1783","0039004100390057","9A00",永豐金-市政,0,3,3,-1,2.17
"20201014","1783","1520","1520",瑞士信貸,5,0,5,1,3.62
"20201014","1783","003600310036004b","6160",中國信託-高雄,0,2,2,-1,1.45
"20201014","1783","0038003100350059","8150",台新-新營,5,0,5,1,3.62
"20201014","1783","0037003000300047","7000",兆豐-麻豆,0,2,2,-1,1.45
"20201014","1783","0038003800340046","8840",玉山-桃園,3,0,3,1,2.17
"20201014","1783","003700300030005a","7000",兆豐-高雄,1,3,2,-1,1.45
"20201014","1783","0039003100330048","9100",群益金鼎-屏東,3,0,3,1,2.17
"20201014","1783","8842","8840",玉山-新莊,0,2,2,-1,1.45
"20201014","1783","1260","1260",宏遠證券,2,0,2,1,1.45
"20201014","1783","0038003800340042","8840",玉山-台中,0,2,2,-1,1.45
"20201014","1783","9300","9300",華南永昌,2,0,2,1,1.45
"20201014","1783","9814","9800",元大-大益,0,2,2,-1,1.45
"20201014","1783","0039003800300043","9800",元大-斗六,2,0,2,1,1.45
"20201014","1783","0039003800310061","9800",元大-歸仁,0,2,2,-1,1.45
"20201014","1783","9873","9800",元大-西門,2,0,2,1,1.45
"20201014","1783","0039003800340045","9800",元大-南勢角,0,2,2,-1,1.45
"20201014","1783","0031003200360069","1260",宏遠-光隆,1,0,1,1,0.72
"20201014","1783","9854","9800",元大-文心興安,0,2,2,-1,1.45
"20201015","1783","9300","9300",華南永昌,11,0,11,1,10.89
"20201015","1783","0039003600360046","9600",富邦-左營,0,20,20,-1,19.80
"20201015","1783","8560","8560",新光,6,0,6,1,5.94
"20201015","1783","0039003100380047","9100",群益金鼎-新莊,3,14,11,-1,10.89
"20201015","1783","1031","1030",土銀-台中,5,0,5,1,4.95
"20201015","1783","8440","8440",摩根大通,0,9,9,-1,8.91
"20201015","1783","5266","5260",美好-中壢,5,0,5,1,4.95
"20201015","1783","9268","9200",凱基-台北,1,7,6,-1,5.94
"20201015","1783","7032","7030",致和-佳里,4,0,4,1,3.96
"20201015","1783","7790","7790",國票證券,0,4,4,-1,3.96
"20201015","1783","9229","9200",凱基-中山,3,0,3,1,2.97
"20201015","1783","1440","1440",美林,0,3,3,-1,2.97
"20201015","1783","0036003000310064","6010",(牛牛牛)亞-鑫豐,2,0,2,1,1.98
"20201015","1783","1260","1260",宏遠證券,0,2,2,-1,1.98
"20201015","1783","5262","5260",美好-楊梅,2,0,2,1,1.98
"20201015","1783","1029","1020",合庫-鳳山,0,2,2,-1,1.98
"20201015","1783","8882","8880",國泰-台中,2,0,2,1,1.98
"20201015","1783","0039003600310050","9600",富邦-和美,0,2,2,-1,1.98
"20201015","1783","9208","9200",凱基-桃園,2,0,2,1,1.98
"20201015","1783","9817","9800",元大-東泰,0,2,2,-1,1.98
"20201015","1783","0039003800310047","9800",元大-彰化,2,0,2,1,1.98
"20201015","1783","1560","1560",港商野村,0,1,1,-1,0.99
"20201015","1783","1023","1020",合庫-高雄,1,0,1,1,0.99
"20201015","1783","0035003900320044","5920",元富-大昌,0,1,1,-1,0.99
"20201015","1783","6464","6460",大昌-新店,1,0,1,1,0.99
"20201015","1783","0038003800340042","8840",玉山-台中,0,1,1,-1,0.99
"20201015","1783","6381","6380",光和-溪湖,1,0,1,1,0.99
"20201015","1783","0039003200300057","9200",凱基-大里,0,1,1,-1,0.99
"20201016","1783","0035003900320057","5920",元富-吉利,25,0,25,1,4.08
"20201016","1783","003900380031004e","9800",元大-金門,0,21,21,-1,3.43
"20201016","1783","6950","6950",福勝,23,0,23,1,3.76
"20201016","1783","9268","9200",凱基-台北,23,41,18,-1,2.94
"20201016","1783","0039003600310048","9600",富邦-新板,10,0,10,1,1.63
"20201016","1783","0035003900320055","5920",元富-宜蘭,0,10,10,-1,1.63
"20201016","1783","9892","9800",元大-屏東,10,0,10,1,1.63
"20201016","1783","8440","8440",摩根大通,0,10,10,-1,1.63
"20201016","1783","1440","1440",美林,37,30,7,1,1.14
"20201016","1783","9634","9600",富邦-羅東,0,9,9,-1,1.47
"20201016","1783","0039003100330048","9100",群益金鼎-屏東,5,0,5,1,0.82
"20201016","1783","9800","9800",元大證券,0,8,8,-1,1.31
"20201016","1783","9283","9200",凱基-北門,5,0,5,1,0.82
"20201016","1783","0037003000300047","7000",兆豐-麻豆,0,6,6,-1,0.98
"20201016","1783","7032","7030",致和-佳里,4,0,4,1,0.65
"20201016","1783","5267","5260",美好-基隆,0,5,5,-1,0.82
"20201016","1783","0039003100380063","9100",群益金鼎-鳳山,4,0,4,1,0.65
"20201016","1783","5266","5260",美好-中壢,0,5,5,-1,0.82
"20201016","1783","9300","9300",華南永昌,4,0,4,1,0.65
"20201016","1783","9817","9800",元大-東泰,0,5,5,-1,0.82
"20201016","1783","0031003200360048","1260",宏遠-中和,3,0,3,1,0.49
"20201016","1783","0037003000300068","7000",兆豐-三民,0,3,3,-1,0.49
"20201016","1783","5921","5920",元富-高雄,3,0,3,1,0.49
"20201016","1783","0039003800310056","9800",元大-民雄,0,3,3,-1,0.49
"20201016","1783","6452","6450",永全-八德,3,0,3,1,0.49
"20201016","1783","1034","1030",土銀-嘉義,0,2,2,-1,0.33
"20201016","1783","0039003600320042","9600",富邦-二林,3,0,3,1,0.49
"20201016","1783","1560","1560",港商野村,9,11,2,-1,0.33
"20201019","1783","003900380039006d","9800",元大-信義,9,0,9,1,12.68
"20201019","1783","0039003100330048","9100",群益金鼎-屏東,0,6,6,-1,8.45
"20201019","1783","0039003600310058","9600",富邦-大墩,6,0,6,1,8.45
"20201019","1783","9302","9300",華南永昌-台中,0,5,5,-1,7.04
"20201019","1783","2187","2180",亞東-台中,5,0,5,1,7.04
"20201019","1783","1020","1020",合庫證券,0,4,4,-1,5.63
"20201019","1783","9268","9200",凱基-台北,12,7,5,1,7.04
"20201019","1783","6950","6950",福勝,0,3,3,-1,4.23
"20201019","1783","5266","5260",美好-中壢,4,0,4,1,5.63
"20201019","1783","9212","9200",凱基-東港,0,3,3,-1,4.23
"20201019","1783","1440","1440",美林,3,0,3,1,4.23
"20201019","1783","1470","1470",台灣摩根士丹利,0,2,2,-1,2.82
"20201019","1783","003900380033004b","9800",元大-學甲,3,0,3,1,4.23
"20201019","1783","8849","8840",玉山-景美,0,2,2,-1,2.82
"20201019","1783","0035003900320044","5920",元富-大昌,2,0,2,1,2.82
"20201019","1783","9300","9300",華南永昌,0,2,2,-1,2.82
"20201019","1783","0039003800300065","9800",元大-清水,2,0,2,1,2.82
"20201019","1783","0039003600320043","9600",富邦-東門,0,2,2,-1,2.82
"20201019","1783","003900380031007a","9800",元大-大統,2,0,2,1,2.82
"20201019","1783","0039004100390036","9A00",永豐金-博愛,0,2,2,-1,2.82
"20201019","1783","6381","6380",光和-溪湖,1,0,1,1,1.41
"20201019","1783","0035003800350044","5850",統一-新台中,0,1,1,-1,1.41
"20201019","1783","0035003900320049","5920",元富-嘉義,1,0,1,1,1.41
"20201019","1783","5460","5460",寶盛,0,1,1,-1,1.41
"20201019","1783","0031003200360069","1260",宏遠-光隆,1,0,1,1,1.41
"20201019","1783","6461","6460",大昌-樹林,0,1,1,-1,1.41
"20201019","1783","003500330038006a","5380",第一金-安和,1,0,1,1,1.41
"20201019","1783","6450","6450",永全證券,0,1,1,-1,1.41
"20201020","1783","0038003100350042","8150",台新-台中,14,0,14,1,13.08
"20201020","1783","1440","1440",美林,0,13,13,-1,12.15
"20201020","1783","9268","9200",凱基-台北,11,2,9,1,8.41
"20201020","1783","1470","1470",台灣摩根士丹利,0,7,7,-1,6.54
"20201020","1783","9817","9800",元大-東泰,5,0,5,1,4.67
"20201020","1783","0039003800310061","9800",元大-歸仁,0,6,6,-1,5.61
"20201020","1783","7032","7030",致和-佳里,3,0,3,1,2.80
"20201020","1783","0035003900320059","5920",元富-埔里,0,5,5,-1,4.67
"20201020","1783","8882","8880",國泰-台中,3,0,3,1,2.80
"20201020","1783","0039003600320044","9600",富邦-新莊,0,5,5,-1,4.67
"20201020","1783","003500330038006a","5380",第一金-安和,2,0,2,1,1.87
"20201020","1783","9303","9300",華南永昌-高雄,0,4,4,-1,3.74
"20201020","1783","8560","8560",新光,2,0,2,1,1.87
"20201020","1783","9604","9600",富邦-陽明,0,3,3,-1,2.80
"20201020","1783","0039003100380047","9100",群益金鼎-新莊,2,0,2,1,1.87
"20201020","1783","5856","5850",統一-台中,0,2,2,-1,1.87
"20201020","1783","9252","9200",凱基-嘉義,2,0,2,1,1.87
"20201020","1783","0039003600310057","9600",富邦-東花蓮,0,2,2,-1,1.87
"20201020","1783","9856","9800",元大-花蓮,2,0,2,1,1.87
"20201020","1783","9822","9800",元大-土城學府,0,2,2,-1,1.87
"20201020","1783","6461","6460",大昌-樹林,1,0,1,1,0.93
"20201020","1783","0039003800370041","9800",元大-楊梅,0,2,2,-1,1.87
"20201020","1783","6381","6380",光和-溪湖,1,0,1,1,0.93
"20201020","1783","1045","1040",臺銀-新竹,0,1,1,-1,0.93
"20201020","1783","003500380035004a","5850",統一-三重,1,0,1,1,0.93
"20201020","1783","9189","9100",群益金鼎-桃園,0,1,1,-1,0.93
"20201020","1783","5858","5850",統一-嘉義,1,0,1,1,0.93
"20201020","1783","0039003100380044","9100",群益金鼎-東門,0,1,1,-1,0.93
"20201021","1783","0038003100350042","8150",台新-台中,10,0,10,1,12.66
"20201021","1783","8880","8880",國泰證券,0,6,6,-1,7.59
"20201021","1783","8881","8880",國泰-高雄,10,0,10,1,12.66
"20201021","1783","1440","1440",美林,0,5,5,-1,6.33
"20201021","1783","1480","1480",美商高盛,5,0,5,1,6.33
"20201021","1783","8843","8840",玉山-高雄,8,13,5,-1,6.33
"20201021","1783","1045","1040",臺銀-新竹,2,0,2,1,2.53
"20201021","1783","9108","9100",群益金鼎-海山,0,3,3,-1,3.80
"20201021","1783","0039003100380047","9100",群益金鼎-新莊,2,0,2,1,2.53
"20201021","1783","0039003600310046","9600",富邦-中港,0,3,3,-1,3.80
"20201021","1783","9623","9600",富邦-台北,1,0,1,1,1.27
"20201021","1783","0039003800390051","9800",元大-汐止,0,3,3,-1,3.80
"20201021","1783","2180","2180",亞東,1,0,1,1,1.27
"20201021","1783","8455","8450",康和-台中,0,2,2,-1,2.53
"20201021","1783","0039003100330055","9100",群益金鼎-崇德,0,0,0,1,0.00
"20201021","1783","9208","9200",凱基-桃園,0,2,2,-1,2.53
"20201021","1783","0035003900320045","5920",元富-城中,0,0,0,1,0.00
"20201021","1783","9268","9200",凱基-台北,8,10,2,-1,2.53
"20201021","1783","8888","8880",國泰-敦南,0,0,0,1,0.00
"20201021","1783","9817","9800",元大-東泰,0,2,2,-1,2.53
"20201021","1783","9326","9300",華南永昌-南京,0,0,0,1,0.00
"20201021","1783","0037003000300045","7000",兆豐-斗南(停),0,1,1,-1,1.27
"20201021","1783","003700300030005a","7000",兆豐-高雄,1,1,0,1,0.00
"20201021","1783","6451","6450",永全-南崁,0,1,1,-1,1.27
"20201021","1783","0035003800350044","5850",統一-新台中,2,2,0,1,0.00
"20201021","1783","0037003700390056","7790",國票-天祥,0,1,1,-1,1.27
"20201021","1783","0039003200320048","9200",凱基-復興,3,3,0,1,0.00
"20201021","1783","003500330038006a","5380",第一金-安和,0,1,1,-1,1.27
"20201022","1783","0039003100380075","9100",群益金鼎-瑞豐,10,0,10,1,13.51
"20201022","1783","1470","1470",台灣摩根士丹利,0,8,8,-1,10.81
"20201022","1783","9654","9600",富邦-永和,7,0,7,1,9.46
"20201022","1783","003900380031004c","9800",元大-莒光,0,6,6,-1,8.11
"20201022","1783","0035003900320044","5920",元富-大昌,5,0,5,1,6.76
"20201022","1783","003900380031004b","9800",元大-林園,0,5,5,-1,6.76
"20201022","1783","9268","9200",凱基-台北,10,5,5,1,6.76
"20201022","1783","0035003900320050","5920",元富-同大,0,4,4,-1,5.41
"20201022","1783","003900410039004a","9A00",永豐金-板新,3,0,3,1,4.05
"20201022","1783","003900380031004e","9800",元大-金門,0,4,4,-1,5.41
"20201022","1783","0038003100350041","8150",台新-高雄,2,0,2,1,2.70
"20201022","1783","9884","9800",元大-斗信,0,4,4,-1,5.41
"20201022","1783","9672","9600",富邦-員林,2,0,2,1,2.70
"20201022","1783","003900310038004a","9100",群益金鼎-永和,0,3,3,-1,4.05
"20201022","1783","0037003000300046","7000",兆豐-虎尾,1,0,1,1,1.35
"20201022","1783","9323","9300",華南永昌-小港,0,3,3,-1,4.05
"20201022","1783","0036003000310064","6010",(牛牛牛)亞-鑫豐,1,0,1,1,1.35
"20201022","1783","9800","9800",元大證券,0,3,3,-1,4.05
"20201022","1783","0035003800350044","5850",統一-新台中,1,0,1,1,1.35
"20201022","1783","0039003200300047","9200",凱基-彰化,0,2,2,-1,2.70
"20201022","1783","003900310038004c","9100",群益金鼎-建成,1,0,1,1,1.35
"20201022","1783","9285","9200",凱基-中壢,0,2,2,-1,2.70
"20201022","1783","8885","8880",國泰-桃園,1,0,1,1,1.35
"20201022","1783","0039004100390073","9A00",永豐金-彰化,0,2,2,-1,2.70
"20201022","1783","9208","9200",凱基-桃園,1,0,1,1,1.35
"20201022","1783","0038003400350044","8450",康和-板橋,0,1,1,-1,1.35
"20201022","1783","0039003600310045","9600",富邦-府城,1,0,1,1,1.35
"20201022","1783","9135","9100",群益金鼎-東大,0,1,1,-1,1.35
"20201023","1783","9268","9200",凱基-台北,10,1,9,1,10.11
"20201023","1783","8843","8840",玉山-高雄,0,8,8,-1,8.99
"20201023","1783","1440","1440",美林,7,0,7,1,7.87
"20201023","1783","8562","8560",新光-高雄,0,6,6,-1,6.74
"20201023","1783","1114","1110",台灣企銀-嘉義,7,0,7,1,7.87
"20201023","1783","0039003200320043","9200",凱基-屏東,0,6,6,-1,6.74
"20201023","1783","0039003600310045","9600",富邦-府城,4,0,4,1,4.49
"20201023","1783","9319","9300",華南永昌-鶯歌,0,6,6,-1,6.74
"20201023","1783","1031","1030",土銀-台中,3,0,3,1,3.37
"20201023","1783","0037003000300047","7000",兆豐-麻豆,0,5,5,-1,5.62
"20201023","1783","0039003100380067","9100",群益金鼎-大甲,3,0,3,1,3.37
"20201023","1783","0039003800310045","9800",元大-發財,0,5,5,-1,5.62
"20201023","1783","9838","9800",元大-豐原,3,0,3,1,3.37
"20201023","1783","0035003800350059","5850",統一-土城,0,4,4,-1,4.49
"20201023","1783","9229","9200",凱基-中山,2,0,2,1,2.25
"20201023","1783","9137","9100",群益金鼎-士林,0,4,4,-1,4.49
"20201023","1783","9252","9200",凱基-嘉義,2,0,2,1,2.25
"20201023","1783","9817","9800",元大-東泰,0,4,4,-1,4.49
"20201023","1783","5850","5850",統一,1,0,1,1,1.12
"20201023","1783","5855","5850",統一-台南,0,2,2,-1,2.25
"20201023","1783","1520","1520",瑞士信貸,1,0,1,1,1.12
"20201023","1783","6463","6460",大昌-新竹,0,2,2,-1,2.25
"20201023","1783","003500390032006c","5920",元富-大裕,1,0,1,1,1.12
"20201023","1783","003900360031004e","9600",富邦-西壢,0,2,2,-1,2.25
"20201023","1783","003500380035004a","5850",統一-三重,1,0,1,1,1.12
"20201023","1783","0039003800310067","9800",元大-大里,0,2,2,-1,2.25
"20201023","1783","0037003000300050","7000",兆豐-南京,1,0,1,1,1.12
"20201023","1783","003900410039004d","9A00",永豐金-南投,0,2,2,-1,2.25
"20201026","1783","0039003600310045","9600",富邦-府城,6,0,6,1,10.34
"20201026","1783","1440","1440",美林,0,6,6,-1,10.34
"20201026","1783","0035003900320049","5920",元富-嘉義,3,0,3,1,5.17
"20201026","1783","0037003000300070","7000",兆豐-復興,0,6,6,-1,10.34
"20201026","1783","1114","1110",台灣企銀-嘉義,3,0,3,1,5.17
"20201026","1783","6950","6950",福勝,0,4,4,-1,6.90
"20201026","1783","8882","8880",國泰-台中,3,0,3,1,5.17
"20201026","1783","5921","5920",元富-高雄,0,3,3,-1,5.17
"20201026","1783","9134","9100",群益金鼎-開元,2,0,2,1,3.45
"20201026","1783","003900380033004b","9800",元大-學甲,0,3,3,-1,5.17
"20201026","1783","9208","9200",凱基-桃園,2,0,2,1,3.45
"20201026","1783","1520","1520",瑞士信貸,0,2,2,-1,3.45
"20201026","1783","9257","9200",凱基-林口,2,0,2,1,3.45
"20201026","1783","7795","7790",國票-南港,0,2,2,-1,3.45
"20201026","1783","0039003800310047","9800",元大-彰化,2,0,2,1,3.45
"20201026","1783","9834","9800",元大-中壢,0,2,2,-1,3.45
"20201026","1783","003900410039004a","9A00",永豐金-板新,2,0,2,1,3.45
"20201026","1783","1470","1470",台灣摩根士丹利,0,1,1,-1,1.72
"20201026","1783","5857","5850",統一-新竹,1,0,1,1,1.72
"20201026","1783","003500390032006c","5920",元富-大裕,0,1,1,-1,1.72
"20201026","1783","0036003000310064","6010",(牛牛牛)亞-鑫豐,1,0,1,1,1.72
"20201026","1783","5920","5920",元富,0,1,1,-1,1.72
"20201026","1783","6381","6380",光和-溪湖,1,0,1,1,1.72
"20201026","1783","0037003000300050","7000",兆豐-南京,0,1,1,-1,1.72
"20201026","1783","8440","8440",摩根大通,1,0,1,1,1.72
"20201026","1783","6110","6110",台中銀,0,1,1,-1,1.72
"20201026","1783","9131","9100",群益金鼎-民權,1,0,1,1,1.72
"20201026","1783","8150","8150",台新證券,0,1,1,-1,1.72
"20201027","1783","9208","9200",凱基-桃園,3,0,3,1,5.77
"20201027","1783","0037003000300047","7000",兆豐-麻豆,0,4,4,-1,7.69
"20201027","1783","5927","5920",元富-林園,2,0,2,1,3.85
"20201027","1783","0039003200300057","9200",凱基-大里,0,3,3,-1,5.77
"20201027","1783","0039003100380047","9100",群益金鼎-新莊,7,5,2,1,3.85
"20201027","1783","9800","9800",元大證券,0,3,3,-1,5.77
"20201027","1783","0039004100390071","9A00",永豐金-潮州,2,0,2,1,3.85
"20201027","1783","0039003800390045","9800",元大-草屯,0,3,3,-1,5.77
"20201027","1783","003500330038004d","5380",第一金-嘉義,1,0,1,1,1.92
"20201027","1783","1520","1520",瑞士信貸,0,2,2,-1,3.85
"20201027","1783","5383","5380",第一金-高雄,1,0,1,1,1.92
"20201027","1783","5320","5320",高橋,0,2,2,-1,3.85
"20201027","1783","5323","5320",高橋-內壢,1,0,1,1,1.92
"20201027","1783","0037003000300072","7000",兆豐-寶成,0,2,2,-1,3.85
"20201027","1783","5266","5260",美好-中壢,1,0,1,1,1.92
"20201027","1783","8150","8150",台新證券,0,2,2,-1,3.85
"20201027","1783","1440","1440",美林,2,1,1,1,1.92
"20201027","1783","0039003100330048","9100",群益金鼎-屏東,0,2,2,-1,3.85
"20201027","1783","0035003900320079","5920",元富-花蓮,1,0,1,1,1.92
"20201027","1783","0039003800300051","9800",元大-南崁,0,2,2,-1,3.85
"20201027","1783","0035003900320044","5920",元富-大昌,1,0,1,1,1.92
"20201027","1783","9854","9800",元大-文心興安,0,2,2,-1,3.85
"20201027","1783","003700300030006b","7000",兆豐-員林,1,0,1,1,1.92
"20201027","1783","5857","5850",統一-新竹,0,1,1,-1,1.92
"20201027","1783","0037003700390076","7790",國票-台中,1,0,1,1,1.92
"20201027","1783","6463","6460",大昌-新竹,0,1,1,-1,1.92
"20201027","1783","8440","8440",摩根大通,1,0,1,1,1.92
"20201027","1783","1031","1030",土銀-台中,0,1,1,-1,1.92
"20201028","1783","1042","1040",臺銀-臺南,10,0,10,1,10.53
"20201028","1783","1520","1520",瑞士信貸,0,11,11,-1,11.58
"20201028","1783","8560","8560",新光,5,0,5,1,5.26
"20201028","1783","003900410039004a","9A00",永豐金-板新,0,9,9,-1,9.47
"20201028","1783","9312","9300",華南永昌-民權,5,0,5,1,5.26
"20201028","1783","9200","9200",凱基,0,6,6,-1,6.32
"20201028","1783","9257","9200",凱基-林口,3,0,3,1,3.16
"20201028","1783","0039003100380041","9100",群益金鼎-中壢,0,5,5,-1,5.26
"20201028","1783","9302","9300",華南永昌-台中,3,0,3,1,3.16
"20201028","1783","0039003100380044","9100",群益金鼎-東門,0,5,5,-1,5.26
"20201028","1783","9672","9600",富邦-員林,3,0,3,1,3.16
"20201028","1783","0039003100330048","9100",群益金鼎-屏東,0,3,3,-1,3.16
"20201028","1783","9838","9800",元大-豐原,3,0,3,1,3.16
"20201028","1783","9871","9800",元大-忠孝,0,3,3,-1,3.16
"20201028","1783","7005","7000",兆豐-台中港,2,0,2,1,2.11
"20201028","1783","9892","9800",元大-屏東,0,3,3,-1,3.16
"20201028","1783","8563","8560",新光-新竹,2,0,2,1,2.11
"20201028","1783","7798","7790",國票-內壢,0,2,2,-1,2.11
"20201028","1783","8842","8840",玉山-新莊,2,0,2,1,2.11
"20201028","1783","1440","1440",美林,0,2,2,-1,2.11
"20201028","1783","8882","8880",國泰-台中,2,0,2,1,2.11
"20201028","1783","9316","9300",華南永昌-淡水,0,2,2,-1,2.11
"20201028","1783","0039003100380045","9100",群益金鼎-南京,2,0,2,1,2.11
"20201028","1783","0036003100310041","6110",台中銀-豐原,0,1,1,-1,1.05
"20201028","1783","9208","9200",凱基-桃園,3,1,2,1,2.11
"20201028","1783","003500390032006c","5920",元富-大裕,0,1,1,-1,1.05
"20201028","1783","0039003600310045","9600",富邦-府城,2,0,2,1,2.11
"20201028","1783","0037003700390065","7790",國票-南科,0,1,1,-1,1.05
"20201029","1783","0035003900320057","5920",元富-吉利,25,0,25,1,2.08
"20201029","1783","8156","8150",台新-三民,0,35,35,-1,2.91
"20201029","1783","9300","9300",華南永昌,20,0,20,1,1.66
"20201029","1783","9322","9300",華南永昌-公誠,0,30,30,-1,2.49
"20201029","1783","8560","8560",新光,16,0,16,1,1.33
"20201029","1783","1470","1470",台灣摩根士丹利,0,24,24,-1,2.00
"20201029","1783","9661","9600",富邦-新店,10,0,10,1,0.83
"20201029","1783","9315","9300",華南永昌-苑裡,2,22,20,-1,1.66
"20201029","1783","9838","9800",元大-豐原,9,0,9,1,0.75
"20201029","1783","8583","8580",聯邦-忠孝,0,13,13,-1,1.08
"20201029","1783","0039003800390051","9800",元大-汐止,8,0,8,1,0.67
"20201029","1783","1520","1520",瑞士信貸,0,12,12,-1,1.00
"20201029","1783","2187","2180",亞東-台中,6,0,6,1,0.50
"20201029","1783","8880","8880",國泰證券,1,10,9,-1,0.75
"20201029","1783","9359","9300",華南永昌-中正,6,0,6,1,0.50
"20201029","1783","9817","9800",元大-東泰,12,21,9,-1,0.75
"20201029","1783","003500320036004b","5260",美好-富順,5,0,5,1,0.42
"20201029","1783","0035003800350067","5850",統一-平鎮,0,8,8,-1,0.67
"20201029","1783","5262","5260",美好-楊梅,5,0,5,1,0.42
"20201029","1783","0039003200300057","9200",凱基-大里,5,12,7,-1,0.58
"20201029","1783","0035003900320044","5920",元富-大昌,5,0,5,1,0.42
"20201029","1783","0039003800310061","9800",元大-歸仁,4,11,7,-1,0.58
"20201029","1783","0038003100350041","8150",台新-高雄,5,0,5,1,0.42
"20201029","1783","0037003700390065","7790",國票-南科,0,4,4,-1,0.33
"20201029","1783","9283","9200",凱基-北門,5,0,5,1,0.42
"20201029","1783","9268","9200",凱基-台北,9,13,4,-1,0.33
"20201029","1783","9369","9300",華南永昌-三重,6,1,5,1,0.42
"20201029","1783","0039003600320059","9600",富邦-土城,0,4,4,-1,0.33
"20201030","1783","1260","1260",宏遠證券,12,0,12,1,11.21
"20201030","1783","0035003300380043","5380",第一金-光復,0,10,10,-1,9.35
"20201030","1783","9324","9300",華南永昌-岡山,10,0,10,1,9.35
"20201030","1783","2187","2180",亞東-台中,0,9,9,-1,8.41
"20201030","1783","9838","9800",元大-豐原,8,0,8,1,7.48
"20201030","1783","0039004100390066","9A00",永豐金-中盛,0,9,9,-1,8.41
"20201030","1783","0036003100310041","6110",台中銀-豐原,6,0,6,1,5.61
"20201030","1783","1440","1440",美林,0,7,7,-1,6.54
"20201030","1783","9268","9200",凱基-台北,6,0,6,1,5.61
"20201030","1783","003900360032004c","9600",富邦-雙和,1,6,5,-1,4.67
"20201030","1783","0031003000320043","1020",合庫-自強,5,0,5,1,4.67
"20201030","1783","0039003800330056","9800",元大-竹南,0,5,5,-1,4.67
"20201030","1783","8888","8880",國泰-敦南,3,1,2,1,1.87
"20201030","1783","9891","9800",元大-永和,0,5,5,-1,4.67
"20201030","1783","1520","1520",瑞士信貸,2,0,2,1,1.87
"20201030","1783","0039003800390049","9800",元大-蘆洲,0,4,4,-1,3.74
"20201030","1783","003700300030005a","7000",兆豐-高雄,2,0,2,1,1.87
"20201030","1783","1590","1590",花旗環球,0,2,2,-1,1.87
"20201030","1783","8882","8880",國泰-台中,2,0,2,1,1.87
"20201030","1783","9283","9200",凱基-北門,1,3,2,-1,1.87
"20201030","1783","9211","9200",凱基-台南,2,0,2,1,1.87
"20201030","1783","9835","9800",元大-員林中山,0,2,2,-1,1.87
"20201030","1783","003800380038004b","8880",國泰-板橋,1,0,1,1,0.93
"20201030","1783","0035003300380046","5380",第一金-大稻埕,0,1,1,-1,0.93
"20201030","1783","0031003000340041","1040",臺銀-臺中,1,0,1,1,0.93
"20201030","1783","5261","5260",美好-蘆洲,0,1,1,-1,0.93
"20201030","1783","5460","5460",寶盛,1,0,1,1,0.93
"20201030","1783","0031003200360058","1260",宏遠-新化,0,1,1,-1,0.93
"20200901","1783","0039003800390051","9800",元大-汐止,10,0,10,1,4.69
"20200901","1783","8440","8440",摩根大通,0,23,23,-1,10.80
"20200901","1783","9817","9800",元大-東泰,8,0,8,1,3.76
"20200901","1783","9206","9200",凱基-高雄,1,23,22,-1,10.33
"20200901","1783","9604","9600",富邦-陽明,7,0,7,1,3.29
"20200901","1783","1560","1560",港商野村,0,10,10,-1,4.69
"20200901","1783","9894","9800",元大-桃興,6,0,6,1,2.82
"20200901","1783","0039003600310043","9600",富邦-南京,0,10,10,-1,4.69
"20200901","1783","0037003700390058","7790",國票-中和,5,0,5,1,2.35
"20200901","1783","0039003600310048","9600",富邦-新板,0,10,10,-1,4.69
"20200901","1783","8560","8560",新光,5,0,5,1,2.35
"20200901","1783","0039004100380046","9A00",永豐金-敦南,0,10,10,-1,4.69
"20200901","1783","9283","9200",凱基-北門,5,0,5,1,2.35
"20200901","1783","1520","1520",瑞士信貸,3,11,8,-1,3.76
"20200901","1783","0039003800310053","9800",元大-崇德,5,0,5,1,2.35
"20200901","1783","1440","1440",美林,13,18,5,-1,2.35
"20200901","1783","0035003300380057","5380",第一金-華江,4,0,4,1,1.88
"20200901","1783","0039003800310068","9800",元大-屏東民生,0,5,5,-1,2.35
"20200901","1783","003500330038006a","5380",第一金-安和,4,0,4,1,1.88
"20200901","1783","0039004100390042","9A00",永豐金-中和,0,5,5,-1,2.35
"20200901","1783","0035003900320045","5920",元富-城中,4,0,4,1,1.88
"20200901","1783","1470","1470",台灣摩根士丹利,0,4,4,-1,1.88
"20200901","1783","0039003800310042","9800",元大-竹北,4,0,4,1,1.88
"20200901","1783","6910","6910",德信,0,4,4,-1,1.88
"20200901","1783","0035003900320044","5920",元富-大昌,5,2,3,1,1.41
"20200901","1783","0039003100380047","9100",群益金鼎-新莊,0,3,3,-1,1.41
"20200901","1783","003700300030005a","7000",兆豐-高雄,3,0,3,1,1.41
"20200901","1783","0037003700390047","7790",國票-新莊,0,2,2,-1,0.94
"20200902","1783","1560","1560",港商野村,12,0,12,1,8.76
"20200902","1783","0039003200300057","9200",凱基-大里,0,15,15,-1,10.95
"20200902","1783","1650","1650",新加坡商瑞銀,12,0,12,1,8.76
"20200902","1783","0039003600320045","9600",富邦-樹林,0,10,10,-1,7.30
"20200902","1783","8848","8840",玉山-嘉義,7,0,7,1,5.11
"20200902","1783","1045","1040",臺銀-新竹,0,5,5,-1,3.65
"20200902","1783","003900310038004d","9100",群益金鼎-嘉義,6,0,6,1,4.38
"20200902","1783","0037003700390058","7790",國票-中和,0,5,5,-1,3.65
"20200902","1783","9268","9200",凱基-台北,13,8,5,1,3.65
"20200902","1783","1470","1470",台灣摩根士丹利,0,4,4,-1,2.92
"20200902","1783","5460","5460",寶盛,4,0,4,1,2.92
"20200902","1783","0035003900320045","5920",元富-城中,0,4,4,-1,2.92
"20200902","1783","1260","1260",宏遠證券,4,0,4,1,2.92
"20200902","1783","8887","8880",國泰-忠孝,0,4,4,-1,2.92
"20200902","1783","8440","8440",摩根大通,5,1,4,1,2.92
"20200902","1783","9339","9300",華南永昌-竹北,0,4,4,-1,2.92
"20200902","1783","9322","9300",華南永昌-公誠,5,1,4,1,2.92
"20200902","1783","003900360031004d","9600",富邦-木柵,0,4,4,-1,2.92
"20200902","1783","6114","6110",台中銀-員林,3,0,3,1,2.19
"20200902","1783","003900320030004e","9200",凱基-湖口,0,3,3,-1,2.19
"20200902","1783","1440","1440",美林,7,5,2,1,1.46
"20200902","1783","9377","9300",華南永昌-虎尾,0,3,3,-1,2.19
"20200902","1783","6460","6460",大昌,2,0,2,1,1.46
"20200902","1783","003500330038006a","5380",第一金-安和,0,2,2,-1,1.46
"20200902","1783","0038003800340045","8840",玉山-城中,2,0,2,1,1.46
"20200902","1783","1023","1020",合庫-高雄,0,2,2,-1,1.46
"20200902","1783","9275","9200",凱基-三多,2,0,2,1,1.46
"20200902","1783","5928","5920",元富-新莊,0,2,2,-1,1.46
"20200903","1783","9676","9600",富邦-仁愛,20,0,20,1,15.15
"20200903","1783","9800","9800",元大證券,0,12,12,-1,9.09
"20200903","1783","9105","9100",群益金鼎-高盛,10,0,10,1,7.58
"20200903","1783","0039003800300064","9800",元大-沙鹿,0,10,10,-1,7.58
"20200903","1783","8840","8840",玉山證券,6,0,6,1,4.55
"20200903","1783","0039003800310061","9800",元大-歸仁,0,10,10,-1,7.58
"20200903","1783","1650","1650",新加坡商瑞銀,5,0,5,1,3.79
"20200903","1783","1520","1520",瑞士信貸,2,8,6,-1,4.55
"20200903","1783","8560","8560",新光,5,0,5,1,3.79
"20200903","1783","9377","9300",華南永昌-虎尾,0,6,6,-1,4.55
"20200903","1783","9229","9200",凱基-中山,5,0,5,1,3.79
"20200903","1783","0035003300380050","5380",第一金-路竹,0,5,5,-1,3.79
"20200903","1783","0039003800370041","9800",元大-楊梅,5,0,5,1,3.79
"20200903","1783","9835","9800",元大-員林中山,0,5,5,-1,3.79
"20200903","1783","9223","9200",凱基-豐中,4,0,4,1,3.03
"20200903","1783","0039003100380073","9100",群益金鼎-丹鳳,0,4,4,-1,3.03
"20200903","1783","0035003800350059","5850",統一-土城,3,0,3,1,2.27
"20200903","1783","003500330038006a","5380",第一金-安和,0,3,3,-1,2.27
"20200903","1783","0035003300380057","5380",第一金-華江,3,1,2,1,1.52
"20200903","1783","5927","5920",元富-林園,0,2,2,-1,1.52
"20200903","1783","1470","1470",台灣摩根士丹利,2,0,2,1,1.52
"20200903","1783","8440","8440",摩根大通,2,4,2,-1,1.52
"20200903","1783","0038003800340045","8840",玉山-城中,2,0,2,1,1.52
"20200903","1783","8880","8880",國泰證券,1,3,2,-1,1.52
"20200903","1783","003900360035004b","9600",富邦-台中,2,0,2,1,1.52
"20200903","1783","8888","8880",國泰-敦南,0,2,2,-1,1.52
"20200903","1783","9817","9800",元大-東泰,2,0,2,1,1.52
"20200903","1783","0039003100380047","9100",群益金鼎-新莊,0,2,2,-1,1.52
"20200904","1783","0035003900320057","5920",元富-吉利,15,0,15,1,2.19
"20200904","1783","9800","9800",元大證券,1,30,29,-1,4.23
"20200904","1783","8848","8840",玉山-嘉義,15,0,15,1,2.19
"20200904","1783","9268","9200",凱基-台北,19,38,19,-1,2.77
"20200904","1783","0039003200300041","9200",凱基-板橋,14,0,14,1,2.04
"20200904","1783","1560","1560",港商野村,3,14,11,-1,1.61
"20200904","1783","9322","9300",華南永昌-公誠,7,1,6,1,0.88
"20200904","1783","1650","1650",新加坡商瑞銀,0,10,10,-1,1.46
"20200904","1783","003900320030005a","9200",凱基-台東,5,0,5,1,0.73
"20200904","1783","9623","9600",富邦-台北,2,10,8,-1,1.17
"20200904","1783","0039003800310053","9800",元大-崇德,5,0,5,1,0.73
"20200904","1783","5850","5850",統一,0,6,6,-1,0.88
"20200904","1783","9359","9300",華南永昌-中正,4,0,4,1,0.58
"20200904","1783","0039003100380047","9100",群益金鼎-新莊,0,6,6,-1,0.88
"20200904","1783","5260","5260",美好,3,0,3,1,0.44
"20200904","1783","9817","9800",元大-東泰,2,8,6,-1,0.88
"20200904","1783","9655","9600",富邦-板橋,3,0,3,1,0.44
"20200904","1783","0035003900320045","5920",元富-城中,5,10,5,-1,0.73
"20200904","1783","9697","9600",富邦-虎尾,2,0,2,1,0.29
"20200904","1783","0035003900320050","5920",元富-同大,0,5,5,-1,0.73
"20200904","1783","0035003900320049","5920",元富-嘉義,2,0,2,1,0.29
"20200904","1783","003700300030004e","7000",兆豐-埔墘,0,5,5,-1,0.73
"20200904","1783","003500390032007a","5920",元富-文心,2,0,2,1,0.29
"20200904","1783","0037003700390063","7790",國票-敦北法人,0,4,4,-1,0.58
"20200904","1783","6950","6950",福勝,2,0,2,1,0.29
"20200904","1783","0039003600310047","9600",富邦-成功,0,4,4,-1,0.58
"20200904","1783","9134","9100",群益金鼎-開元,2,0,2,1,0.29
"20200904","1783","1520","1520",瑞士信貸,1,4,3,-1,0.44
"20200907","1783","9268","9200",凱基-台北,18,3,15,1,10.14
"20200907","1783","5382","5380",第一金-台中,0,13,13,-1,8.78
"20200907","1783","9105","9100",群益金鼎-高盛,10,0,10,1,6.76
"20200907","1783","0039003600320046","9600",富邦-北桃園(停),0,11,11,-1,7.43
"20200907","1783","0039003100380047","9100",群益金鼎-新莊,8,0,8,1,5.41
"20200907","1783","0039003200300057","9200",凱基-大里,0,8,8,-1,5.41
"20200907","1783","9134","9100",群益金鼎-開元,7,0,7,1,4.73
"20200907","1783","2180","2180",亞東,0,6,6,-1,4.05
"20200907","1783","1440","1440",美林,8,3,5,1,3.38
"20200907","1783","0039003100380067","9100",群益金鼎-大甲,0,6,6,-1,4.05
"20200907","1783","003900320030005a","9200",凱基-台東,5,0,5,1,3.38
"20200907","1783","0035003900320061","5920",元富-松德,0,5,5,-1,3.38
"20200907","1783","0039003200310053","9200",凱基-幸福,5,0,5,1,3.38
"20200907","1783","0031003000330046","1030",土銀-南港,0,4,4,-1,2.70
"20200907","1783","003900360035004b","9600",富邦-台中,5,0,5,1,3.38
"20200907","1783","0037003700390065","7790",國票-南科,0,4,4,-1,2.70
"20200907","1783","1470","1470",台灣摩根士丹利,5,2,3,1,2.03
"20200907","1783","1650","1650",新加坡商瑞銀,0,3,3,-1,2.03
"20200907","1783","6450","6450",永全證券,4,1,3,1,2.03
"20200907","1783","8881","8880",國泰-高雄,0,3,3,-1,2.03
"20200907","1783","5265","5260",美好-苗栗,2,0,2,1,1.35
"20200907","1783","9234","9200",凱基-竹北,0,3,3,-1,2.03
"20200907","1783","0036003000310064","6010",(牛牛牛)亞-鑫豐,3,1,2,1,1.35
"20200907","1783","8150","8150",台新證券,0,2,2,-1,1.35
"20200907","1783","8880","8880",國泰證券,2,0,2,1,1.35
"20200907","1783","003900310038004a","9100",群益金鼎-永和,0,2,2,-1,1.35
"20200907","1783","0039003600310053","9600",富邦-景美,2,0,2,1,1.35
"20200907","1783","0039004100390055","9A00",永豐金-中正,0,2,2,-1,1.35
"20200908","1783","5389","5380",第一金-中山,20,0,20,1,2.56
"20200908","1783","9817","9800",元大-東泰,3,20,17,-1,2.18
"20200908","1783","0037003000300070","7000",兆豐-復興,20,0,20,1,2.56
"20200908","1783","1470","1470",台灣摩根士丹利,0,16,16,-1,2.05
"20200908","1783","9319","9300",華南永昌-鶯歌,20,0,20,1,2.56
"20200908","1783","9835","9800",元大-員林中山,0,15,15,-1,1.92
"20200908","1783","0031003200360055","1260",宏遠-館前,18,0,18,1,2.30
"20200908","1783","1650","1650",新加坡商瑞銀,0,13,13,-1,1.66
"20200908","1783","9647","9600",富邦-新竹,11,0,11,1,1.41
"20200908","1783","0035003900320058","5920",元富-草屯,0,10,10,-1,1.28
"20200908","1783","8440","8440",摩根大通,30,20,10,1,1.28
"20200908","1783","9308","9300",華南永昌-麻豆,0,10,10,-1,1.28
"20200908","1783","9654","9600",富邦-永和,10,0,10,1,1.28
"20200908","1783","9352","9300",華南永昌-桃園,0,9,9,-1,1.15
"20200908","1783","0039003800380042","9800",元大-桃園,10,0,10,1,1.28
"20200908","1783","0035003900320045","5920",元富-城中,10,18,8,-1,1.02
"20200908","1783","9208","9200",凱基-桃園,10,1,9,1,1.15
"20200908","1783","8882","8880",國泰-台中,0,7,7,-1,0.90
"20200908","1783","9229","9200",凱基-中山,8,0,8,1,1.02
"20200908","1783","003700300030004b","7000",兆豐-新營,0,6,6,-1,0.77
"20200908","1783","0039003800310046","9800",元大-福營,7,0,7,1,0.90
"20200908","1783","003900310038004d","9100",群益金鼎-嘉義,0,6,6,-1,0.77
"20200908","1783","8560","8560",新光,12,6,6,1,0.77
"20200908","1783","9266","9200",凱基-新豐,0,6,6,-1,0.77
"20200908","1783","0039003600320045","9600",富邦-樹林,10,4,6,1,0.77
"20200908","1783","003900360035004b","9600",富邦-台中,0,6,6,-1,0.77
"20200908","1783","5267","5260",美好-基隆,5,0,5,1,0.64
"20200908","1783","1045","1040",臺銀-新竹,0,5,5,-1,0.64
"20200909","1783","0039004100390058","9A00",永豐金-竹科,17,0,17,1,5.67
"20200909","1783","9634","9600",富邦-羅東,8,29,21,-1,7.00
"20200909","1783","0037003700390076","7790",國票-台中,10,0,10,1,3.33
"20200909","1783","1440","1440",美林,1,21,20,-1,6.67
"20200909","1783","8560","8560",新光,8,1,7,1,2.33
"20200909","1783","0035003900320055","5920",元富-宜蘭,10,30,20,-1,6.67
"20200909","1783","9322","9300",華南永昌-公誠,5,0,5,1,1.67
"20200909","1783","0039003600320045","9600",富邦-樹林,0,10,10,-1,3.33
"20200909","1783","5460","5460",寶盛,4,0,4,1,1.33
"20200909","1783","9208","9200",凱基-桃園,0,9,9,-1,3.00
"20200909","1783","0036003000310064","6010",(牛牛牛)亞-鑫豐,4,0,4,1,1.33
"20200909","1783","1470","1470",台灣摩根士丹利,2,10,8,-1,2.67
"20200909","1783","0038003100350041","8150",台新-高雄,4,0,4,1,1.33
"20200909","1783","0039003800380042","9800",元大-桃園,0,5,5,-1,1.67
"20200909","1783","8440","8440",摩根大通,4,0,4,1,1.33
"20200909","1783","0038003800340041","8840",玉山-士林,0,3,3,-1,1.00
"20200909","1783","9101","9100",群益金鼎-敦南,4,0,4,1,1.33
"20200909","1783","0039003800310061","9800",元大-歸仁,0,3,3,-1,1.00
"20200909","1783","9817","9800",元大-東泰,10,6,4,1,1.33
"20200909","1783","5927","5920",元富-林園,0,2,2,-1,0.67
"20200909","1783","0036003300380041","6380",光和-嘉義,3,0,3,1,1.00
"20200909","1783","0035003900320062","5920",元富-板橋,0,2,2,-1,0.67
"20200909","1783","0039003800310046","9800",元大-福營,3,0,3,1,1.00
"20200909","1783","0035003900320067","5920",元富-中原,0,2,2,-1,0.67
"20200909","1783","1020","1020",合庫證券,2,0,2,1,0.67
"20200909","1783","0036003100310041","6110",台中銀-豐原,0,2,2,-1,0.67
"20200909","1783","0035003300380057","5380",第一金-華江,3,1,2,1,0.67
"20200909","1783","8159","8150",台新-台南,0,2,2,-1,0.67
"20200910","1783","0039003800310046","9800",元大-福營,10,0,10,1,5.62
"20200910","1783","1440","1440",美林,0,12,12,-1,6.74
"20200910","1783","0037003000300050","7000",兆豐-南京,5,0,5,1,2.81
"20200910","1783","1470","1470",台灣摩根士丹利,0,8,8,-1,4.49
"20200910","1783","9317","9300",華南永昌-林口,5,0,5,1,2.81
"20200910","1783","5266","5260",美好-中壢,0,8,8,-1,4.49
"20200910","1783","0039004100390055","9A00",永豐金-中正,5,0,5,1,2.81
"20200910","1783","9800","9800",元大證券,0,6,6,-1,3.37
"20200910","1783","0031003200360055","1260",宏遠-館前,4,0,4,1,2.25
"20200910","1783","0035003800350046","5850",統一-彰化,0,5,5,-1,2.81
"20200910","1783","0036003300380041","6380",光和-嘉義,3,0,3,1,1.69
"20200910","1783","7032","7030",致和-佳里,0,5,5,-1,2.81
"20200910","1783","0039003100330049","9100",群益金鼎-萬華,3,0,3,1,1.69
"20200910","1783","0039003200310053","9200",凱基-幸福,0,5,5,-1,2.81
"20200910","1783","0035003900320047","5920",元富-新竹,2,0,2,1,1.12
"20200910","1783","0039003600320045","9600",富邦-樹林,0,5,5,-1,2.81
"20200910","1783","6913","6910",德信-新營,2,0,2,1,1.12
"20200910","1783","0039003800380042","9800",元大-桃園,0,5,5,-1,2.81
"20200910","1783","7006","7000",兆豐-台南,2,0,2,1,1.12
"20200910","1783","0036003000310064","6010",(牛牛牛)亞-鑫豐,0,4,4,-1,2.25
"20200910","1783","0039003100380047","9100",群益金鼎-新莊,3,1,2,1,1.12
"20200910","1783","6450","6450",永全證券,0,4,4,-1,2.25
"20200910","1783","003900310038004d","9100",群益金鼎-嘉義,2,0,2,1,1.12
"20200910","1783","6464","6460",大昌-新店,0,3,3,-1,1.69
"20200910","1783","9835","9800",元大-員林中山,2,0,2,1,1.12
"20200910","1783","8843","8840",玉山-高雄,0,3,3,-1,1.69
"20200910","1783","0039004100390050","9A00",永豐金-竹北,2,0,2,1,1.12
"20200910","1783","9302","9300",華南永昌-台中,0,3,3,-1,1.69
"20200911","1783","0035003900320057","5920",元富-吉利,15,0,15,1,6.22
"20200911","1783","0031003200360055","1260",宏遠-館前,0,29,29,-1,12.03
"20200911","1783","9134","9100",群益金鼎-開元,10,0,10,1,4.15
"20200911","1783","0038003800340046","8840",玉山-桃園,0,26,26,-1,10.79
"20200911","1783","003900360031004b","9600",富邦-七賢,10,0,10,1,4.15
"20200911","1783","9834","9800",元大-中壢,0,24,24,-1,9.96
"20200911","1783","5389","5380",第一金-中山,8,0,8,1,3.32
"20200911","1783","1520","1520",瑞士信貸,5,27,22,-1,9.13
"20200911","1783","9285","9200",凱基-中壢,8,0,8,1,3.32
"20200911","1783","9697","9600",富邦-虎尾,0,11,11,-1,4.56
"20200911","1783","0035003900320044","5920",元富-大昌,5,0,5,1,2.07
"20200911","1783","9302","9300",華南永昌-台中,0,10,10,-1,4.15
"20200911","1783","0035003900320045","5920",元富-城中,6,1,5,1,2.07
"20200911","1783","003900360032004c","9600",富邦-雙和,0,10,10,-1,4.15
"20200911","1783","0035003900320055","5920",元富-宜蘭,5,0,5,1,2.07
"20200911","1783","0039004100390055","9A00",永豐金-中正,0,5,5,-1,2.07
"20200911","1783","9233","9200",凱基-長庚,5,0,5,1,2.07
"20200911","1783","0037003000300047","7000",兆豐-麻豆,1,5,4,-1,1.66
"20200911","1783","9283","9200",凱基-北門,5,0,5,1,2.07
"20200911","1783","1560","1560",港商野村,0,3,3,-1,1.24
"20200911","1783","8840","8840",玉山證券,6,2,4,1,1.66
"20200911","1783","0036003300380041","6380",光和-嘉義,0,3,3,-1,1.24
"20200911","1783","003700300030005a","7000",兆豐-高雄,3,0,3,1,1.24
"20200911","1783","1470","1470",台灣摩根士丹利,1,3,2,-1,0.83
"20200911","1783","8581","8580",聯邦-高雄,3,0,3,1,1.24
"20200911","1783","8440","8440",摩根大通,0,2,2,-1,0.83
"20200911","1783","9108","9100",群益金鼎-海山,3,0,3,1,1.24
"20200911","1783","9234","9200",凱基-竹北,0,2,2,-1,0.83
"20200914","1783","9105","9100",群益金鼎-高盛,10,0,10,1,6.06
"20200914","1783","8156","8150",台新-三民,0,10,10,-1,6.06
"20200914","1783","0039003200310053","9200",凱基-幸福,10,0,10,1,6.06
"20200914","1783","0039003800330056","9800",元大-竹南,0,10,10,-1,6.06
"20200914","1783","0039003800310070","9800",元大-松山,10,0,10,1,6.06
"20200914","1783","5389","5380",第一金-中山,0,8,8,-1,4.85
"20200914","1783","0037003000300047","7000",兆豐-麻豆,9,0,9,1,5.45
"20200914","1783","0031003100310045","1110",台灣企銀-桃園,0,5,5,-1,3.03
"20200914","1783","1440","1440",美林,8,0,8,1,4.85
"20200914","1783","0035003900320044","5920",元富-大昌,0,5,5,-1,3.03
"20200914","1783","8440","8440",摩根大通,8,2,6,1,3.64
"20200914","1783","5960","5960",日茂,0,4,4,-1,2.42
"20200914","1783","0039003800310047","9800",元大-彰化,5,0,5,1,3.03
"20200914","1783","0036003300380041","6380",光和-嘉義,0,4,4,-1,2.42
"20200914","1783","1040","1040",臺銀,5,0,5,1,3.03
"20200914","1783","9858","9800",元大-龍潭,0,4,4,-1,2.42
"20200914","1783","6451","6450",永全-南崁,3,0,3,1,1.82
"20200914","1783","0035003900320045","5920",元富-城中,0,3,3,-1,1.82
"20200914","1783","0039003800390056","9800",元大-北三重,3,0,3,1,1.82
"20200914","1783","0035003300380057","5380",第一金-華江,0,2,2,-1,1.21
"20200914","1783","0035003800350052","5850",統一-汐止,2,0,2,1,1.21
"20200914","1783","0037003000300046","7000",兆豐-虎尾,0,2,2,-1,1.21
"20200914","1783","5386","5380",第一金-彰化,2,0,2,1,1.21
"20200914","1783","8584","8580",聯邦-雙和,0,2,2,-1,1.21
"20200914","1783","0039003100380044","9100",群益金鼎-東門,2,0,2,1,1.21
"20200914","1783","9352","9300",華南永昌-桃園,0,2,2,-1,1.21
"20200914","1783","1470","1470",台灣摩根士丹利,8,7,1,1,0.61
"20200914","1783","003500330038006a","5380",第一金-安和,0,1,1,-1,0.61
"20200915","1783","1560","1560",港商野村,14,0,14,1,9.46
"20200915","1783","9319","9300",華南永昌-鶯歌,0,20,20,-1,13.51
"20200915","1783","1520","1520",瑞士信貸,14,0,14,1,9.46
"20200915","1783","0039003200310053","9200",凱基-幸福,0,10,10,-1,6.76
"20200915","1783","1650","1650",新加坡商瑞銀,9,0,9,1,6.08
"20200915","1783","0039003100380047","9100",群益金鼎-新莊,0,7,7,-1,4.73
"20200915","1783","8440","8440",摩根大通,9,0,9,1,6.08
"20200915","1783","0035003900320044","5920",元富-大昌,0,6,6,-1,4.05
"20200915","1783","1470","1470",台灣摩根士丹利,9,3,6,1,4.05
"20200915","1783","003900360035004b","9600",富邦-台中,0,6,6,-1,4.05
"20200915","1783","1040","1040",臺銀,5,0,5,1,3.38
"20200915","1783","8883","8880",國泰-松江,0,4,4,-1,2.70
"20200915","1783","0035003900320057","5920",元富-吉利,5,0,5,1,3.38
"20200915","1783","0036003000310064","6010",(牛牛牛)亞-鑫豐,0,3,3,-1,2.03
"20200915","1783","003900380039005a","9800",元大-小港,5,0,5,1,3.38
"20200915","1783","8840","8840",玉山證券,0,3,3,-1,2.03
"20200915","1783","1440","1440",美林,5,2,3,1,2.03
"20200915","1783","8881","8880",國泰-高雄,0,2,2,-1,1.35
"20200915","1783","5660","5660",日進,3,0,3,1,2.03
"20200915","1783","9205","9200",凱基-三重,0,2,2,-1,1.35
"20200915","1783","0037003000300064","7000",兆豐-彰化,3,0,3,1,2.03
"20200915","1783","0039003800390045","9800",元大-草屯,0,2,2,-1,1.35
"20200915","1783","8560","8560",新光,3,0,3,1,2.03
"20200915","1783","0039003800390049","9800",元大-蘆洲,0,2,2,-1,1.35
"20200915","1783","0039004100390066","9A00",永豐金-中盛,2,0,2,1,1.35
"20200915","1783","0035003900320043","5920",元富-潮州,0,1,1,-1,0.68
"20200915","1783","6464","6460",大昌-新店,1,0,1,1,0.68
"20200915","1783","5267","5260",美好-基隆,0,1,1,-1,0.68
"20200916","1783","1650","1650",新加坡商瑞銀,10,0,10,1,9.43
"20200916","1783","9672","9600",富邦-員林,0,12,12,-1,11.32
"20200916","1783","9268","9200",凱基-台北,9,0,9,1,8.49
"20200916","1783","9834","9800",元大-中壢,0,10,10,-1,9.43
"20200916","1783","5660","5660",日進,8,0,8,1,7.55
"20200916","1783","0039003800390059","9800",元大-基隆,0,6,6,-1,5.66
"20200916","1783","1520","1520",瑞士信貸,8,0,8,1,7.55
"20200916","1783","0039003600320044","9600",富邦-新莊,0,5,5,-1,4.72
"20200916","1783","0039003100380047","9100",群益金鼎-新莊,8,1,7,1,6.60
"20200916","1783","9679","9600",富邦-延吉(停),0,5,5,-1,4.72
"20200916","1783","1470","1470",台灣摩根士丹利,7,2,5,1,4.72
"20200916","1783","0039004100390052","9A00",永豐金-信義,0,5,5,-1,4.72
"20200916","1783","8843","8840",玉山-高雄,4,0,4,1,3.77
"20200916","1783","9817","9800",元大-東泰,0,4,4,-1,3.77
"20200916","1783","0031003000340044","1040",臺銀-金山,4,1,3,1,2.83
"20200916","1783","0039003800340048","9800",元大-景美,0,3,3,-1,2.83
"20200916","1783","9134","9100",群益金鼎-開元,3,0,3,1,2.83
"20200916","1783","0039003800390056","9800",元大-北三重,0,3,3,-1,2.83
"20200916","1783","0039003100330045","9100",群益金鼎-基隆,3,0,3,1,2.83
"20200916","1783","5387","5380",第一金-澎湖,0,2,2,-1,1.89
"20200916","1783","0035003300380049","5380",第一金-頭份,2,0,2,1,1.89
"20200916","1783","9604","9600",富邦-陽明,0,2,2,-1,1.89
"20200916","1783","0035003300380046","5380",第一金-大稻埕,2,0,2,1,1.89
"20200916","1783","003900360035004b","9600",富邦-台中,0,2,2,-1,1.89
"20200916","1783","003600310036004b","6160",中國信託-高雄,2,0,2,1,1.89
"20200916","1783","9800","9800",元大證券,0,2,2,-1,1.89
"20200916","1783","003800340035004a","8450",康和-高雄,2,0,2,1,1.89
"20200916","1783","9863","9800",元大-和平,0,2,2,-1,1.89
"20200917","1783","0039003600310045","9600",富邦-府城,10,0,10,1,7.87
"20200917","1783","8150","8150",台新證券,0,20,20,-1,15.75
"20200917","1783","1440","1440",美林,17,8,9,1,7.09
"20200917","1783","9834","9800",元大-中壢,0,10,10,-1,7.87
"20200917","1783","1520","1520",瑞士信貸,8,0,8,1,6.30
"20200917","1783","0035003900320045","5920",元富-城中,0,9,9,-1,7.09
"20200917","1783","1650","1650",新加坡商瑞銀,7,0,7,1,5.51
"20200917","1783","1260","1260",宏遠證券,0,7,7,-1,5.51
"20200917","1783","9303","9300",華南永昌-高雄,5,0,5,1,3.94
"20200917","1783","9227","9200",凱基-城中,0,5,5,-1,3.94
"20200917","1783","1470","1470",台灣摩根士丹利,6,2,4,1,3.15
"20200917","1783","8560","8560",新光,0,3,3,-1,2.36
"20200917","1783","0038003100350041","8150",台新-高雄,4,0,4,1,3.15
"20200917","1783","9359","9300",華南永昌-中正,0,3,3,-1,2.36
"20200917","1783","9134","9100",群益金鼎-開元,4,0,4,1,3.15
"20200917","1783","9892","9800",元大-屏東,0,3,3,-1,2.36
"20200917","1783","0035003300380057","5380",第一金-華江,6,3,3,1,2.36
"20200917","1783","5460","5460",寶盛,0,2,2,-1,1.57
"20200917","1783","9817","9800",元大-東泰,3,0,3,1,2.36
"20200917","1783","0035003300380049","5380",第一金-頭份,0,2,2,-1,1.57
"20200917","1783","1041","1040",臺銀-鳳山,2,0,2,1,1.57
"20200917","1783","0039003600320050","9600",富邦-頭份,0,2,2,-1,1.57
"20200917","1783","0035003800350049","5850",統一-員林,2,0,2,1,1.57
"20200917","1783","9857","9800",元大-東蘆,0,2,2,-1,1.57
"20200917","1783","003500330038006a","5380",第一金-安和,3,1,2,1,1.57
"20200917","1783","0031003200360055","1260",宏遠-館前,0,1,1,-1,0.79
"20200917","1783","9188","9100",群益金鼎-三民,2,0,2,1,1.57
"20200917","1783","0031003200360069","1260",宏遠-光隆,0,1,1,-1,0.79
"20200918","1783","0039003800390047","9800",元大-大同,20,2,18,1,11.46
"20200918","1783","0039003100380047","9100",群益金鼎-新莊,2,14,12,-1,7.64
"20200918","1783","9268","9200",凱基-台北,27,15,12,1,7.64
"20200918","1783","0039003800310070","9800",元大-松山,0,10,10,-1,6.37
"20200918","1783","0039003100380043","9100",群益金鼎-古亭,10,0,10,1,6.37
"20200918","1783","0035003900320045","5920",元富-城中,0,7,7,-1,4.46
"20200918","1783","1520","1520",瑞士信貸,9,0,9,1,5.73
"20200918","1783","0036003000310064","6010",(牛牛牛)亞-鑫豐,0,6,6,-1,3.82
"20200918","1783","1470","1470",台灣摩根士丹利,10,1,9,1,5.73
"20200918","1783","5384","5380",第一金-台南,0,5,5,-1,3.18
"20200918","1783","8440","8440",摩根大通,5,0,5,1,3.18
"20200918","1783","0039003200310045","9200",凱基-三峽,0,5,5,-1,3.18
"20200918","1783","0039003800310053","9800",元大-崇德,5,0,5,1,3.18
"20200918","1783","5386","5380",第一金-彰化,0,3,3,-1,1.91
"20200918","1783","1440","1440",美林,7,3,4,1,2.55
"20200918","1783","0039003100380046","9100",群益金鼎-新店,0,3,3,-1,1.91
"20200918","1783","1045","1040",臺銀-新竹,4,0,4,1,2.55
"20200918","1783","9233","9200",凱基-長庚,0,3,3,-1,1.91
"20200918","1783","0038003100350059","8150",台新-新營,3,0,3,1,1.91
"20200918","1783","9278","9200",凱基-永康,0,3,3,-1,1.91
"20200918","1783","9206","9200",凱基-高雄,3,0,3,1,1.91
"20200918","1783","1110","1110",台灣企銀,0,2,2,-1,1.27
"20200918","1783","9323","9300",華南永昌-小港,3,0,3,1,1.91
"20200918","1783","0031003000340044","1040",臺銀-金山,2,4,2,-1,1.27
"20200918","1783","0037003700390057","7790",國票-彰化,2,0,2,1,1.27
"20200918","1783","1040","1040",臺銀,0,2,2,-1,1.27
"20200918","1783","003900360031004b","9600",富邦-七賢,2,0,2,1,1.27
"20200918","1783","003500330038006a","5380",第一金-安和,0,2,2,-1,1.27
"20200921","1783","5320","5320",高橋,10,0,10,1,7.19
"20200921","1783","5260","5260",美好,0,13,13,-1,9.35
"20200921","1783","0035003900320057","5920",元富-吉利,10,0,10,1,7.19
"20200921","1783","5389","5380",第一金-中山,0,10,10,-1,7.19
"20200921","1783","9268","9200",凱基-台北,10,0,10,1,7.19
"20200921","1783","8156","8150",台新-三民,0,10,10,-1,7.19
"20200921","1783","0039003800310070","9800",元大-松山,10,0,10,1,7.19
"20200921","1783","8840","8840",玉山證券,0,7,7,-1,5.04
"20200921","1783","9834","9800",元大-中壢,10,0,10,1,7.19
"20200921","1783","9817","9800",元大-東泰,0,7,7,-1,5.04
"20200921","1783","8440","8440",摩根大通,7,0,7,1,5.04
"20200921","1783","5460","5460",寶盛,0,5,5,-1,3.60
"20200921","1783","1520","1520",瑞士信貸,6,0,6,1,4.32
"20200921","1783","9875","9800",元大-土城永寧,0,5,5,-1,3.60
"20200921","1783","1560","1560",港商野村,5,0,5,1,3.60
"20200921","1783","1040","1040",臺銀,0,4,4,-1,2.88
"20200921","1783","1470","1470",台灣摩根士丹利,4,0,4,1,2.88
"20200921","1783","9315","9300",華南永昌-苑裡,0,4,4,-1,2.88
"20200921","1783","6461","6460",大昌-樹林,4,0,4,1,2.88
"20200921","1783","0039003600320045","9600",富邦-樹林,0,4,4,-1,2.88
"20200921","1783","0038003100350042","8150",台新-台中,4,0,4,1,2.88
"20200921","1783","0037003000300064","7000",兆豐-彰化,0,3,3,-1,2.16
"20200921","1783","9134","9100",群益金鼎-開元,4,0,4,1,2.88
"20200921","1783","9285","9200",凱基-中壢,0,3,3,-1,2.16
"20200921","1783","1590","1590",花旗環球,3,0,3,1,2.16
"20200921","1783","9838","9800",元大-豐原,0,3,3,-1,2.16
"20200921","1783","0039003800390050","9800",元大-敦南,3,0,3,1,2.16
"20200921","1783","0035003900320049","5920",元富-嘉義,0,2,2,-1,1.44
"20200922","1783","0035003900320057","5920",元富-吉利,26,0,26,1,20.97
"20200922","1783","1650","1650",新加坡商瑞銀,0,12,12,-1,9.68
"20200922","1783","0039003800310070","9800",元大-松山,10,0,10,1,8.06
"20200922","1783","5921","5920",元富-高雄,0,10,10,-1,8.06
"20200922","1783","0035003300380057","5380",第一金-華江,8,0,8,1,6.45
"20200922","1783","1470","1470",台灣摩根士丹利,0,7,7,-1,5.65
"20200922","1783","9359","9300",華南永昌-中正,7,0,7,1,5.65
"20200922","1783","9817","9800",元大-東泰,2,8,6,-1,4.84
"20200922","1783","0039003100380047","9100",群益金鼎-新莊,9,3,6,1,4.84
"20200922","1783","0038003400350041","8450",康和-內湖,0,5,5,-1,4.03
"20200922","1783","1590","1590",花旗環球,3,0,3,1,2.42
"20200922","1783","0039003100380075","9100",群益金鼎-瑞豐,0,5,5,-1,4.03
"20200922","1783","0036003100310041","6110",台中銀-豐原,2,0,2,1,1.61
"20200922","1783","8882","8880",國泰-台中,0,3,3,-1,2.42
"20200922","1783","8880","8880",國泰證券,2,0,2,1,1.61
"20200922","1783","1440","1440",美林,3,5,2,-1,1.61
"20200922","1783","9134","9100",群益金鼎-開元,2,0,2,1,1.61
"20200922","1783","0035003900320044","5920",元富-大昌,2,4,2,-1,1.61
"20200922","1783","003900360031004e","9600",富邦-西壢,2,0,2,1,1.61
"20200922","1783","9661","9600",富邦-新店,0,2,2,-1,1.61
"20200922","1783","6164","6160",中國信託-文心,1,0,1,1,0.81
"20200922","1783","0039003800330056","9800",元大-竹南,0,2,2,-1,1.61
"20200922","1783","0035003300380041","5380",第一金-新興,1,0,1,1,0.81
"20200922","1783","003500390032006d","5920",元富-成功,0,1,1,-1,0.81
"20200922","1783","003800380034004a","8840",玉山-大里,1,0,1,1,0.81
"20200922","1783","003700300030005a","7000",兆豐-高雄,0,1,1,-1,0.81
"20200922","1783","0038003800380041","8880",國泰-館前,1,0,1,1,0.81
"20200922","1783","003600310036004b","6160",中國信託-高雄,0,1,1,-1,0.81
"20200923","1783","8560","8560",新光,6,0,6,1,7.50
"20200923","1783","9268","9200",凱基-台北,1,16,15,-1,18.75
"20200923","1783","9285","9200",凱基-中壢,7,1,6,1,7.50
"20200923","1783","9800","9800",元大證券,0,13,13,-1,16.25
"20200923","1783","8150","8150",台新證券,5,0,5,1,6.25
"20200923","1783","1440","1440",美林,0,5,5,-1,6.25
"20200923","1783","9266","9200",凱基-新豐,5,0,5,1,6.25
"20200923","1783","9234","9200",凱基-竹北,0,5,5,-1,6.25
"20200923","1783","9359","9300",華南永昌-中正,5,0,5,1,6.25
"20200923","1783","1520","1520",瑞士信貸,0,4,4,-1,5.00
"20200923","1783","9817","9800",元大-東泰,4,0,4,1,5.00
"20200923","1783","8880","8880",國泰證券,0,2,2,-1,2.50
"20200923","1783","5851","5850",統一-高雄,3,0,3,1,3.75
"20200923","1783","003900360031004d","9600",富邦-木柵,0,2,2,-1,2.50
"20200923","1783","9105","9100",群益金鼎-高盛,3,0,3,1,3.75
"20200923","1783","0039003800390049","9800",元大-蘆洲,0,2,2,-1,2.50
"20200923","1783","0037003700390072","7790",國票-桃園,2,0,2,1,2.50
"20200923","1783","0037003000300063","7000",兆豐-民生,0,1,1,-1,1.25
"20200923","1783","1260","1260",宏遠證券,2,0,2,1,2.50
"20200923","1783","0037003000300061","7000",兆豐-忠孝,0,1,1,-1,1.25
"20200923","1783","0035003900320076","5920",元富-桃園,2,0,2,1,2.50
"20200923","1783","6461","6460",大昌-樹林,0,1,1,-1,1.25
"20200923","1783","8842","8840",玉山-新莊,2,0,2,1,2.50
"20200923","1783","1590","1590",花旗環球,0,1,1,-1,1.25
"20200923","1783","9134","9100",群益金鼎-開元,2,0,2,1,2.50
"20200923","1783","0039003100330044","9100",群益金鼎-潭子,0,1,1,-1,1.25
"20200923","1783","0039003100380047","9100",群益金鼎-新莊,4,2,2,1,2.50
"20200923","1783","003900360035004b","9600",富邦-台中,0,1,1,-1,1.25
"20200924","1783","8560","8560",新光,34,0,34,1,13.93
"20200924","1783","1440","1440",美林,0,21,21,-1,8.61
"20200924","1783","9105","9100",群益金鼎-高盛,10,0,10,1,4.10
"20200924","1783","0039003800390047","9800",元大-大同,0,20,20,-1,8.20
"20200924","1783","9315","9300",華南永昌-苑裡,10,0,10,1,4.10
"20200924","1783","1650","1650",新加坡商瑞銀,0,17,17,-1,6.97
"20200924","1783","9817","9800",元大-東泰,8,0,8,1,3.28
"20200924","1783","1470","1470",台灣摩根士丹利,5,20,15,-1,6.15
"20200924","1783","0039003100330049","9100",群益金鼎-萬華,5,0,5,1,2.05
"20200924","1783","5389","5380",第一金-中山,0,10,10,-1,4.10
"20200924","1783","0039003200310053","9200",凱基-幸福,5,0,5,1,2.05
"20200924","1783","1560","1560",港商野村,0,10,10,-1,4.10
"20200924","1783","9283","9200",凱基-北門,5,0,5,1,2.05
"20200924","1783","9208","9200",凱基-桃園,0,8,8,-1,3.28
"20200924","1783","6464","6460",大昌-新店,4,0,4,1,1.64
"20200924","1783","1590","1590",花旗環球,0,6,6,-1,2.46
"20200924","1783","8150","8150",台新證券,5,1,4,1,1.64
"20200924","1783","1520","1520",瑞士信貸,0,5,5,-1,2.05
"20200924","1783","9134","9100",群益金鼎-開元,4,0,4,1,1.64
"20200924","1783","0035003300380057","5380",第一金-華江,0,5,5,-1,2.05
"20200924","1783","9217","9200",凱基-松山,4,0,4,1,1.64
"20200924","1783","0035003900320044","5920",元富-大昌,0,5,5,-1,2.05
"20200924","1783","0038003800340048","8840",玉山-新竹,3,0,3,1,1.23
"20200924","1783","5323","5320",高橋-內壢,0,3,3,-1,1.23
"20200924","1783","0035003900320049","5920",元富-嘉義,2,0,2,1,0.82
"20200924","1783","7003","7000",兆豐-台中,0,3,3,-1,1.23
"20200924","1783","0035003900320050","5920",元富-同大,2,0,2,1,0.82
"20200924","1783","0039003800310061","9800",元大-歸仁,2,5,3,-1,1.23
"20200925","1783","0035003900320057","5920",元富-吉利,25,0,25,1,7.72
"20200925","1783","1650","1650",新加坡商瑞銀,0,17,17,-1,5.25
"20200925","1783","9817","9800",元大-東泰,18,0,18,1,5.56
"20200925","1783","9651","9600",富邦-民生(停),1,15,14,-1,4.32
"20200925","1783","003900360031004b","9600",富邦-七賢,10,0,10,1,3.09
"20200925","1783","0039003800310061","9800",元大-歸仁,4,18,14,-1,4.32
"20200925","1783","0039003800310053","9800",元大-崇德,11,1,10,1,3.09
"20200925","1783","8440","8440",摩根大通,0,12,12,-1,3.70
"20200925","1783","003900320031004d","9200",凱基-八德,8,0,8,1,2.47
"20200925","1783","1440","1440",美林,0,11,11,-1,3.40
"20200925","1783","9801","9800",元大-城東,7,0,7,1,2.16
"20200925","1783","9252","9200",凱基-嘉義,0,11,11,-1,3.40
"20200925","1783","9359","9300",華南永昌-中正,6,0,6,1,1.85
"20200925","1783","0039003800390059","9800",元大-基隆,2,13,11,-1,3.40
"20200925","1783","5262","5260",美好-楊梅,5,0,5,1,1.54
"20200925","1783","1520","1520",瑞士信貸,2,11,9,-1,2.78
"20200925","1783","003500390032006c","5920",元富-大裕,5,0,5,1,1.54
"20200925","1783","9302","9300",華南永昌-台中,0,9,9,-1,2.78
"20200925","1783","0036003100310041","6110",台中銀-豐原,5,0,5,1,1.54
"20200925","1783","0039003800390041","9800",元大-北投,0,9,9,-1,2.78
"20200925","1783","0037003700390045","7790",國票-南崁,5,0,5,1,1.54
"20200925","1783","0035003300380057","5380",第一金-華江,1,9,8,-1,2.47
"20200925","1783","8886","8880",國泰-新莊,5,0,5,1,1.54
"20200925","1783","0039003800300064","9800",元大-沙鹿,0,8,8,-1,2.47
"20200925","1783","9134","9100",群益金鼎-開元,5,0,5,1,1.54
"20200925","1783","0037003000300042","7000",兆豐-板橋,0,5,5,-1,1.54
"20200925","1783","9322","9300",華南永昌-公誠,5,0,5,1,1.54
"20200925","1783","0038003400350041","8450",康和-內湖,0,5,5,-1,1.54
"20200928","1783","9206","9200",凱基-高雄,8,0,8,1,7.08
"20200928","1783","9268","9200",凱基-台北,10,27,17,-1,15.04
"20200928","1783","1440","1440",美林,5,0,5,1,4.42
"20200928","1783","5921","5920",元富-高雄,0,8,8,-1,7.08
"20200928","1783","1043","1040",臺銀-民權,5,0,5,1,4.42
"20200928","1783","5960","5960",日茂,0,7,7,-1,6.19
"20200928","1783","1470","1470",台灣摩根士丹利,4,0,4,1,3.54
"20200928","1783","9862","9800",元大-南京,0,5,5,-1,4.42
"20200928","1783","6165","6160",中國信託-新竹,4,0,4,1,3.54
"20200928","1783","0039003600320046","9600",富邦-北桃園(停),0,4,4,-1,3.54
"20200928","1783","0039004100390078","9A00",永豐金-桃園,4,0,4,1,3.54
"20200928","1783","003700300030004b","7000",兆豐-新營,0,3,3,-1,2.65
"20200928","1783","0035003800350052","5850",統一-汐止,2,0,2,1,1.77
"20200928","1783","0039003100380047","9100",群益金鼎-新莊,2,4,2,-1,1.77
"20200928","1783","003500380035004a","5850",統一-三重,2,0,2,1,1.77
"20200928","1783","9283","9200",凱基-北門,0,2,2,-1,1.77
"20200928","1783","0031003000340041","1040",臺銀-臺中,2,0,2,1,1.77
"20200928","1783","9369","9300",華南永昌-三重,0,2,2,-1,1.77
"20200928","1783","5323","5320",高橋-內壢,2,0,2,1,1.77
"20200928","1783","0039003600320045","9600",富邦-樹林,0,2,2,-1,1.77
"20200928","1783","5260","5260",美好,2,0,2,1,1.77
"20200928","1783","003900360032004c","9600",富邦-雙和,0,2,2,-1,1.77
"20200928","1783","8440","8440",摩根大通,2,0,2,1,1.77
"20200928","1783","9817","9800",元大-東泰,0,2,2,-1,1.77
"20200928","1783","8841","8840",玉山-雙和,2,0,2,1,1.77
"20200928","1783","0039003800310043","9800",元大-路竹,0,2,2,-1,1.77
"20200928","1783","9285","9200",凱基-中壢,2,0,2,1,1.77
"20200928","1783","9825","9800",元大-新營,0,2,2,-1,1.77
"20200929","1783","9285","9200",凱基-中壢,9,0,9,1,8.26
"20200929","1783","6464","6460",大昌-新店,0,12,12,-1,11.01
"20200929","1783","8560","8560",新光,8,0,8,1,7.34
"20200929","1783","9800","9800",元大證券,0,12,12,-1,11.01
"20200929","1783","8440","8440",摩根大通,6,1,5,1,4.59
"20200929","1783","0039003600310043","9600",富邦-南京,0,9,9,-1,8.26
"20200929","1783","9894","9800",元大-桃興,5,0,5,1,4.59
"20200929","1783","9884","9800",元大-斗信,0,6,6,-1,5.50
"20200929","1783","0035003900320044","5920",元富-大昌,4,0,4,1,3.67
"20200929","1783","1470","1470",台灣摩根士丹利,0,5,5,-1,4.59
"20200929","1783","003900380031006e","9800",元大-旗山,3,0,3,1,2.75
"20200929","1783","1440","1440",美林,0,5,5,-1,4.59
"20200929","1783","6110","6110",台中銀,2,0,2,1,1.83
"20200929","1783","9872","9800",元大-復北,0,5,5,-1,4.59
"20200929","1783","9278","9200",凱基-永康,2,0,2,1,1.83
"20200929","1783","0039003100330059","9100",群益金鼎-館前,0,3,3,-1,2.75
"20200929","1783","0039003600320055","9600",富邦-縣政,2,0,2,1,1.83
"20200929","1783","9838","9800",元大-豐原,0,3,3,-1,2.75
"20200929","1783","0039003800300064","9800",元大-沙鹿,2,0,2,1,1.83
"20200929","1783","0039004100360031","9A00",永豐金-鳳山,0,3,3,-1,2.75
"20200929","1783","0039003800320042","9800",元大-博愛,2,0,2,1,1.83
"20200929","1783","1021","1020",合庫-台中,0,2,2,-1,1.83
"20200929","1783","9859","9800",元大-新竹經國,2,0,2,1,1.83
"20200929","1783","0039003200300046","9200",凱基-站前,0,2,2,-1,1.83
"20200929","1783","6383","6380",光和-和美,1,0,1,1,0.92
"20200929","1783","0039003600310052","9600",富邦-南員林,0,2,2,-1,1.83
"20200929","1783","1520","1520",瑞士信貸,1,0,1,1,0.92
"20200929","1783","9817","9800",元大-東泰,0,2,2,-1,1.83
"20200930","1783","1650","1650",新加坡商瑞銀,15,0,15,1,11.11
"20200930","1783","8150","8150",台新證券,0,8,8,-1,5.93
"20200930","1783","1470","1470",台灣摩根士丹利,13,0,13,1,9.63
"20200930","1783","1520","1520",瑞士信貸,2,9,7,-1,5.19
"20200930","1783","9268","9200",凱基-台北,25,15,10,1,7.41
"20200930","1783","9800","9800",元大證券,0,6,6,-1,4.44
"20200930","1783","9300","9300",華南永昌,9,0,9,1,6.67
"20200930","1783","0039004100390055","9A00",永豐金-中正,0,6,6,-1,4.44
"20200930","1783","1440","1440",美林,9,2,7,1,5.19
"20200930","1783","0039003100380075","9100",群益金鼎-瑞豐,0,5,5,-1,3.70
"20200930","1783","8560","8560",新光,6,0,6,1,4.44
"20200930","1783","0039003200310053","9200",凱基-幸福,0,5,5,-1,3.70
"20200930","1783","9257","9200",凱基-林口,5,0,5,1,3.70
"20200930","1783","0039004100390047","9A00",永豐金-天母,0,5,5,-1,3.70
"20200930","1783","8380","8380",安泰,3,0,3,1,2.22
"20200930","1783","1260","1260",宏遠證券,0,4,4,-1,2.96
"20200930","1783","0039003800300075","9800",元大-府城,2,0,2,1,1.48
"20200930","1783","003500330038006a","5380",第一金-安和,0,4,4,-1,2.96
"20200930","1783","9897","9800",元大-土城,2,0,2,1,1.48
"20200930","1783","0035003900320044","5920",元富-大昌,0,4,4,-1,2.96
"20200930","1783","5262","5260",美好-楊梅,1,0,1,1,0.74
"20200930","1783","5323","5320",高橋-內壢,1,4,3,-1,2.22
"20200930","1783","5856","5850",統一-台中,1,0,1,1,0.74
"20200930","1783","5320","5320",高橋,0,2,2,-1,1.48
"20200930","1783","1560","1560",港商野村,1,0,1,1,0.74
"20200930","1783","0035003800350045","5850",統一-新營,0,2,2,-1,1.48
"20200930","1783","7008","7000",兆豐-三重,1,0,1,1,0.74
"20200930","1783","0035003800350052","5850",統一-汐止,0,2,2,-1,1.48
"20200803","1783","1470","1470",台灣摩根士丹利,37,0,37,1,7.37
"20200803","1783","9898","9800",元大-新莊,3,25,22,-1,4.38
"20200803","1783","1480","1480",美商高盛,28,0,28,1,5.58
"20200803","1783","9217","9200",凱基-松山,0,21,21,-1,4.18
"20200803","1783","8150","8150",台新證券,21,0,21,1,4.18
"20200803","1783","0039003100380078","9100",群益金鼎-延平,0,20,20,-1,3.98
"20200803","1783","9323","9300",華南永昌-小港,20,0,20,1,3.98
"20200803","1783","8560","8560",新光,1,19,18,-1,3.59
"20200803","1783","9834","9800",元大-中壢,15,0,15,1,2.99
"20200803","1783","9205","9200",凱基-三重,0,17,17,-1,3.39
"20200803","1783","1520","1520",瑞士信貸,12,1,11,1,2.19
"20200803","1783","1440","1440",美林,15,31,16,-1,3.19
"20200803","1783","0039003800390042","9800",元大-台中中港,11,0,11,1,2.19
"20200803","1783","0039003800320041","9800",元大-羅東,0,15,15,-1,2.99
"20200803","1783","003900380031006a","9800",元大-士林,10,0,10,1,1.99
"20200803","1783","0035003900320045","5920",元富-城中,0,11,11,-1,2.19
"20200803","1783","0039003800310053","9800",元大-崇德,10,0,10,1,1.99
"20200803","1783","0039003100380047","9100",群益金鼎-新莊,1,11,10,-1,1.99
"20200803","1783","0039004100390038","9A00",永豐金-大園,10,0,10,1,1.99
"20200803","1783","9291","9200",凱基-大安,0,9,9,-1,1.79
"20200803","1783","1560","1560",港商野村,7,0,7,1,1.39
"20200803","1783","0039003600320047","9600",富邦-斗六,0,9,9,-1,1.79
"20200803","1783","9317","9300",華南永昌-林口,8,1,7,1,1.39
"20200803","1783","1262","1260",宏遠-桃園,0,8,8,-1,1.59
"20200803","1783","5921","5920",元富-高雄,6,0,6,1,1.20
"20200803","1783","5386","5380",第一金-彰化,5,13,8,-1,1.59
"20200803","1783","1031","1030",土銀-台中,5,0,5,1,1.00
"20200803","1783","0039004100390039","9A00",永豐金-中壢,0,8,8,-1,1.59
"20200804","1783","8440","8440",摩根大通,35,1,34,1,6.83
"20200804","1783","9800","9800",元大證券,0,20,20,-1,4.02
"20200804","1783","0038003800380041","8880",國泰-館前,18,0,18,1,3.61
"20200804","1783","1440","1440",美林,11,30,19,-1,3.82
"20200804","1783","1470","1470",台灣摩根士丹利,10,0,10,1,2.01
"20200804","1783","9623","9600",富邦-台北,2,15,13,-1,2.61
"20200804","1783","8156","8150",台新-三民,10,0,10,1,2.01
"20200804","1783","9898","9800",元大-新莊,0,13,13,-1,2.61
"20200804","1783","9651","9600",富邦-民生(停),10,0,10,1,2.01
"20200804","1783","1560","1560",港商野村,1,11,10,-1,2.01
"20200804","1783","9834","9800",元大-中壢,10,0,10,1,2.01
"20200804","1783","0037003700390065","7790",國票-南科,0,10,10,-1,2.01
"20200804","1783","0036003300380044","6380",光和-高雄,8,0,8,1,1.61
"20200804","1783","0039003100380078","9100",群益金鼎-延平,0,10,10,-1,2.01
"20200804","1783","0039003800390053","9800",元大-鹿港,8,0,8,1,1.61
"20200804","1783","0039004100390038","9A00",永豐金-大園,0,10,10,-1,2.01
"20200804","1783","9268","9200",凱基-台北,15,9,6,1,1.20
"20200804","1783","6380","6380",光和,1,10,9,-1,1.81
"20200804","1783","0035003900320062","5920",元富-板橋,5,0,5,1,1.00
"20200804","1783","0039003600330041","9600",富邦-八德,0,7,7,-1,1.41
"20200804","1783","9234","9200",凱基-竹北,5,0,5,1,1.00
"20200804","1783","9893","9800",元大-大天母,0,7,7,-1,1.41
"20200804","1783","9815","9800",元大-大灣,5,0,5,1,1.00
"20200804","1783","8560","8560",新光,0,6,6,-1,1.20
"20200804","1783","0039003800310061","9800",元大-歸仁,5,0,5,1,1.00
"20200804","1783","1520","1520",瑞士信貸,4,9,5,-1,1.00
"20200804","1783","003900380031004c","9800",元大-莒光,5,0,5,1,1.00
"20200804","1783","2180","2180",亞東,0,5,5,-1,1.00
"20200805","1783","1520","1520",瑞士信貸,38,0,38,1,8.46
"20200805","1783","9894","9800",元大-桃興,0,20,20,-1,4.45
"20200805","1783","003700300030005a","7000",兆豐-高雄,36,1,35,1,7.80
"20200805","1783","0039003800310047","9800",元大-彰化,1,20,19,-1,4.23
"20200805","1783","1470","1470",台灣摩根士丹利,20,0,20,1,4.45
"20200805","1783","8156","8150",台新-三民,0,17,17,-1,3.79
"20200805","1783","003900380031004c","9800",元大-莒光,15,0,15,1,3.34
"20200805","1783","1045","1040",臺銀-新竹,0,13,13,-1,2.90
"20200805","1783","0031003000340041","1040",臺銀-臺中,11,0,11,1,2.45
"20200805","1783","5921","5920",元富-高雄,0,10,10,-1,2.23
"20200805","1783","0039003800310065","9800",元大-佳里,10,0,10,1,2.23
"20200805","1783","003900380039004c","9800",元大-成功,0,10,10,-1,2.23
"20200805","1783","003900380033006a","9800",元大-仁愛,10,0,10,1,2.23
"20200805","1783","9268","9200",凱基-台北,3,12,9,-1,2.00
"20200805","1783","0039003800390051","9800",元大-汐止,10,0,10,1,2.23
"20200805","1783","0039003800390055","9800",元大-大甲,0,8,8,-1,1.78
"20200805","1783","0035003900320044","5920",元富-大昌,12,3,9,1,2.00
"20200805","1783","0037003700390045","7790",國票-南崁,0,7,7,-1,1.56
"20200805","1783","003500390032006c","5920",元富-大裕,10,1,9,1,2.00
"20200805","1783","003900360035004b","9600",富邦-台中,0,7,7,-1,1.56
"20200805","1783","0035003300380057","5380",第一金-華江,7,0,7,1,1.56
"20200805","1783","5460","5460",寶盛,0,6,6,-1,1.34
"20200805","1783","9211","9200",凱基-台南,7,0,7,1,1.56
"20200805","1783","003500380035004a","5850",統一-三重,0,6,6,-1,1.34
"20200805","1783","0039004100360031","9A00",永豐金-鳳山,6,0,6,1,1.34
"20200805","1783","0039003800310043","9800",元大-路竹,0,6,6,-1,1.34
"20200805","1783","9252","9200",凱基-嘉義,6,0,6,1,1.34
"20200805","1783","8843","8840",玉山-高雄,5,10,5,-1,1.11
"20200806","1783","8440","8440",摩根大通,37,4,33,1,7.11
"20200806","1783","8156","8150",台新-三民,0,33,33,-1,7.11
"20200806","1783","0039003800390046","9800",元大-高雄,25,0,25,1,5.39
"20200806","1783","9800","9800",元大證券,0,20,20,-1,4.31
"20200806","1783","1116","1110",台灣企銀-屏東,20,0,20,1,4.31
"20200806","1783","0039003800390055","9800",元大-大甲,0,15,15,-1,3.23
"20200806","1783","1560","1560",港商野村,18,0,18,1,3.88
"20200806","1783","0036003300380044","6380",光和-高雄,0,11,11,-1,2.37
"20200806","1783","1470","1470",台灣摩根士丹利,17,0,17,1,3.66
"20200806","1783","0039003800390067","9800",元大-嘉義,0,11,11,-1,2.37
"20200806","1783","003500330038006a","5380",第一金-安和,17,0,17,1,3.66
"20200806","1783","0035003900320058","5920",元富-草屯,0,10,10,-1,2.16
"20200806","1783","0039003800310043","9800",元大-路竹,12,0,12,1,2.59
"20200806","1783","0039003100380067","9100",群益金鼎-大甲,0,10,10,-1,2.16
"20200806","1783","1480","1480",美商高盛,20,10,10,1,2.16
"20200806","1783","9817","9800",元大-東泰,0,10,10,-1,2.16
"20200806","1783","0037003000300048","7000",兆豐-東門,10,0,10,1,2.16
"20200806","1783","0039003800310044","9800",元大-南投,0,10,10,-1,2.16
"20200806","1783","0037003700390044","7790",國票-台南,10,0,10,1,2.16
"20200806","1783","9239","9200",凱基-市政,0,9,9,-1,1.94
"20200806","1783","8843","8840",玉山-高雄,10,0,10,1,2.16
"20200806","1783","003500390032006f","5920",元富-新興,0,7,7,-1,1.51
"20200806","1783","9223","9200",凱基-豐中,10,0,10,1,2.16
"20200806","1783","0039003800330055","9800",元大-頭份,2,9,7,-1,1.51
"20200806","1783","9319","9300",華南永昌-鶯歌,10,0,10,1,2.16
"20200806","1783","0035003900320045","5920",元富-城中,0,6,6,-1,1.29
"20200806","1783","2187","2180",亞東-台中,6,0,6,1,1.29
"20200806","1783","5387","5380",第一金-澎湖,0,5,5,-1,1.08
"20200807","1783","8440","8440",摩根大通,25,3,22,1,8.12
"20200807","1783","8382","8380",安泰-楠梓,0,20,20,-1,7.38
"20200807","1783","0039003800310053","9800",元大-崇德,15,0,15,1,5.54
"20200807","1783","8561","8560",新光-台中,1,17,16,-1,5.90
"20200807","1783","1520","1520",瑞士信貸,11,0,11,1,4.06
"20200807","1783","0039003800390061","9800",元大-苑裡,0,16,16,-1,5.90
"20200807","1783","9268","9200",凱基-台北,19,8,11,1,4.06
"20200807","1783","5266","5260",美好-中壢,0,15,15,-1,5.54
"20200807","1783","0039003600310048","9600",富邦-新板,10,0,10,1,3.69
"20200807","1783","2187","2180",亞東-台中,0,10,10,-1,3.69
"20200807","1783","0039003800300064","9800",元大-沙鹿,10,0,10,1,3.69
"20200807","1783","0035003800350055","5850",統一-南京,0,10,10,-1,3.69
"20200807","1783","1480","1480",美商高盛,8,1,7,1,2.58
"20200807","1783","0039003600350055","9600",富邦-彰化,0,10,10,-1,3.69
"20200807","1783","003500390032006e","5920",元富-西松,7,0,7,1,2.58
"20200807","1783","0039003800310069","9800",元大-西螺,0,10,10,-1,3.69
"20200807","1783","0039003600320044","9600",富邦-新莊,7,0,7,1,2.58
"20200807","1783","003900380031004c","9800",元大-莒光,0,9,9,-1,3.32
"20200807","1783","0035003900320044","5920",元富-大昌,6,0,6,1,2.21
"20200807","1783","0039003800300043","9800",元大-斗六,1,8,7,-1,2.58
"20200807","1783","9332","9300",華南永昌-楠梓,6,0,6,1,2.21
"20200807","1783","9227","9200",凱基-城中,0,6,6,-1,2.21
"20200807","1783","9825","9800",元大-新營,5,0,5,1,1.85
"20200807","1783","1031","1030",土銀-台中,0,5,5,-1,1.85
"20200807","1783","003900380039004e","9800",元大-內湖,5,0,5,1,1.85
"20200807","1783","5928","5920",元富-新莊,0,5,5,-1,1.85
"20200807","1783","1560","1560",港商野村,5,1,4,1,1.48
"20200807","1783","0035003900320043","5920",元富-潮州,0,5,5,-1,1.85
"20200810","1783","8560","8560",新光,24,0,24,1,4.93
"20200810","1783","9800","9800",元大證券,0,78,78,-1,16.02
"20200810","1783","9208","9200",凱基-桃園,21,0,21,1,4.31
"20200810","1783","0038003800380041","8880",國泰-館前,0,20,20,-1,4.11
"20200810","1783","0038003800340046","8840",玉山-桃園,14,0,14,1,2.87
"20200810","1783","0039003100380048","9100",群益金鼎-中山,0,17,17,-1,3.49
"20200810","1783","0035003900320045","5920",元富-城中,13,0,13,1,2.67
"20200810","1783","9825","9800",元大-新營,0,16,16,-1,3.29
"20200810","1783","1030","1030",土銀,10,0,10,1,2.05
"20200810","1783","1520","1520",瑞士信貸,45,58,13,-1,2.67
"20200810","1783","003500380035004a","5850",統一-三重,10,0,10,1,2.05
"20200810","1783","003900320031004d","9200",凱基-八德,0,13,13,-1,2.67
"20200810","1783","0035003900320055","5920",元富-宜蘭,10,0,10,1,2.05
"20200810","1783","9266","9200",凱基-新豐,0,12,12,-1,2.46
"20200810","1783","8156","8150",台新-三民,10,0,10,1,2.05
"20200810","1783","003900380031006a","9800",元大-士林,0,10,10,-1,2.05
"20200810","1783","9325","9300",華南永昌-忠孝,10,0,10,1,2.05
"20200810","1783","1480","1480",美商高盛,0,9,9,-1,1.85
"20200810","1783","9359","9300",華南永昌-中正,10,0,10,1,2.05
"20200810","1783","0039003600320047","9600",富邦-斗六,0,9,9,-1,1.85
"20200810","1783","003500330038006a","5380",第一金-安和,8,0,8,1,1.64
"20200810","1783","0039003800300077","9800",元大-西屯,0,8,8,-1,1.64
"20200810","1783","9647","9600",富邦-新竹,8,0,8,1,1.64
"20200810","1783","9108","9100",群益金鼎-海山,0,6,6,-1,1.23
"20200810","1783","0036003000310064","6010",(牛牛牛)亞-鑫豐,7,0,7,1,1.44
"20200810","1783","9204","9200",凱基-台中,0,5,5,-1,1.03
"20200810","1783","9817","9800",元大-東泰,8,1,7,1,1.44
"20200810","1783","0039003600310045","9600",富邦-府城,0,5,5,-1,1.03
"20200811","1783","0039003100380048","9100",群益金鼎-中山,17,0,17,1,6.12
"20200811","1783","8848","8840",玉山-嘉義,0,20,20,-1,7.19
"20200811","1783","8440","8440",摩根大通,16,0,16,1,5.76
"20200811","1783","1480","1480",美商高盛,0,18,18,-1,6.47
"20200811","1783","5262","5260",美好-楊梅,11,0,11,1,3.96
"20200811","1783","9268","9200",凱基-台北,8,23,15,-1,5.40
"20200811","1783","003600310036004b","6160",中國信託-高雄,10,0,10,1,3.60
"20200811","1783","1560","1560",港商野村,0,14,14,-1,5.04
"20200811","1783","9308","9300",華南永昌-麻豆,10,0,10,1,3.60
"20200811","1783","5050","5050",大展,0,10,10,-1,3.60
"20200811","1783","1470","1470",台灣摩根士丹利,8,0,8,1,2.88
"20200811","1783","1030","1030",土銀,0,10,10,-1,3.60
"20200811","1783","0039004100380046","9A00",永豐金-敦南,8,0,8,1,2.88
"20200811","1783","0038003400350045","8450",康和-澎湖,0,10,10,-1,3.60
"20200811","1783","0039003100380047","9100",群益金鼎-新莊,7,0,7,1,2.52
"20200811","1783","003900360031005a","9600",富邦-永康,0,7,7,-1,2.52
"20200811","1783","5382","5380",第一金-台中,5,0,5,1,1.80
"20200811","1783","0037003000300046","7000",兆豐-虎尾,0,6,6,-1,2.16
"20200811","1783","0035003800350042","5850",統一-永和,5,0,5,1,1.80
"20200811","1783","9817","9800",元大-東泰,0,6,6,-1,2.16
"20200811","1783","9317","9300",華南永昌-林口,5,0,5,1,1.80
"20200811","1783","9898","9800",元大-新莊,0,6,6,-1,2.16
"20200811","1783","0039003600320044","9600",富邦-新莊,5,0,5,1,1.80
"20200811","1783","1440","1440",美林,3,8,5,-1,1.80
"20200811","1783","1043","1040",臺銀-民權,3,0,3,1,1.08
"20200811","1783","6110","6110",台中銀,0,5,5,-1,1.80
"20200811","1783","0035003900320045","5920",元富-城中,4,1,3,1,1.08
"20200811","1783","9202","9200",凱基-中港,0,5,5,-1,1.80
"20200812","1783","9268","9200",凱基-台北,18,6,12,1,5.74
"20200812","1783","003900380033006a","9800",元大-仁愛,0,10,10,-1,4.78
"20200812","1783","0039003800310053","9800",元大-崇德,10,0,10,1,4.78
"20200812","1783","1480","1480",美商高盛,3,9,6,-1,2.87
"20200812","1783","1440","1440",美林,11,2,9,1,4.31
"20200812","1783","003700300030005a","7000",兆豐-高雄,2,8,6,-1,2.87
"20200812","1783","0036003100310041","6110",台中銀-豐原,10,3,7,1,3.35
"20200812","1783","0031003200360069","1260",宏遠-光隆,0,5,5,-1,2.39
"20200812","1783","9300","9300",華南永昌,6,0,6,1,2.87
"20200812","1783","5857","5850",統一-新竹,0,5,5,-1,2.39
"20200812","1783","0037003000300052","7000",兆豐-小港,5,0,5,1,2.39
"20200812","1783","003500330038006a","5380",第一金-安和,0,5,5,-1,2.39
"20200812","1783","8156","8150",台新-三民,5,0,5,1,2.39
"20200812","1783","0035003800350044","5850",統一-新台中,1,6,5,-1,2.39
"20200812","1783","9315","9300",華南永昌-苑裡,5,0,5,1,2.39
"20200812","1783","0037003700390044","7790",國票-台南,0,5,5,-1,2.39
"20200812","1783","9817","9800",元大-東泰,4,0,4,1,1.91
"20200812","1783","8380","8380",安泰,0,5,5,-1,2.39
"20200812","1783","0039003800310045","9800",元大-發財,4,0,4,1,1.91
"20200812","1783","9647","9600",富邦-新竹,0,5,5,-1,2.39
"20200812","1783","5921","5920",元富-高雄,3,0,3,1,1.44
"20200812","1783","0039003800300077","9800",元大-西屯,0,5,5,-1,2.39
"20200812","1783","6463","6460",大昌-新竹,3,0,3,1,1.44
"20200812","1783","9835","9800",元大-員林中山,0,5,5,-1,2.39
"20200812","1783","8842","8840",玉山-新莊,3,0,3,1,1.44
"20200812","1783","003900380039005a","9800",元大-小港,0,5,5,-1,2.39
"20200812","1783","0039003100380047","9100",群益金鼎-新莊,3,0,3,1,1.44
"20200812","1783","0039004100360031","9A00",永豐金-鳳山,0,5,5,-1,2.39
"20200813","1783","1470","1470",台灣摩根士丹利,9,0,9,1,3.88
"20200813","1783","9236","9200",凱基-虎尾,0,17,17,-1,7.33
"20200813","1783","8440","8440",摩根大通,17,8,9,1,3.88
"20200813","1783","6480","6480",福邦證券,0,10,10,-1,4.31
"20200813","1783","9874","9800",元大-雙和,6,0,6,1,2.59
"20200813","1783","9218","9200",凱基-大直,0,10,10,-1,4.31
"20200813","1783","1260","1260",宏遠證券,5,0,5,1,2.16
"20200813","1783","0039003600320045","9600",富邦-樹林,2,12,10,-1,4.31
"20200813","1783","0035003900320045","5920",元富-城中,5,0,5,1,2.16
"20200813","1783","0039004100390055","9A00",永豐金-中正,0,10,10,-1,4.31
"20200813","1783","0036003300380041","6380",光和-嘉義,5,0,5,1,2.16
"20200813","1783","1440","1440",美林,2,11,9,-1,3.88
"20200813","1783","7032","7030",致和-佳里,5,0,5,1,2.16
"20200813","1783","9800","9800",元大證券,0,8,8,-1,3.45
"20200813","1783","8841","8840",玉山-雙和,5,0,5,1,2.16
"20200813","1783","0037003000300061","7000",兆豐-忠孝,0,5,5,-1,2.16
"20200813","1783","9359","9300",華南永昌-中正,5,0,5,1,2.16
"20200813","1783","8380","8380",安泰,0,5,5,-1,2.16
"20200813","1783","0039003800310061","9800",元大-歸仁,5,0,5,1,2.16
"20200813","1783","0039003100380063","9100",群益金鼎-鳳山,0,5,5,-1,2.16
"20200813","1783","0039004100380046","9A00",永豐金-敦南,5,0,5,1,2.16
"20200813","1783","9268","9200",凱基-台北,5,10,5,-1,2.16
"20200813","1783","9131","9100",群益金鼎-民權,4,0,4,1,1.72
"20200813","1783","9369","9300",華南永昌-三重,0,5,5,-1,2.16
"20200813","1783","9331","9300",華南永昌-鳳山,4,0,4,1,1.72
"20200813","1783","0039003200300041","9200",凱基-板橋,0,4,4,-1,1.72
"20200813","1783","6385","6380",光和-花壇,3,0,3,1,1.29
"20200813","1783","0035003300380057","5380",第一金-華江,0,3,3,-1,1.29
"20200814","1783","1470","1470",台灣摩根士丹利,17,0,17,1,7.59
"20200814","1783","9236","9200",凱基-虎尾,0,13,13,-1,5.80
"20200814","1783","1440","1440",美林,14,2,12,1,5.36
"20200814","1783","6110","6110",台中銀,0,10,10,-1,4.46
"20200814","1783","0039003200310045","9200",凱基-三峽,10,0,10,1,4.46
"20200814","1783","6910","6910",德信,0,10,10,-1,4.46
"20200814","1783","9187","9100",群益金鼎-彰化,9,0,9,1,4.02
"20200814","1783","8156","8150",台新-三民,0,10,10,-1,4.46
"20200814","1783","9667","9600",富邦-台南,6,0,6,1,2.68
"20200814","1783","9672","9600",富邦-員林,0,6,6,-1,2.68
"20200814","1783","0039003800310061","9800",元大-歸仁,6,0,6,1,2.68
"20200814","1783","9835","9800",元大-員林中山,0,6,6,-1,2.68
"20200814","1783","5860","5860",盈溢,5,0,5,1,2.23
"20200814","1783","0035003300380045","5380",第一金-自由,0,5,5,-1,2.23
"20200814","1783","6950","6950",福勝,5,0,5,1,2.23
"20200814","1783","5856","5850",統一-台中,0,5,5,-1,2.23
"20200814","1783","9322","9300",華南永昌-公誠,6,1,5,1,2.23
"20200814","1783","0035003800350051","5850",統一-三多,0,5,5,-1,2.23
"20200814","1783","5265","5260",美好-苗栗,4,1,3,1,1.34
"20200814","1783","0035003900320062","5920",元富-板橋,0,5,5,-1,2.23
"20200814","1783","8458","8450",康和-台南,3,0,3,1,1.34
"20200814","1783","0035003900320044","5920",元富-大昌,0,5,5,-1,2.23
"20200814","1783","8846","8840",玉山-板橋,3,0,3,1,1.34
"20200814","1783","8380","8380",安泰,0,5,5,-1,2.23
"20200814","1783","9268","9200",凱基-台北,26,23,3,1,1.34
"20200814","1783","9651","9600",富邦-民生(停),0,5,5,-1,2.23
"20200814","1783","9303","9300",華南永昌-高雄,3,0,3,1,1.34
"20200814","1783","0039003800320041","9800",元大-羅東,0,5,5,-1,2.23
"20200817","1783","9651","9600",富邦-民生(停),34,0,34,1,15.89
"20200817","1783","9894","9800",元大-桃興,0,10,10,-1,4.67
"20200817","1783","8440","8440",摩根大通,16,7,9,1,4.21
"20200817","1783","9800","9800",元大證券,0,9,9,-1,4.21
"20200817","1783","1470","1470",台灣摩根士丹利,8,0,8,1,3.74
"20200817","1783","9226","9200",凱基-汐止,0,6,6,-1,2.80
"20200817","1783","8560","8560",新光,5,0,5,1,2.34
"20200817","1783","0039003800310071","9800",元大-萬華,0,5,5,-1,2.34
"20200817","1783","1520","1520",瑞士信貸,4,0,4,1,1.87
"20200817","1783","003500390032006d","5920",元富-成功,0,4,4,-1,1.87
"20200817","1783","0039003800330057","9800",元大-大里德芳,4,0,4,1,1.87
"20200817","1783","0039003100330067","9100",群益金鼎-三重,0,4,4,-1,1.87
"20200817","1783","0038003800340041","8840",玉山-士林,3,0,3,1,1.40
"20200817","1783","9233","9200",凱基-長庚,0,4,4,-1,1.87
"20200817","1783","8883","8880",國泰-松江,3,0,3,1,1.40
"20200817","1783","0039003800310046","9800",元大-福營,0,4,4,-1,1.87
"20200817","1783","003800340035004a","8450",康和-高雄,2,0,2,1,0.93
"20200817","1783","1023","1020",合庫-高雄,0,3,3,-1,1.40
"20200817","1783","0039003200300046","9200",凱基-站前,2,0,2,1,0.93
"20200817","1783","003500320036004b","5260",美好-富順,0,3,3,-1,1.40
"20200817","1783","9268","9200",凱基-台北,6,4,2,1,0.93
"20200817","1783","0035003900320075","5920",元富-世貿,0,3,3,-1,1.40
"20200817","1783","9329","9300",華南永昌-朴子,2,0,2,1,0.93
"20200817","1783","9334","9300",華南永昌-世貿,0,3,3,-1,1.40
"20200817","1783","5384","5380",第一金-台南,1,0,1,1,0.47
"20200817","1783","9862","9800",元大-南京,0,3,3,-1,1.40
"20200817","1783","5263","5260",美好-泰山,1,0,1,1,0.47
"20200817","1783","003500330038006a","5380",第一金-安和,0,2,2,-1,0.93
"20200818","1783","8150","8150",台新證券,10,0,10,1,4.26
"20200818","1783","0039003200300046","9200",凱基-站前,0,12,12,-1,5.11
"20200818","1783","9658","9600",富邦-建國,10,0,10,1,4.26
"20200818","1783","1560","1560",港商野村,0,11,11,-1,4.68
"20200818","1783","0039003800300064","9800",元大-沙鹿,10,0,10,1,4.26
"20200818","1783","6910","6910",德信,0,11,11,-1,4.68
"20200818","1783","0039003100380067","9100",群益金鼎-大甲,7,0,7,1,2.98
"20200818","1783","1650","1650",新加坡商瑞銀,0,10,10,-1,4.26
"20200818","1783","0039004100380039","9A00",永豐金-敦北,7,0,7,1,2.98
"20200818","1783","9359","9300",華南永昌-中正,0,10,10,-1,4.26
"20200818","1783","0039003200310059","9200",凱基-東勢,6,0,6,1,2.55
"20200818","1783","003900380033006a","9800",元大-仁愛,0,10,10,-1,4.26
"20200818","1783","9322","9300",華南永昌-公誠,5,0,5,1,2.13
"20200818","1783","9800","9800",元大證券,0,8,8,-1,3.40
"20200818","1783","9651","9600",富邦-民生(停),5,0,5,1,2.13
"20200818","1783","1440","1440",美林,6,11,5,-1,2.13
"20200818","1783","0039003800390053","9800",元大-鹿港,5,0,5,1,2.13
"20200818","1783","0035003900320044","5920",元富-大昌,0,5,5,-1,2.13
"20200818","1783","0039004100390047","9A00",永豐金-天母,5,0,5,1,2.13
"20200818","1783","0035003900320079","5920",元富-花蓮,0,5,5,-1,2.13
"20200818","1783","1040","1040",臺銀,4,0,4,1,1.70
"20200818","1783","9268","9200",凱基-台北,17,22,5,-1,2.13
"20200818","1783","8564","8560",新光-台南,6,2,4,1,1.70
"20200818","1783","9634","9600",富邦-羅東,0,5,5,-1,2.13
"20200818","1783","0039003100380047","9100",群益金鼎-新莊,6,2,4,1,1.70
"20200818","1783","0039003800340045","9800",元大-南勢角,0,5,5,-1,2.13
"20200818","1783","0039003600310043","9600",富邦-南京,5,1,4,1,1.70
"20200818","1783","9255","9200",凱基-和平,0,4,4,-1,1.70
"20200819","1783","9817","9800",元大-東泰,8,0,8,1,2.40
"20200819","1783","1116","1110",台灣企銀-屏東,0,20,20,-1,6.01
"20200819","1783","0035003900320045","5920",元富-城中,9,2,7,1,2.10
"20200819","1783","1045","1040",臺銀-新竹,0,15,15,-1,4.50
"20200819","1783","0037003700390065","7790",國票-南科,7,0,7,1,2.10
"20200819","1783","9667","9600",富邦-台南,0,11,11,-1,3.30
"20200819","1783","0039003600310043","9600",富邦-南京,7,0,7,1,2.10
"20200819","1783","1560","1560",港商野村,0,8,8,-1,2.40
"20200819","1783","1590","1590",花旗環球,6,0,6,1,1.80
"20200819","1783","0039003600320044","9600",富邦-新莊,0,7,7,-1,2.10
"20200819","1783","0035003800350049","5850",統一-員林,13,7,6,1,1.80
"20200819","1783","1650","1650",新加坡商瑞銀,0,5,5,-1,1.50
"20200819","1783","8150","8150",台新證券,6,0,6,1,1.80
"20200819","1783","0039003800310065","9800",元大-佳里,0,5,5,-1,1.50
"20200819","1783","5260","5260",美好,5,0,5,1,1.50
"20200819","1783","9873","9800",元大-西門,0,5,5,-1,1.50
"20200819","1783","0035003900320044","5920",元富-大昌,5,0,5,1,1.50
"20200819","1783","1520","1520",瑞士信貸,0,4,4,-1,1.20
"20200819","1783","9359","9300",華南永昌-中正,5,0,5,1,1.50
"20200819","1783","6461","6460",大昌-樹林,0,4,4,-1,1.20
"20200819","1783","1043","1040",臺銀-民權,4,0,4,1,1.20
"20200819","1783","0039003800310052","9800",元大-竹山,0,4,4,-1,1.20
"20200819","1783","0031003000340044","1040",臺銀-金山,4,0,4,1,1.20
"20200819","1783","9894","9800",元大-桃興,6,10,4,-1,1.20
"20200819","1783","8159","8150",台新-台南,4,0,4,1,1.20
"20200819","1783","0039004100390037","9A00",永豐金-新竹,0,4,4,-1,1.20
"20200819","1783","0039003100380047","9100",群益金鼎-新莊,4,0,4,1,1.20
"20200819","1783","0035003300380043","5380",第一金-光復,0,3,3,-1,0.90
"20200820","1783","9300","9300",華南永昌,25,0,25,1,2.46
"20200820","1783","0039003800390043","9800",元大-板橋,1,50,49,-1,4.82
"20200820","1783","9229","9200",凱基-中山,17,0,17,1,1.67
"20200820","1783","8440","8440",摩根大通,20,67,47,-1,4.63
"20200820","1783","1650","1650",新加坡商瑞銀,18,2,16,1,1.57
"20200820","1783","9105","9100",群益金鼎-高盛,10,50,40,-1,3.94
"20200820","1783","9302","9300",華南永昌-台中,17,1,16,1,1.57
"20200820","1783","1440","1440",美林,32,71,39,-1,3.84
"20200820","1783","0035003900320045","5920",元富-城中,17,2,15,1,1.48
"20200820","1783","1470","1470",台灣摩根士丹利,22,61,39,-1,3.84
"20200820","1783","0037003700390065","7790",國票-南科,13,0,13,1,1.28
"20200820","1783","0038003400350045","8450",康和-澎湖,0,27,27,-1,2.66
"20200820","1783","9817","9800",元大-東泰,24,11,13,1,1.28
"20200820","1783","0039003100380041","9100",群益金鼎-中壢,1,25,24,-1,2.36
"20200820","1783","9894","9800",元大-桃興,12,0,12,1,1.18
"20200820","1783","0039003800310047","9800",元大-彰化,0,20,20,-1,1.97
"20200820","1783","0031003000340043","1040",臺銀-高雄,11,0,11,1,1.08
"20200820","1783","6460","6460",大昌,0,17,17,-1,1.67
"20200820","1783","9308","9300",華南永昌-麻豆,11,0,11,1,1.08
"20200820","1783","8563","8560",新光-新竹,0,15,15,-1,1.48
"20200820","1783","0035003800350042","5850",統一-永和,10,0,10,1,0.98
"20200820","1783","6163","6160",中國信託-永康,0,13,13,-1,1.28
"20200820","1783","0037003000300052","7000",兆豐-小港,10,0,10,1,0.98
"20200820","1783","0039003600320047","9600",富邦-斗六,0,13,13,-1,1.28
"20200820","1783","8150","8150",台新證券,10,0,10,1,0.98
"20200820","1783","0039003800310061","9800",元大-歸仁,7,20,13,-1,1.28
"20200820","1783","9134","9100",群益金鼎-開元,10,0,10,1,0.98
"20200820","1783","6381","6380",光和-溪湖,0,10,10,-1,0.98
"20200821","1783","1440","1440",美林,27,2,25,1,6.74
"20200821","1783","9234","9200",凱基-竹北,0,14,14,-1,3.77
"20200821","1783","1560","1560",港商野村,23,0,23,1,6.20
"20200821","1783","0039003100380047","9100",群益金鼎-新莊,5,17,12,-1,3.23
"20200821","1783","1470","1470",台灣摩根士丹利,18,0,18,1,4.85
"20200821","1783","0035003800350042","5850",統一-永和,0,10,10,-1,2.70
"20200821","1783","9268","9200",凱基-台北,60,44,16,1,4.31
"20200821","1783","0039003800300064","9800",元大-沙鹿,5,15,10,-1,2.70
"20200821","1783","003900380039004e","9800",元大-內湖,11,0,11,1,2.96
"20200821","1783","9817","9800",元大-東泰,0,10,10,-1,2.70
"20200821","1783","0035003300380044","5380",第一金-忠孝,10,0,10,1,2.70
"20200821","1783","0039003100380075","9100",群益金鼎-瑞豐,0,8,8,-1,2.16
"20200821","1783","0037003700390045","7790",國票-南崁,10,0,10,1,2.70
"20200821","1783","9300","9300",華南永昌,3,11,8,-1,2.16
"20200821","1783","1480","1480",美商高盛,6,0,6,1,1.62
"20200821","1783","9229","9200",凱基-中山,0,7,7,-1,1.89
"20200821","1783","0039003600320044","9600",富邦-新莊,5,0,5,1,1.35
"20200821","1783","1021","1020",合庫-台中,0,6,6,-1,1.62
"20200821","1783","9636","9600",富邦-中壢,5,0,5,1,1.35
"20200821","1783","0035003800350049","5850",統一-員林,0,6,6,-1,1.62
"20200821","1783","9825","9800",元大-新營,5,0,5,1,1.35
"20200821","1783","0031003000340041","1040",臺銀-臺中,0,5,5,-1,1.35
"20200821","1783","0039004100380039","9A00",永豐金-敦北,5,0,5,1,1.35
"20200821","1783","9651","9600",富邦-民生(停),0,5,5,-1,1.35
"20200821","1783","9233","9200",凱基-長庚,4,0,4,1,1.08
"20200821","1783","0039003800390047","9800",元大-大同,0,5,5,-1,1.35
"20200821","1783","0039003600320055","9600",富邦-縣政,3,0,3,1,0.81
"20200821","1783","5387","5380",第一金-澎湖,0,4,4,-1,1.08
"20200824","1783","9268","9200",凱基-台北,54,36,18,1,8.41
"20200824","1783","0035003300380050","5380",第一金-路竹,0,12,12,-1,5.61
"20200824","1783","1470","1470",台灣摩根士丹利,13,0,13,1,6.07
"20200824","1783","0039003200310045","9200",凱基-三峽,0,10,10,-1,4.67
"20200824","1783","0035003800350042","5850",統一-永和,10,0,10,1,4.67
"20200824","1783","0039003800300064","9800",元大-沙鹿,0,10,10,-1,4.67
"20200824","1783","5960","5960",日茂,10,0,10,1,4.67
"20200824","1783","9817","9800",元大-東泰,0,7,7,-1,3.27
"20200824","1783","6950","6950",福勝,10,0,10,1,4.67
"20200824","1783","9229","9200",凱基-中山,0,5,5,-1,2.34
"20200824","1783","1520","1520",瑞士信貸,5,0,5,1,2.34
"20200824","1783","1480","1480",美商高盛,0,4,4,-1,1.87
"20200824","1783","0037003700390057","7790",國票-彰化,5,0,5,1,2.34
"20200824","1783","003900380031004c","9800",元大-莒光,0,4,4,-1,1.87
"20200824","1783","0039003100330045","9100",群益金鼎-基隆,5,0,5,1,2.34
"20200824","1783","0039003800330069","9800",元大-大雅,0,4,4,-1,1.87
"20200824","1783","9183","9100",群益金鼎-高雄,5,0,5,1,2.34
"20200824","1783","9891","9800",元大-永和,0,4,4,-1,1.87
"20200824","1783","0039003100380047","9100",群益金鼎-新莊,7,3,4,1,1.87
"20200824","1783","003700300030004d","7000",兆豐-桃園,0,3,3,-1,1.40
"20200824","1783","1040","1040",臺銀,3,0,3,1,1.40
"20200824","1783","0039003100380044","9100",群益金鼎-東門,0,3,3,-1,1.40
"20200824","1783","9616","9600",富邦-岡山,3,0,3,1,1.40
"20200824","1783","9252","9200",凱基-嘉義,0,3,3,-1,1.40
"20200824","1783","0039004100390038","9A00",永豐金-大園,3,0,3,1,1.40
"20200824","1783","003900380033006a","9800",元大-仁愛,0,3,3,-1,1.40
"20200824","1783","003500390032006d","5920",元富-成功,3,1,2,1,0.93
"20200824","1783","1560","1560",港商野村,0,2,2,-1,0.93
"20200825","1783","9817","9800",元大-東泰,6,0,6,1,6.67
"20200825","1783","9268","9200",凱基-台北,1,14,13,-1,14.44
"20200825","1783","9234","9200",凱基-竹北,4,0,4,1,4.44
"20200825","1783","0038003100350042","8150",台新-台中,0,5,5,-1,5.56
"20200825","1783","1470","1470",台灣摩根士丹利,4,1,3,1,3.33
"20200825","1783","0035003900320071","5920",元富-屏東,0,4,4,-1,4.44
"20200825","1783","5922","5920",元富-新店,3,0,3,1,3.33
"20200825","1783","1040","1040",臺銀,0,3,3,-1,3.33
"20200825","1783","9328","9300",華南永昌-潮州,3,0,3,1,3.33
"20200825","1783","6950","6950",福勝,0,3,3,-1,3.33
"20200825","1783","9825","9800",元大-新營,5,2,3,1,3.33
"20200825","1783","1480","1480",美商高盛,0,2,2,-1,2.22
"20200825","1783","0035003300380057","5380",第一金-華江,2,0,2,1,2.22
"20200825","1783","0038003800340043","8840",玉山-南京東路,0,2,2,-1,2.22
"20200825","1783","0036003000310064","6010",(牛牛牛)亞-鑫豐,2,0,2,1,2.22
"20200825","1783","003900310038007a","9100",群益金鼎-宜蘭,0,2,2,-1,2.22
"20200825","1783","0035003900320049","5920",元富-嘉義,2,0,2,1,2.22
"20200825","1783","9661","9600",富邦-新店,0,2,2,-1,2.22
"20200825","1783","6450","6450",永全證券,2,0,2,1,2.22
"20200825","1783","0039004100390078","9A00",永豐金-桃園,0,2,2,-1,2.22
"20200825","1783","9103","9100",群益金鼎-松山,2,0,2,1,2.22
"20200825","1783","0035003900320043","5920",元富-潮州,0,1,1,-1,1.11
"20200825","1783","003900310038004d","9100",群益金鼎-嘉義,2,0,2,1,2.22
"20200825","1783","5856","5850",統一-台中,0,1,1,-1,1.11
"20200825","1783","9208","9200",凱基-桃園,3,1,2,1,2.22
"20200825","1783","1440","1440",美林,5,6,1,-1,1.11
"20200825","1783","0039003200310046","9200",凱基-天母,2,0,2,1,2.22
"20200825","1783","6452","6450",永全-八德,0,1,1,-1,1.11
"20200826","1783","1520","1520",瑞士信貸,32,0,32,1,15.38
"20200826","1783","9300","9300",華南永昌,0,20,20,-1,9.62
"20200826","1783","1440","1440",美林,24,2,22,1,10.58
"20200826","1783","9834","9800",元大-中壢,0,16,16,-1,7.69
"20200826","1783","1560","1560",港商野村,19,0,19,1,9.13
"20200826","1783","9634","9600",富邦-羅東,0,10,10,-1,4.81
"20200826","1783","0039003600320045","9600",富邦-樹林,15,3,12,1,5.77
"20200826","1783","0039003800300061","9800",元大-承德,0,9,9,-1,4.33
"20200826","1783","0039003800300064","9800",元大-沙鹿,7,0,7,1,3.37
"20200826","1783","9234","9200",凱基-竹北,0,7,7,-1,3.37
"20200826","1783","2187","2180",亞東-台中,5,0,5,1,2.40
"20200826","1783","0035003900320055","5920",元富-宜蘭,0,5,5,-1,2.40
"20200826","1783","9208","9200",凱基-桃園,5,0,5,1,2.40
"20200826","1783","0037003700390065","7790",國票-南科,0,5,5,-1,2.40
"20200826","1783","0037003000300046","7000",兆豐-虎尾,3,0,3,1,1.44
"20200826","1783","9229","9200",凱基-中山,0,5,5,-1,2.40
"20200826","1783","2180","2180",亞東,2,0,2,1,0.96
"20200826","1783","0039004100360039","9A00",永豐金-屏東,0,5,5,-1,2.40
"20200826","1783","7750","7750",北城證券,2,0,2,1,0.96
"20200826","1783","0039004100380039","9A00",永豐金-敦北,0,5,5,-1,2.40
"20200826","1783","8157","8150",台新-左楠,2,0,2,1,0.96
"20200826","1783","0036003000310064","6010",(牛牛牛)亞-鑫豐,0,4,4,-1,1.92
"20200826","1783","9103","9100",群益金鼎-松山,4,2,2,1,0.96
"20200826","1783","9333","9300",華南永昌-長虹,0,4,4,-1,1.92
"20200826","1783","0039003100380047","9100",群益金鼎-新莊,11,9,2,1,0.96
"20200826","1783","5322","5320",高橋-中壢,0,3,3,-1,1.44
"20200826","1783","0039003800310045","9800",元大-發財,2,0,2,1,0.96
"20200826","1783","003500330038006a","5380",第一金-安和,0,3,3,-1,1.44
"20200827","1783","1650","1650",新加坡商瑞銀,7,0,7,1,4.96
"20200827","1783","9268","9200",凱基-台北,3,16,13,-1,9.22
"20200827","1783","5856","5850",統一-台中,7,1,6,1,4.26
"20200827","1783","9187","9100",群益金鼎-彰化,0,8,8,-1,5.67
"20200827","1783","9815","9800",元大-大灣,6,0,6,1,4.26
"20200827","1783","1520","1520",瑞士信貸,4,9,5,-1,3.55
"20200827","1783","003500390032006d","5920",元富-成功,5,0,5,1,3.55
"20200827","1783","9651","9600",富邦-民生(停),0,5,5,-1,3.55
"20200827","1783","0035003900320055","5920",元富-宜蘭,5,0,5,1,3.55
"20200827","1783","9875","9800",元大-土城永寧,0,5,5,-1,3.55
"20200827","1783","0036003000310064","6010",(牛牛牛)亞-鑫豐,6,1,5,1,3.55
"20200827","1783","6210","6210",新百王,0,4,4,-1,2.84
"20200827","1783","9634","9600",富邦-羅東,5,0,5,1,3.55
"20200827","1783","9324","9300",華南永昌-岡山,0,4,4,-1,2.84
"20200827","1783","9817","9800",元大-東泰,4,0,4,1,2.84
"20200827","1783","0035003900320067","5920",元富-中原,0,3,3,-1,2.13
"20200827","1783","5961","5960",日茂-埔里,3,0,3,1,2.13
"20200827","1783","9233","9200",凱基-長庚,0,3,3,-1,2.13
"20200827","1783","7750","7750",北城證券,2,0,2,1,1.42
"20200827","1783","0031003200360048","1260",宏遠-中和,0,2,2,-1,1.42
"20200827","1783","8565","8560",新光-桃園,2,0,2,1,1.42
"20200827","1783","5460","5460",寶盛,0,2,2,-1,1.42
"20200827","1783","8880","8880",國泰證券,2,0,2,1,1.42
"20200827","1783","003500330038006a","5380",第一金-安和,2,4,2,-1,1.42
"20200827","1783","9208","9200",凱基-桃園,2,0,2,1,1.42
"20200827","1783","0036003300380041","6380",光和-嘉義,0,2,2,-1,1.42
"20200827","1783","0039003200300057","9200",凱基-大里,2,0,2,1,1.42
"20200827","1783","0037003000300052","7000",兆豐-小港,0,2,2,-1,1.42
"20200828","1783","0039003800310061","9800",元大-歸仁,20,1,19,1,7.04
"20200828","1783","0035003900320044","5920",元富-大昌,0,10,10,-1,3.70
"20200828","1783","003900380039004e","9800",元大-內湖,17,0,17,1,6.30
"20200828","1783","0039003800300064","9800",元大-沙鹿,0,10,10,-1,3.70
"20200828","1783","8560","8560",新光,17,3,14,1,5.19
"20200828","1783","0036003000310064","6010",(牛牛牛)亞-鑫豐,1,9,8,-1,2.96
"20200828","1783","1440","1440",美林,30,18,12,1,4.44
"20200828","1783","0039003100380047","9100",群益金鼎-新莊,1,9,8,-1,2.96
"20200828","1783","0039003100380069","9100",群益金鼎-竹南,10,0,10,1,3.70
"20200828","1783","9817","9800",元大-東泰,2,10,8,-1,2.96
"20200828","1783","1520","1520",瑞士信貸,9,0,9,1,3.33
"20200828","1783","0039003200300047","9200",凱基-彰化,0,6,6,-1,2.22
"20200828","1783","8159","8150",台新-台南,9,0,9,1,3.33
"20200828","1783","0031003000340043","1040",臺銀-高雄,0,5,5,-1,1.85
"20200828","1783","9377","9300",華南永昌-虎尾,6,0,6,1,2.22
"20200828","1783","003500330038006a","5380",第一金-安和,0,5,5,-1,1.85
"20200828","1783","5260","5260",美好,5,0,5,1,1.85
"20200828","1783","0035003900320055","5920",元富-宜蘭,0,5,5,-1,1.85
"20200828","1783","1650","1650",新加坡商瑞銀,4,0,4,1,1.48
"20200828","1783","9208","9200",凱基-桃園,0,5,5,-1,1.85
"20200828","1783","1560","1560",港商野村,4,0,4,1,1.48
"20200828","1783","0039003200310059","9200",凱基-東勢,0,5,5,-1,1.85
"20200828","1783","1470","1470",台灣摩根士丹利,10,6,4,1,1.48
"20200828","1783","9634","9600",富邦-羅東,0,5,5,-1,1.85
"20200828","1783","003900410039004b","9A00",永豐金-三重,4,0,4,1,1.48
"20200828","1783","9834","9800",元大-中壢,0,5,5,-1,1.85
"20200828","1783","0035003900320063","5920",元富-烏日,3,0,3,1,1.11
"20200828","1783","7003","7000",兆豐-台中,0,4,4,-1,1.48
"20200831","1783","0035003900320057","5920",元富-吉利,25,0,25,1,9.92
"20200831","1783","0035003800350048","5850",統一-桃園,0,40,40,-1,15.87
"20200831","1783","0039003800300064","9800",元大-沙鹿,16,3,13,1,5.16
"20200831","1783","1440","1440",美林,6,37,31,-1,12.30
"20200831","1783","8886","8880",國泰-新莊,10,0,10,1,3.97
"20200831","1783","1560","1560",港商野村,0,15,15,-1,5.95
"20200831","1783","0039003600350055","9600",富邦-彰化,10,0,10,1,3.97
"20200831","1783","8440","8440",摩根大通,0,12,12,-1,4.76
"20200831","1783","0036003000310064","6010",(牛牛牛)亞-鑫豐,6,0,6,1,2.38
"20200831","1783","9268","9200",凱基-台北,13,22,9,-1,3.57
"20200831","1783","8560","8560",新光,6,0,6,1,2.38
"20200831","1783","9623","9600",富邦-台北,1,10,9,-1,3.57
"20200831","1783","0039003100380047","9100",群益金鼎-新莊,7,1,6,1,2.38
"20200831","1783","9274","9200",凱基-鳳山,0,7,7,-1,2.78
"20200831","1783","0039004100390038","9A00",永豐金-大園,6,0,6,1,2.38
"20200831","1783","2187","2180",亞東-台中,0,5,5,-1,1.98
"20200831","1783","003500330038006a","5380",第一金-安和,6,1,5,1,1.98
"20200831","1783","1470","1470",台灣摩根士丹利,0,4,4,-1,1.59
"20200831","1783","0035003900320055","5920",元富-宜蘭,5,0,5,1,1.98
"20200831","1783","0035003300380046","5380",第一金-大稻埕,0,3,3,-1,1.19
"20200831","1783","9252","9200",凱基-嘉義,5,0,5,1,1.98
"20200831","1783","003900380033006a","9800",元大-仁愛,0,3,3,-1,1.19
"20200831","1783","9283","9200",凱基-北門,5,0,5,1,1.98
"20200831","1783","5265","5260",美好-苗栗,0,2,2,-1,0.79
"20200831","1783","9289","9200",凱基-興隆,5,0,5,1,1.98
"20200831","1783","0039003800310056","9800",元大-民雄,0,2,2,-1,0.79
"20200831","1783","1520","1520",瑞士信貸,10,6,4,1,1.59
"20200831","1783","0039003800390045","9800",元大-草屯,0,2,2,-1,0.79
"20230525","1783","8560","8560",新光,56,9,47,1,3.96
"20230525","1783","1470","1470",台灣摩根士丹利,0,143,143,-1,12.04
"20230525","1783","8849","8840",玉山-景美,20,0,20,1,1.68
"20230525","1783","1440","1440",美林,1,124,123,-1,10.35
"20230525","1783","0039003800390044","9800",元大-左營,20,0,20,1,1.68
"20230525","1783","9268","9200",凱基-台北,25,137,112,-1,9.43
"20230525","1783","0031003200360069","1260",宏遠-光隆,18,0,18,1,1.52
"20230525","1783","1650","1650",新加坡商瑞銀,16,113,97,-1,8.16
"20230525","1783","9315","9300",華南永昌-苑裡,20,3,17,1,1.43
"20230525","1783","003900380031004c","9800",元大-莒光,0,26,26,-1,2.19
"20230525","1783","0039004100300030","9A00",永豐金證券,17,0,17,1,1.43
"20230525","1783","8440","8440",摩根大通,0,22,22,-1,1.85
"20230525","1783","9800","9800",元大證券,22,6,16,1,1.35
"20230525","1783","9897","9800",元大-土城,0,16,16,-1,1.35
"20230525","1783","0039003800330055","9800",元大-頭份,18,4,14,1,1.18
"20230525","1783","9233","9200",凱基-長庚,0,15,15,-1,1.26
"20230525","1783","9831","9800",元大-四維,12,0,12,1,1.01
"20230525","1783","9658","9600",富邦-建國,2,10,8,-1,0.67
"20230525","1783","0039004100390066","9A00",永豐金-中盛,16,4,12,1,1.01
"20230525","1783","9206","9200",凱基-高雄,0,7,7,-1,0.59
"20230525","1783","6450","6450",永全證券,11,0,11,1,0.93
"20230525","1783","0035003900320044","5920",元富-大昌,0,7,7,-1,0.59
"20230525","1783","9324","9300",華南永昌-岡山,11,0,11,1,0.93
"20230525","1783","0036003300380044","6380",光和-高雄,0,7,7,-1,0.59
"20230525","1783","9625","9600",富邦-竹東,11,0,11,1,0.93
"20230525","1783","0035003300380045","5380",第一金-自由,0,6,6,-1,0.51
"20230525","1783","9215","9200",凱基-高美館,11,0,11,1,0.93
"20230525","1783","0035003900320055","5920",元富-宜蘭,0,6,6,-1,0.51
"20230526","1783","0031003000340041","1040",臺銀-臺中,84,16,68,1,2.32
"20230526","1783","9268","9200",凱基-台北,111,308,197,-1,6.73
"20230526","1783","8560","8560",新光,86,23,63,1,2.15
"20230526","1783","0039004100390057","9A00",永豐金-市政,18,161,143,-1,4.89
"20230526","1783","0039004100300030","9A00",永豐金證券,46,3,43,1,1.47
"20230526","1783","1650","1650",新加坡商瑞銀,53,194,141,-1,4.82
"20230526","1783","9324","9300",華南永昌-岡山,35,1,34,1,1.16
"20230526","1783","1470","1470",台灣摩根士丹利,2,125,123,-1,4.20
"20230526","1783","8888","8880",國泰-敦南,34,2,32,1,1.09
"20230526","1783","1560","1560",港商野村,0,94,94,-1,3.21
"20230526","1783","9867","9800",元大-北成功,30,0,30,1,1.02
"20230526","1783","1440","1440",美林,32,120,88,-1,3.01
"20230526","1783","0035003300380044","5380",第一金-忠孝,30,0,30,1,1.02
"20230526","1783","6160","6160",中國信託,1,79,78,-1,2.66
"20230526","1783","6165","6160",中國信託-新竹,30,0,30,1,1.02
"20230526","1783","8150","8150",台新證券,17,76,59,-1,2.02
"20230526","1783","9278","9200",凱基-永康,29,0,29,1,0.99
"20230526","1783","0035003300380043","5380",第一金-光復,0,55,55,-1,1.88
"20230526","1783","0039004100390055","9A00",永豐金-中正,30,2,28,1,0.96
"20230526","1783","9623","9600",富邦-台北,5,51,46,-1,1.57
"20230526","1783","6464","6460",大昌-新店,42,15,27,1,0.92
"20230526","1783","003700370039005a","7790",國票-安和,0,33,33,-1,1.13
"20230526","1783","9257","9200",凱基-林口,25,1,24,1,0.82
"20230526","1783","1480","1480",美商高盛,19,48,29,-1,0.99
"20230526","1783","7006","7000",兆豐-台南,23,0,23,1,0.79
"20230526","1783","8440","8440",摩根大通,6,31,25,-1,0.85
"20230526","1783","0037003700390065","7790",國票-南科,23,0,23,1,0.79
"20230526","1783","0039003100330059","9100",群益金鼎-館前,0,25,25,-1,0.85
"20230529","1783","9268","9200",凱基-台北,79,37,42,1,5.02
"20230529","1783","9891","9800",元大-永和,0,52,52,-1,6.21
"20230529","1783","1440","1440",美林,36,10,26,1,3.11
"20230529","1783","5850","5850",統一,0,30,30,-1,3.58
"20230529","1783","1560","1560",港商野村,33,15,18,1,2.15
"20230529","1783","0039004100390041","9A00",永豐金-羅東,3,25,22,-1,2.63
"20230529","1783","6114","6110",台中銀-員林,15,0,15,1,1.79
"20230529","1783","0035003300380044","5380",第一金-忠孝,3,23,20,-1,2.39
"20230529","1783","9604","9600",富邦-陽明,14,0,14,1,1.67
"20230529","1783","8150","8150",台新證券,4,18,14,-1,1.67
"20230529","1783","0039003600310043","9600",富邦-南京,14,0,14,1,1.67
"20230529","1783","1116","1110",台灣企銀-屏東,0,10,10,-1,1.19
"20230529","1783","8840","8840",玉山證券,12,1,11,1,1.31
"20230529","1783","1040","1040",臺銀,0,10,10,-1,1.19
"20230529","1783","1480","1480",美商高盛,38,28,10,1,1.19
"20230529","1783","0039003800330057","9800",元大-大里德芳,0,10,10,-1,1.19
"20230529","1783","9185","9100",群益金鼎-台南,10,0,10,1,1.19
"20230529","1783","0038003400350046","8450",康和-仁愛,1,10,9,-1,1.08
"20230529","1783","0039003100380063","9100",群益金鼎-鳳山,10,0,10,1,1.19
"20230529","1783","0039003800320041","9800",元大-羅東,0,8,8,-1,0.96
"20230529","1783","0039003600320056","9600",富邦-復興,9,0,9,1,1.08
"20230529","1783","8881","8880",國泰-高雄,0,7,7,-1,0.84
"20230529","1783","6380","6380",光和,9,1,8,1,0.96
"20230529","1783","0039004100300030","9A00",永豐金證券,14,21,7,-1,0.84
"20230529","1783","6950","6950",福勝,6,0,6,1,0.72
"20230529","1783","5856","5850",統一-台中,1,7,6,-1,0.72
"20230529","1783","8711","8710",陽信-石牌,6,0,6,1,0.72
"20230529","1783","8159","8150",台新-台南,2,8,6,-1,0.72
"20230530","1783","6160","6160",中國信託,33,0,33,1,5.55
"20230530","1783","9268","9200",凱基-台北,13,75,62,-1,10.42
"20230530","1783","0031003200360069","1260",宏遠-光隆,12,0,12,1,2.02
"20230530","1783","5920","5920",元富,1,59,58,-1,9.75
"20230530","1783","0039003800330057","9800",元大-大里德芳,12,0,12,1,2.02
"20230530","1783","0039003200300046","9200",凱基-站前,1,26,25,-1,4.20
"20230530","1783","003900380039004e","9800",元大-內湖,11,0,11,1,1.85
"20230530","1783","0039004100390041","9A00",永豐金-羅東,0,25,25,-1,4.20
"20230530","1783","1028","1020",合庫-彰化,10,0,10,1,1.68
"20230530","1783","1650","1650",新加坡商瑞銀,18,39,21,-1,3.53
"20230530","1783","0035003900320057","5920",元富-吉利,10,0,10,1,1.68
"20230530","1783","8150","8150",台新證券,1,20,19,-1,3.19
"20230530","1783","0039004100390055","9A00",永豐金-中正,10,0,10,1,1.68
"20230530","1783","1480","1480",美商高盛,7,23,16,-1,2.69
"20230530","1783","0031003000340041","1040",臺銀-臺中,23,14,9,1,1.51
"20230530","1783","6114","6110",台中銀-員林,0,10,10,-1,1.68
"20230530","1783","0039003100380043","9100",群益金鼎-古亭,9,0,9,1,1.51
"20230530","1783","0039003800320041","9800",元大-羅東,0,10,10,-1,1.68
"20230530","1783","003900380030006c","9800",元大-虎尾,8,0,8,1,1.34
"20230530","1783","6385","6380",光和-花壇,0,8,8,-1,1.34
"20230530","1783","9209","9200",凱基-岡山,6,0,6,1,1.01
"20230530","1783","0039004100390066","9A00",永豐金-中盛,0,7,7,-1,1.18
"20230530","1783","9215","9200",凱基-高美館,6,0,6,1,1.01
"20230530","1783","8440","8440",摩根大通,0,6,6,-1,1.01
"20230530","1783","9278","9200",凱基-永康,6,0,6,1,1.01
"20230530","1783","0035003900320050","5920",元富-同大,0,5,5,-1,0.84
"20230530","1783","0039003800390044","9800",元大-左營,6,0,6,1,1.01
"20230530","1783","9604","9600",富邦-陽明,2,7,5,-1,0.84
"20230531","1783","8150","8150",台新證券,25,1,24,1,3.46
"20230531","1783","1480","1480",美商高盛,19,88,69,-1,9.96
"20230531","1783","0039003100380044","9100",群益金鼎-東門,20,0,20,1,2.89
"20230531","1783","9692","9600",富邦-嘉義,0,22,22,-1,3.17
"20230531","1783","0035003300380044","5380",第一金-忠孝,21,5,16,1,2.31
"20230531","1783","9616","9600",富邦-岡山,0,18,18,-1,2.60
"20230531","1783","0039003200300046","9200",凱基-站前,14,1,13,1,1.88
"20230531","1783","0039003800320041","9800",元大-羅東,30,41,11,-1,1.59
"20230531","1783","8888","8880",國泰-敦南,12,0,12,1,1.73
"20230531","1783","0039003800390053","9800",元大-鹿港,0,10,10,-1,1.44
"20230531","1783","5385","5380",第一金-桃園,10,0,10,1,1.44
"20230531","1783","1560","1560",港商野村,6,14,8,-1,1.15
"20230531","1783","6110","6110",台中銀,10,0,10,1,1.44
"20230531","1783","0039003800310042","9800",元大-竹北,0,8,8,-1,1.15
"20230531","1783","9800","9800",元大證券,10,0,10,1,1.44
"20230531","1783","1440","1440",美林,3,10,7,-1,1.01
"20230531","1783","0039003600310050","9600",富邦-和美,10,1,9,1,1.30
"20230531","1783","1650","1650",新加坡商瑞銀,3,10,7,-1,1.01
"20230531","1783","8159","8150",台新-台南,10,2,8,1,1.15
"20230531","1783","6461","6460",大昌-樹林,1,7,6,-1,0.87
"20230531","1783","9666","9600",富邦-南屯,11,3,8,1,1.15
"20230531","1783","9604","9600",富邦-陽明,0,6,6,-1,0.87
"20230531","1783","0039003100380043","9100",群益金鼎-古亭,9,2,7,1,1.01
"20230531","1783","0031003200360069","1260",宏遠-光隆,0,5,5,-1,0.72
"20230531","1783","8560","8560",新光,9,3,6,1,0.87
"20230531","1783","0038003400350046","8450",康和-仁愛,0,5,5,-1,0.72
"20230531","1783","9205","9200",凱基-三重,6,0,6,1,0.87
"20230531","1783","9859","9800",元大-新竹經國,0,5,5,-1,0.72
"20200701","1783","1040","1040",臺銀,70,0,70,1,8.66
"20200701","1783","9200","9200",凱基,0,30,30,-1,3.71
"20200701","1783","9268","9200",凱基-台北,54,14,40,1,4.95
"20200701","1783","0035003900320044","5920",元富-大昌,0,20,20,-1,2.48
"20200701","1783","1520","1520",瑞士信貸,40,16,24,1,2.97
"20200701","1783","9334","9300",華南永昌-世貿,0,20,20,-1,2.48
"20200701","1783","1560","1560",港商野村,24,8,16,1,1.98
"20200701","1783","003900380039006a","9800",元大-樹林,2,18,16,-1,1.98
"20200701","1783","0039003800390061","9800",元大-苑裡,13,0,13,1,1.61
"20200701","1783","9208","9200",凱基-桃園,4,14,10,-1,1.24
"20200701","1783","0039003800300043","9800",元大-斗六,11,0,11,1,1.36
"20200701","1783","9226","9200",凱基-汐止,2,12,10,-1,1.24
"20200701","1783","9604","9600",富邦-陽明,9,2,7,1,0.87
"20200701","1783","9272","9200",凱基-竹科,2,12,10,-1,1.24
"20200701","1783","0039003800310041","9800",元大-鶯歌,7,0,7,1,0.87
"20200701","1783","9328","9300",華南永昌-潮州,0,10,10,-1,1.24
"20200701","1783","6464","6460",大昌-新店,7,1,6,1,0.74
"20200701","1783","9366","9300",華南永昌-豐原,0,10,10,-1,1.24
"20200701","1783","003700370039004a","7790",國票-北高雄,10,4,6,1,0.74
"20200701","1783","0039004100390078","9A00",永豐金-桃園,0,10,10,-1,1.24
"20200701","1783","9315","9300",華南永昌-苑裡,6,0,6,1,0.74
"20200701","1783","9661","9600",富邦-新店,1,10,9,-1,1.11
"20200701","1783","0035003800350042","5850",統一-永和,5,0,5,1,0.62
"20200701","1783","9184","9100",群益金鼎-台中,2,10,8,-1,0.99
"20200701","1783","003700370039006d","7790",國票-中港,5,0,5,1,0.62
"20200701","1783","6164","6160",中國信託-文心,1,8,7,-1,0.87
"20200701","1783","9204","9200",凱基-台中,5,0,5,1,0.62
"20200701","1783","8380","8380",安泰,0,7,7,-1,0.87
"20200702","1783","0038003800380041","8880",國泰-館前,31,0,31,1,2.72
"20200702","1783","0035003900320061","5920",元富-松德,0,55,55,-1,4.82
"20200702","1783","9863","9800",元大-和平,21,0,21,1,1.84
"20200702","1783","0037003700390063","7790",國票-敦北法人,0,50,50,-1,4.38
"20200702","1783","0035003900320055","5920",元富-宜蘭,16,0,16,1,1.40
"20200702","1783","1520","1520",瑞士信貸,4,38,34,-1,2.98
"20200702","1783","9692","9600",富邦-嘉義,19,3,16,1,1.40
"20200702","1783","9268","9200",凱基-台北,32,62,30,-1,2.63
"20200702","1783","0038003100350048","8150",台新-屏東,13,0,13,1,1.14
"20200702","1783","003700370039004a","7790",國票-北高雄,0,22,22,-1,1.93
"20200702","1783","9834","9800",元大-中壢,13,1,12,1,1.05
"20200702","1783","0039004100390064","9A00",永豐金-古亭,0,21,21,-1,1.84
"20200702","1783","5320","5320",高橋,14,3,11,1,0.96
"20200702","1783","1560","1560",港商野村,14,33,19,-1,1.67
"20200702","1783","8565","8560",新光-桃園,11,0,11,1,0.96
"20200702","1783","0036003100310041","6110",台中銀-豐原,0,19,19,-1,1.67
"20200702","1783","9224","9200",凱基-新莊,11,0,11,1,0.96
"20200702","1783","9272","9200",凱基-竹科,0,14,14,-1,1.23
"20200702","1783","1045","1040",臺銀-新竹,10,0,10,1,0.88
"20200702","1783","9300","9300",華南永昌,7,20,13,-1,1.14
"20200702","1783","6461","6460",大昌-樹林,10,0,10,1,0.88
"20200702","1783","0039003800310045","9800",元大-發財,3,15,12,-1,1.05
"20200702","1783","9327","9300",華南永昌-斗六,10,0,10,1,0.88
"20200702","1783","9654","9600",富邦-永和,0,11,11,-1,0.96
"20200702","1783","5385","5380",第一金-桃園,10,1,9,1,0.79
"20200702","1783","2184","2180",亞東-新竹,0,10,10,-1,0.88
"20200702","1783","9326","9300",華南永昌-南京,9,0,9,1,0.79
"20200702","1783","003500390032006e","5920",元富-西松,0,10,10,-1,0.88
"20200703","1783","9672","9600",富邦-員林,36,1,35,1,2.04
"20200703","1783","1040","1040",臺銀,0,70,70,-1,4.09
"20200703","1783","5850","5850",統一,34,4,30,1,1.75
"20200703","1783","0039004100390045","9A00",永豐金-板橋,2,37,35,-1,2.04
"20200703","1783","6461","6460",大昌-樹林,23,0,23,1,1.34
"20200703","1783","0035003800350062","5850",統一-內湖,0,30,30,-1,1.75
"20200703","1783","1520","1520",瑞士信貸,29,9,20,1,1.17
"20200703","1783","9302","9300",華南永昌-台中,1,30,29,-1,1.69
"20200703","1783","0039003200310046","9200",凱基-天母,18,0,18,1,1.05
"20200703","1783","003500390032007a","5920",元富-文心,1,29,28,-1,1.64
"20200703","1783","9604","9600",富邦-陽明,18,0,18,1,1.05
"20200703","1783","6160","6160",中國信託,0,20,20,-1,1.17
"20200703","1783","8150","8150",台新證券,28,12,16,1,0.93
"20200703","1783","0037003000300045","7000",兆豐-斗南(停),0,18,18,-1,1.05
"20200703","1783","0039004100300030","9A00",永豐金證券,15,0,15,1,0.88
"20200703","1783","8560","8560",新光,9,26,17,-1,0.99
"20200703","1783","0039003600320045","9600",富邦-樹林,14,0,14,1,0.82
"20200703","1783","9285","9200",凱基-中壢,5,22,17,-1,0.99
"20200703","1783","9863","9800",元大-和平,13,0,13,1,0.76
"20200703","1783","9252","9200",凱基-嘉義,0,16,16,-1,0.93
"20200703","1783","0039003800300043","9800",元大-斗六,11,0,11,1,0.64
"20200703","1783","0035003900320044","5920",元富-大昌,0,15,15,-1,0.88
"20200703","1783","5261","5260",美好-蘆洲,11,1,10,1,0.58
"20200703","1783","0037003700390063","7790",國票-敦北法人,0,15,15,-1,0.88
"20200703","1783","5385","5380",第一金-桃園,10,0,10,1,0.58
"20200703","1783","9692","9600",富邦-嘉義,1,16,15,-1,0.88
"20200703","1783","003500380035004d","5850",統一-士林,10,0,10,1,0.58
"20200703","1783","0039003800390043","9800",元大-板橋,0,15,15,-1,0.88
"20200706","1783","9252","9200",凱基-嘉義,35,0,35,1,2.22
"20200706","1783","5920","5920",元富,1,94,93,-1,5.89
"20200706","1783","003700300030004a","7000",兆豐-公益,25,0,25,1,1.58
"20200706","1783","7795","7790",國票-南港,0,82,82,-1,5.20
"20200706","1783","1045","1040",臺銀-新竹,23,0,23,1,1.46
"20200706","1783","9103","9100",群益金鼎-松山,0,55,55,-1,3.49
"20200706","1783","5320","5320",高橋,22,0,22,1,1.39
"20200706","1783","0039003100380048","9100",群益金鼎-中山,0,25,25,-1,1.58
"20200706","1783","0039003200300046","9200",凱基-站前,20,0,20,1,1.27
"20200706","1783","5961","5960",日茂-埔里,0,21,21,-1,1.33
"20200706","1783","9229","9200",凱基-中山,20,0,20,1,1.27
"20200706","1783","003900310038004d","9100",群益金鼎-嘉義,6,26,20,-1,1.27
"20200706","1783","5386","5380",第一金-彰化,19,0,19,1,1.20
"20200706","1783","7797","7790",國票-中正,10,29,19,-1,1.20
"20200706","1783","0035003900320061","5920",元富-松德,19,0,19,1,1.20
"20200706","1783","003700300030004b","7000",兆豐-新營,0,18,18,-1,1.14
"20200706","1783","9654","9600",富邦-永和,20,1,19,1,1.20
"20200706","1783","9287","9200",凱基-內湖,2,20,18,-1,1.14
"20200706","1783","0039003200300057","9200",凱基-大里,18,0,18,1,1.14
"20200706","1783","9326","9300",華南永昌-南京,1,19,18,-1,1.14
"20200706","1783","9623","9600",富邦-台北,19,1,18,1,1.14
"20200706","1783","9604","9600",富邦-陽明,0,17,17,-1,1.08
"20200706","1783","9835","9800",元大-員林中山,17,0,17,1,1.08
"20200706","1783","9651","9600",富邦-民生(停),4,20,16,-1,1.01
"20200706","1783","9817","9800",元大-東泰,16,0,16,1,1.01
"20200706","1783","9871","9800",元大-忠孝,1,17,16,-1,1.01
"20200706","1783","003900380033006a","9800",元大-仁愛,15,0,15,1,0.95
"20200706","1783","0039003100380057","9100",群益金鼎-忠孝,0,14,14,-1,0.89
"20200707","1783","9229","9200",凱基-中山,42,0,42,1,2.90
"20200707","1783","003500390032007a","5920",元富-文心,0,65,65,-1,4.49
"20200707","1783","003900360035004b","9600",富邦-台中,41,0,41,1,2.83
"20200707","1783","6910","6910",德信,0,53,53,-1,3.66
"20200707","1783","9319","9300",華南永昌-鶯歌,40,0,40,1,2.76
"20200707","1783","8150","8150",台新證券,4,40,36,-1,2.49
"20200707","1783","9654","9600",富邦-永和,42,3,39,1,2.70
"20200707","1783","9672","9600",富邦-員林,2,34,32,-1,2.21
"20200707","1783","0039003800300043","9800",元大-斗六,33,0,33,1,2.28
"20200707","1783","7003","7000",兆豐-台中,0,30,30,-1,2.07
"20200707","1783","7035","7030",致和-東門,30,0,30,1,2.07
"20200707","1783","0039004100300030","9A00",永豐金證券,0,30,30,-1,2.07
"20200707","1783","1560","1560",港商野村,39,16,23,1,1.59
"20200707","1783","5385","5380",第一金-桃園,0,24,24,-1,1.66
"20200707","1783","0036003000310064","6010",(牛牛牛)亞-鑫豐,23,0,23,1,1.59
"20200707","1783","0039003800380042","9800",元大-桃園,1,25,24,-1,1.66
"20200707","1783","6161","6160",中國信託-三重,22,0,22,1,1.52
"20200707","1783","9202","9200",凱基-中港,0,21,21,-1,1.45
"20200707","1783","9892","9800",元大-屏東,20,0,20,1,1.38
"20200707","1783","0035003300380057","5380",第一金-華江,3,23,20,-1,1.38
"20200707","1783","6464","6460",大昌-新店,18,0,18,1,1.24
"20200707","1783","0037003000300063","7000",兆豐-民生,0,20,20,-1,1.38
"20200707","1783","0039003800300044","9800",元大-北府,16,1,15,1,1.04
"20200707","1783","1440","1440",美林,28,45,17,-1,1.17
"20200707","1783","9858","9800",元大-龍潭,15,0,15,1,1.04
"20200707","1783","0037003700390056","7790",國票-天祥,0,15,15,-1,1.04
"20200707","1783","5386","5380",第一金-彰化,16,3,13,1,0.90
"20200707","1783","0038003800340048","8840",玉山-新竹,1,15,14,-1,0.97
"20200708","1783","1440","1440",美林,155,67,88,1,3.51
"20200708","1783","0039003800300043","9800",元大-斗六,0,62,62,-1,2.47
"20200708","1783","1520","1520",瑞士信貸,99,14,85,1,3.39
"20200708","1783","9654","9600",富邦-永和,2,61,59,-1,2.35
"20200708","1783","1560","1560",港商野村,71,22,49,1,1.95
"20200708","1783","6167","6160",中國信託-松江,0,30,30,-1,1.20
"20200708","1783","1470","1470",台灣摩根士丹利,61,29,32,1,1.28
"20200708","1783","7035","7030",致和-東門,0,30,30,-1,1.20
"20200708","1783","9323","9300",華南永昌-小港,27,2,25,1,1.00
"20200708","1783","9300","9300",華南永昌,50,80,30,-1,1.20
"20200708","1783","9226","9200",凱基-汐止,21,0,21,1,0.84
"20200708","1783","9206","9200",凱基-高雄,1,27,26,-1,1.04
"20200708","1783","5929","5920",元富-台南,20,0,20,1,0.80
"20200708","1783","0036003000310064","6010",(牛牛牛)亞-鑫豐,11,34,23,-1,0.92
"20200708","1783","0039004100390062","9A00",永豐金-虎尾,21,1,20,1,0.80
"20200708","1783","9858","9800",元大-龍潭,6,29,23,-1,0.92
"20200708","1783","9205","9200",凱基-三重,19,0,19,1,0.76
"20200708","1783","6461","6460",大昌-樹林,1,23,22,-1,0.88
"20200708","1783","0039003800310047","9800",元大-彰化,22,4,18,1,0.72
"20200708","1783","5386","5380",第一金-彰化,16,36,20,-1,0.80
"20200708","1783","5321","5320",高橋-龍潭,17,0,17,1,0.68
"20200708","1783","6465","6460",大昌-桃園,0,20,20,-1,0.80
"20200708","1783","5923","5920",元富-三重,16,0,16,1,0.64
"20200708","1783","9892","9800",元大-屏東,4,24,20,-1,0.80
"20200708","1783","9878","9800",元大-金華,17,1,16,1,0.64
"20200708","1783","9266","9200",凱基-新豐,1,20,19,-1,0.76
"20200708","1783","5385","5380",第一金-桃園,16,1,15,1,0.60
"20200708","1783","9835","9800",元大-員林中山,1,19,18,-1,0.72
"20200709","1783","9205","9200",凱基-三重,36,0,36,1,1.40
"20200709","1783","9229","9200",凱基-中山,2,43,41,-1,1.59
"20200709","1783","0035003300380050","5380",第一金-路竹,34,0,34,1,1.32
"20200709","1783","9835","9800",元大-員林中山,4,36,32,-1,1.24
"20200709","1783","0038003800340045","8840",玉山-城中,31,1,30,1,1.16
"20200709","1783","6461","6460",大昌-樹林,1,32,31,-1,1.20
"20200709","1783","9209","9200",凱基-岡山,25,4,21,1,0.81
"20200709","1783","1470","1470",台灣摩根士丹利,8,38,30,-1,1.16
"20200709","1783","0035003900320043","5920",元富-潮州,20,0,20,1,0.78
"20200709","1783","1045","1040",臺銀-新竹,4,33,29,-1,1.12
"20200709","1783","9692","9600",富邦-嘉義,26,7,19,1,0.74
"20200709","1783","1440","1440",美林,122,150,28,-1,1.09
"20200709","1783","0039003100380067","9100",群益金鼎-大甲,18,0,18,1,0.70
"20200709","1783","0035003900320041","5920",元富-緯城,0,24,24,-1,0.93
"20200709","1783","0039003600310048","9600",富邦-新板,25,7,18,1,0.70
"20200709","1783","0037003000300048","7000",兆豐-東門,2,25,23,-1,0.89
"20200709","1783","0037003000300063","7000",兆豐-民生,20,3,17,1,0.66
"20200709","1783","0036003100310041","6110",台中銀-豐原,3,24,21,-1,0.81
"20200709","1783","8440","8440",摩根大通,30,14,16,1,0.62
"20200709","1783","8520","8520",中農,0,21,21,-1,0.81
"20200709","1783","5265","5260",美好-苗栗,15,0,15,1,0.58
"20200709","1783","9208","9200",凱基-桃園,0,20,20,-1,0.78
"20200709","1783","9187","9100",群益金鼎-彰化,15,0,15,1,0.58
"20200709","1783","9817","9800",元大-東泰,3,21,18,-1,0.70
"20200709","1783","0039003200300043","9200",凱基-雙和,15,0,15,1,0.58
"20200709","1783","003700300030006a","7000",兆豐-大安,9,26,17,-1,0.66
"20200709","1783","9651","9600",富邦-民生(停),16,1,15,1,0.58
"20200709","1783","7750","7750",北城證券,1,17,16,-1,0.62
"20200710","1783","9817","9800",元大-東泰,29,1,28,1,1.83
"20200710","1783","5385","5380",第一金-桃園,2,96,94,-1,6.15
"20200710","1783","0039003200300046","9200",凱基-站前,44,20,24,1,1.57
"20200710","1783","003500390032006c","5920",元富-大裕,1,55,54,-1,3.53
"20200710","1783","5323","5320",高橋-內壢,26,4,22,1,1.44
"20200710","1783","0039003200310059","9200",凱基-東勢,0,30,30,-1,1.96
"20200710","1783","9801","9800",元大-城東,20,0,20,1,1.31
"20200710","1783","9108","9100",群益金鼎-海山,0,24,24,-1,1.57
"20200710","1783","0035003900320061","5920",元富-松德,19,0,19,1,1.24
"20200710","1783","0039003600320045","9600",富邦-樹林,9,31,22,-1,1.44
"20200710","1783","0035003900320050","5920",元富-同大,18,0,18,1,1.18
"20200710","1783","0037003000300061","7000",兆豐-忠孝,5,26,21,-1,1.37
"20200710","1783","9837","9800",元大-北港,17,0,17,1,1.11
"20200710","1783","0039003200300057","9200",凱基-大里,1,21,20,-1,1.31
"20200710","1783","0039003600310045","9600",富邦-府城,17,1,16,1,1.05
"20200710","1783","0039004100390062","9A00",永豐金-虎尾,0,20,20,-1,1.31
"20200710","1783","0039003800300044","9800",元大-北府,16,0,16,1,1.05
"20200710","1783","5320","5320",高橋,7,25,18,-1,1.18
"20200710","1783","003500330038004d","5380",第一金-嘉義,16,1,15,1,0.98
"20200710","1783","0039003800320042","9800",元大-博愛,0,16,16,-1,1.05
"20200710","1783","1520","1520",瑞士信貸,40,26,14,1,0.92
"20200710","1783","5263","5260",美好-泰山,0,12,12,-1,0.79
"20200710","1783","2187","2180",亞東-台中,13,0,13,1,0.85
"20200710","1783","9854","9800",元大-文心興安,1,12,11,-1,0.72
"20200710","1783","0039003600310050","9600",富邦-和美,12,0,12,1,0.79
"20200710","1783","0031003100310041","1110",台灣企銀-民雄,0,10,10,-1,0.65
"20200710","1783","0039003800300064","9800",元大-沙鹿,12,0,12,1,0.79
"20200710","1783","0037003000300063","7000",兆豐-民生,0,10,10,-1,0.65
"20200713","1783","003900410039004a","9A00",永豐金-板新,21,0,21,1,2.75
"20200713","1783","9205","9200",凱基-三重,0,34,34,-1,4.46
"20200713","1783","1520","1520",瑞士信貸,29,11,18,1,2.36
"20200713","1783","0039003800300065","9800",元大-清水,0,26,26,-1,3.41
"20200713","1783","9817","9800",元大-東泰,17,1,16,1,2.10
"20200713","1783","9323","9300",華南永昌-小港,0,16,16,-1,2.10
"20200713","1783","6110","6110",台中銀,15,0,15,1,1.97
"20200713","1783","0039004100390059","9A00",永豐金-板盛,0,16,16,-1,2.10
"20200713","1783","5320","5320",高橋,15,1,14,1,1.83
"20200713","1783","003500330038004d","5380",第一金-嘉義,11,26,15,-1,1.97
"20200713","1783","8150","8150",台新證券,12,1,11,1,1.44
"20200713","1783","003700370039006d","7790",國票-中港,0,10,10,-1,1.31
"20200713","1783","0039003800390041","9800",元大-北投,11,0,11,1,1.44
"20200713","1783","9239","9200",凱基-市政,1,11,10,-1,1.31
"20200713","1783","0038003100350048","8150",台新-屏東,10,0,10,1,1.31
"20200713","1783","9651","9600",富邦-民生(停),0,10,10,-1,1.31
"20200713","1783","8711","8710",陽信-石牌,10,0,10,1,1.31
"20200713","1783","0035003900320043","5920",元富-潮州,1,10,9,-1,1.18
"20200713","1783","003900310038004d","9100",群益金鼎-嘉義,15,5,10,1,1.31
"20200713","1783","7034","7030",致和-金華,1,10,9,-1,1.18
"20200713","1783","0039003600310048","9600",富邦-新板,9,1,8,1,1.05
"20200713","1783","1560","1560",港商野村,1,9,8,-1,1.05
"20200713","1783","5323","5320",高橋-內壢,6,0,6,1,0.79
"20200713","1783","0037003000300063","7000",兆豐-民生,0,8,8,-1,1.05
"20200713","1783","9302","9300",華南永昌-台中,6,0,6,1,0.79
"20200713","1783","0039003100380067","9100",群益金鼎-大甲,1,9,8,-1,1.05
"20200713","1783","9623","9600",富邦-台北,6,0,6,1,0.79
"20200713","1783","0038003400350055","8450",康和-台北,0,7,7,-1,0.92
"20200714","1783","9229","9200",凱基-中山,27,0,27,1,4.34
"20200714","1783","0039003800390050","9800",元大-敦南,0,25,25,-1,4.02
"20200714","1783","003900360031005a","9600",富邦-永康,20,0,20,1,3.22
"20200714","1783","1560","1560",港商野村,7,31,24,-1,3.86
"20200714","1783","9834","9800",元大-中壢,20,4,16,1,2.57
"20200714","1783","9692","9600",富邦-嘉義,0,19,19,-1,3.05
"20200714","1783","0039003600320045","9600",富邦-樹林,14,0,14,1,2.25
"20200714","1783","1029","1020",合庫-鳳山,0,15,15,-1,2.41
"20200714","1783","0037003700390050","7790",國票-九鼎,16,3,13,1,2.09
"20200714","1783","2187","2180",亞東-台中,0,13,13,-1,2.09
"20200714","1783","0039003800310047","9800",元大-彰化,12,0,12,1,1.93
"20200714","1783","6114","6110",台中銀-員林,0,11,11,-1,1.77
"20200714","1783","7035","7030",致和-東門,11,0,11,1,1.77
"20200714","1783","003700300030005a","7000",兆豐-高雄,2,12,10,-1,1.61
"20200714","1783","1115","1110",台灣企銀-太平,10,0,10,1,1.61
"20200714","1783","8710","8710",陽信,0,10,10,-1,1.61
"20200714","1783","0038003400350045","8450",康和-澎湖,10,0,10,1,1.61
"20200714","1783","8560","8560",新光,0,9,9,-1,1.45
"20200714","1783","9686","9600",富邦-宜蘭,10,0,10,1,1.61
"20200714","1783","9871","9800",元大-忠孝,1,10,9,-1,1.45
"20200714","1783","003900380039004e","9800",元大-內湖,10,0,10,1,1.61
"20200714","1783","1650","1650",新加坡商瑞銀,2,10,8,-1,1.29
"20200714","1783","8888","8880",國泰-敦南,10,1,9,1,1.45
"20200714","1783","0039003200300043","9200",凱基-雙和,2,10,8,-1,1.29
"20200714","1783","0039003200300057","9200",凱基-大里,8,0,8,1,1.29
"20200714","1783","9875","9800",元大-土城永寧,2,10,8,-1,1.29
"20200714","1783","0031003200360051","1260",宏遠-高雄,7,0,7,1,1.13
"20200714","1783","0039003600310053","9600",富邦-景美,0,7,7,-1,1.13
"20200715","1783","1480","1480",美商高盛,23,1,22,1,2.33
"20200715","1783","8560","8560",新光,0,33,33,-1,3.50
"20200715","1783","0039003200300046","9200",凱基-站前,31,11,20,1,2.12
"20200715","1783","0039003600310045","9600",富邦-府城,0,29,29,-1,3.08
"20200715","1783","0035003800350052","5850",統一-汐止,15,2,13,1,1.38
"20200715","1783","003500390032006c","5920",元富-大裕,0,22,22,-1,2.33
"20200715","1783","1470","1470",台灣摩根士丹利,20,8,12,1,1.27
"20200715","1783","003900380030004b","9800",元大-竹科,1,20,19,-1,2.01
"20200715","1783","1560","1560",港商野村,20,8,12,1,1.27
"20200715","1783","9206","9200",凱基-高雄,0,17,17,-1,1.80
"20200715","1783","6464","6460",大昌-新店,12,0,12,1,1.27
"20200715","1783","003900380031006a","9800",元大-士林,2,16,14,-1,1.48
"20200715","1783","003900380031006d","9800",元大-前金,12,0,12,1,1.27
"20200715","1783","003900410039004d","9A00",永豐金-南投,0,14,14,-1,1.48
"20200715","1783","0039004100390061","9A00",永豐金-苓雅,12,0,12,1,1.27
"20200715","1783","1650","1650",新加坡商瑞銀,0,11,11,-1,1.17
"20200715","1783","0039003100380047","9100",群益金鼎-新莊,11,0,11,1,1.17
"20200715","1783","5385","5380",第一金-桃園,0,11,11,-1,1.17
"20200715","1783","9208","9200",凱基-桃園,18,7,11,1,1.17
"20200715","1783","0035003800350046","5850",統一-彰化,0,10,10,-1,1.06
"20200715","1783","9604","9600",富邦-陽明,10,0,10,1,1.06
"20200715","1783","0035003900320061","5920",元富-松德,0,10,10,-1,1.06
"20200715","1783","9654","9600",富邦-永和,10,0,10,1,1.06
"20200715","1783","0035003900320043","5920",元富-潮州,0,10,10,-1,1.06
"20200715","1783","5320","5320",高橋,9,0,9,1,0.95
"20200715","1783","9651","9600",富邦-民生(停),1,10,9,-1,0.95
"20200715","1783","8881","8880",國泰-高雄,10,1,9,1,0.95
"20200715","1783","003900380033006a","9800",元大-仁愛,0,9,9,-1,0.95
"20200716","1783","9672","9600",富邦-員林,27,2,25,1,5.08
"20200716","1783","9358","9300",華南永昌-東勢,2,25,23,-1,4.67
"20200716","1783","9898","9800",元大-新莊,17,3,14,1,2.85
"20200716","1783","0039003800390050","9800",元大-敦南,0,15,15,-1,3.05
"20200716","1783","9834","9800",元大-中壢,23,10,13,1,2.64
"20200716","1783","9625","9600",富邦-竹東,1,11,10,-1,2.03
"20200716","1783","5267","5260",美好-基隆,12,0,12,1,2.44
"20200716","1783","0039003800330055","9800",元大-頭份,0,10,10,-1,2.03
"20200716","1783","1650","1650",新加坡商瑞銀,11,0,11,1,2.24
"20200716","1783","0039004100390061","9A00",永豐金-苓雅,0,10,10,-1,2.03
"20200716","1783","7005","7000",兆豐-台中港,10,0,10,1,2.03
"20200716","1783","0039003600310051","9600",富邦-重新,0,8,8,-1,1.63
"20200716","1783","9283","9200",凱基-北門,10,0,10,1,2.03
"20200716","1783","0039003200300045","9200",凱基-東門,0,7,7,-1,1.42
"20200716","1783","0039003100380047","9100",群益金鼎-新莊,10,3,7,1,1.42
"20200716","1783","0031003000320045","1020",合庫-桃園,0,6,6,-1,1.22
"20200716","1783","0039003200320048","9200",凱基-復興,9,2,7,1,1.42
"20200716","1783","0039003600310045","9600",富邦-府城,0,6,6,-1,1.22
"20200716","1783","5921","5920",元富-高雄,5,0,5,1,1.02
"20200716","1783","9897","9800",元大-土城,0,6,6,-1,1.22
"20200716","1783","0035003900320041","5920",元富-緯城,5,0,5,1,1.02
"20200716","1783","6161","6160",中國信託-三重,0,5,5,-1,1.02
"20200716","1783","6452","6450",永全-八德,5,0,5,1,1.02
"20200716","1783","0037003700390063","7790",國票-敦北法人,0,5,5,-1,1.02
"20200716","1783","003700370039005a","7790",國票-安和,5,0,5,1,1.02
"20200716","1783","8157","8150",台新-左楠,0,5,5,-1,1.02
"20200716","1783","0038003400350045","8450",康和-澎湖,5,0,5,1,1.02
"20200716","1783","9217","9200",凱基-松山,0,5,5,-1,1.02
"20200717","1783","0039003800310047","9800",元大-彰化,28,0,28,1,2.06
"20200717","1783","0039003800310068","9800",元大-屏東民生,0,23,23,-1,1.70
"20200717","1783","0039003800310045","9800",元大-發財,22,2,20,1,1.47
"20200717","1783","0038003100350042","8150",台新-台中,3,24,21,-1,1.55
"20200717","1783","8848","8840",玉山-嘉義,17,0,17,1,1.25
"20200717","1783","0037003000300070","7000",兆豐-復興,0,20,20,-1,1.47
"20200717","1783","9134","9100",群益金鼎-開元,16,0,16,1,1.18
"20200717","1783","0039004100390072","9A00",永豐金-北高雄,0,20,20,-1,1.47
"20200717","1783","9604","9600",富邦-陽明,16,0,16,1,1.18
"20200717","1783","8560","8560",新光,9,27,18,-1,1.33
"20200717","1783","1045","1040",臺銀-新竹,13,0,13,1,0.96
"20200717","1783","5385","5380",第一金-桃園,0,18,18,-1,1.33
"20200717","1783","9266","9200",凱基-新豐,13,1,12,1,0.88
"20200717","1783","0039003800390057","9800",元大-豐原站前,5,21,16,-1,1.18
"20200717","1783","9623","9600",富邦-台北,13,1,12,1,0.88
"20200717","1783","9873","9800",元大-西門,0,14,14,-1,1.03
"20200717","1783","0036003300380041","6380",光和-嘉義,11,0,11,1,0.81
"20200717","1783","1470","1470",台灣摩根士丹利,2,15,13,-1,0.96
"20200717","1783","8561","8560",新光-台中,11,0,11,1,0.81
"20200717","1783","6460","6460",大昌,0,12,12,-1,0.88
"20200717","1783","0035003800350046","5850",統一-彰化,10,0,10,1,0.74
"20200717","1783","9288","9200",凱基-埔墘,0,12,12,-1,0.88
"20200717","1783","0037003700390065","7790",國票-南科,10,0,10,1,0.74
"20200717","1783","9347","9300",華南永昌-敦南,0,12,12,-1,0.88
"20200717","1783","0038003400350055","8450",康和-台北,10,0,10,1,0.74
"20200717","1783","0039003600320045","9600",富邦-樹林,0,12,12,-1,0.88
"20200717","1783","9325","9300",華南永昌-忠孝,10,0,10,1,0.74
"20200717","1783","7005","7000",兆豐-台中港,1,12,11,-1,0.81
"20200720","1783","1440","1440",美林,49,4,45,1,6.03
"20200720","1783","0039003100330044","9100",群益金鼎-潭子,0,20,20,-1,2.68
"20200720","1783","1560","1560",港商野村,46,10,36,1,4.83
"20200720","1783","8560","8560",新光,0,19,19,-1,2.55
"20200720","1783","1650","1650",新加坡商瑞銀,36,0,36,1,4.83
"20200720","1783","8380","8380",安泰,0,15,15,-1,2.01
"20200720","1783","8440","8440",摩根大通,43,12,31,1,4.16
"20200720","1783","7005","7000",兆豐-台中港,4,14,10,-1,1.34
"20200720","1783","1470","1470",台灣摩根士丹利,23,0,23,1,3.08
"20200720","1783","8561","8560",新光-台中,0,10,10,-1,1.34
"20200720","1783","0036003300380041","6380",光和-嘉義,23,0,23,1,3.08
"20200720","1783","9217","9200",凱基-松山,0,10,10,-1,1.34
"20200720","1783","0039003600320045","9600",富邦-樹林,12,1,11,1,1.47
"20200720","1783","9834","9800",元大-中壢,0,10,10,-1,1.34
"20200720","1783","0037003700390044","7790",國票-台南,10,0,10,1,1.34
"20200720","1783","003700300030005a","7000",兆豐-高雄,0,8,8,-1,1.07
"20200720","1783","003900360035004b","9600",富邦-台中,12,3,9,1,1.21
"20200720","1783","8564","8560",新光-台南,0,8,8,-1,1.07
"20200720","1783","9814","9800",元大-大益,9,0,9,1,1.21
"20200720","1783","0039003600310045","9600",富邦-府城,2,10,8,-1,1.07
"20200720","1783","5267","5260",美好-基隆,5,0,5,1,0.67
"20200720","1783","0039003800310052","9800",元大-竹山,0,8,8,-1,1.07
"20200720","1783","0038003800340048","8840",玉山-新竹,5,0,5,1,0.67
"20200720","1783","7750","7750",北城證券,0,7,7,-1,0.94
"20200720","1783","9100","9100",群益金鼎,5,0,5,1,0.67
"20200720","1783","9285","9200",凱基-中壢,7,14,7,-1,0.94
"20200720","1783","0039003600320057","9600",富邦-龍潭,5,0,5,1,0.67
"20200720","1783","9333","9300",華南永昌-長虹,0,7,7,-1,0.94
"20200721","1783","8382","8380",安泰-楠梓,52,0,52,1,11.66
"20200721","1783","9834","9800",元大-中壢,0,20,20,-1,4.48
"20200721","1783","9206","9200",凱基-高雄,20,2,18,1,4.04
"20200721","1783","9302","9300",華南永昌-台中,0,17,17,-1,3.81
"20200721","1783","0039003100380078","9100",群益金鼎-延平,15,0,15,1,3.36
"20200721","1783","1440","1440",美林,18,32,14,-1,3.14
"20200721","1783","0039003800310047","9800",元大-彰化,10,0,10,1,2.24
"20200721","1783","5320","5320",高橋,0,13,13,-1,2.91
"20200721","1783","1650","1650",新加坡商瑞銀,9,0,9,1,2.02
"20200721","1783","1520","1520",瑞士信貸,0,11,11,-1,2.47
"20200721","1783","0039003200300057","9200",凱基-大里,7,0,7,1,1.57
"20200721","1783","1470","1470",台灣摩根士丹利,0,11,11,-1,2.47
"20200721","1783","9362","9300",華南永昌-苗栗,6,0,6,1,1.35
"20200721","1783","0035003800350046","5850",統一-彰化,0,10,10,-1,2.24
"20200721","1783","0039003800390061","9800",元大-苑裡,6,0,6,1,1.35
"20200721","1783","003900380039005a","9800",元大-小港,0,9,9,-1,2.02
"20200721","1783","5921","5920",元富-高雄,5,0,5,1,1.12
"20200721","1783","0039004100390078","9A00",永豐金-桃園,0,9,9,-1,2.02
"20200721","1783","0037003700390063","7790",國票-敦北法人,5,0,5,1,1.12
"20200721","1783","1043","1040",臺銀-民權,0,8,8,-1,1.79
"20200721","1783","0039003800310065","9800",元大-佳里,5,0,5,1,1.12
"20200721","1783","8440","8440",摩根大通,10,18,8,-1,1.79
"20200721","1783","9858","9800",元大-龍潭,5,0,5,1,1.12
"20200721","1783","5265","5260",美好-苗栗,0,6,6,-1,1.35
"20200721","1783","5386","5380",第一金-彰化,5,1,4,1,0.90
"20200721","1783","1560","1560",港商野村,0,6,6,-1,1.35
"20200721","1783","0039003100380046","9100",群益金鼎-新店,4,0,4,1,0.90
"20200721","1783","9268","9200",凱基-台北,37,43,6,-1,1.35
"20200722","1783","1650","1650",新加坡商瑞銀,39,0,39,1,7.49
"20200722","1783","0038003400350058","8450",康和-屏東,0,22,22,-1,4.22
"20200722","1783","0037003000300048","7000",兆豐-東門,15,0,15,1,2.88
"20200722","1783","9892","9800",元大-屏東,0,17,17,-1,3.26
"20200722","1783","5921","5920",元富-高雄,10,0,10,1,1.92
"20200722","1783","9274","9200",凱基-鳳山,0,15,15,-1,2.88
"20200722","1783","6950","6950",福勝,10,0,10,1,1.92
"20200722","1783","0039003100380078","9100",群益金鼎-延平,0,11,11,-1,2.11
"20200722","1783","9208","9200",凱基-桃園,10,0,10,1,1.92
"20200722","1783","2180","2180",亞東,0,10,10,-1,1.92
"20200722","1783","0039003600310048","9600",富邦-新板,10,0,10,1,1.92
"20200722","1783","003500390032004c","5920",元富-中壢,0,9,9,-1,1.73
"20200722","1783","9206","9200",凱基-高雄,10,2,8,1,1.54
"20200722","1783","9283","9200",凱基-北門,1,10,9,-1,1.73
"20200722","1783","9816","9800",元大-新竹,7,0,7,1,1.34
"20200722","1783","8560","8560",新光,1,9,8,-1,1.54
"20200722","1783","1440","1440",美林,44,38,6,1,1.15
"20200722","1783","0039004100390037","9A00",永豐金-新竹,0,8,8,-1,1.54
"20200722","1783","5320","5320",高橋,6,0,6,1,1.15
"20200722","1783","9834","9800",元大-中壢,3,10,7,-1,1.34
"20200722","1783","0039003100380047","9100",群益金鼎-新莊,6,0,6,1,1.15
"20200722","1783","0039004100390055","9A00",永豐金-中正,0,7,7,-1,1.34
"20200722","1783","9604","9600",富邦-陽明,6,0,6,1,1.15
"20200722","1783","0039004100390078","9A00",永豐金-桃園,0,7,7,-1,1.34
"20200722","1783","0039003800390061","9800",元大-苑裡,6,0,6,1,1.15
"20200722","1783","0036003300380041","6380",光和-嘉義,0,6,6,-1,1.15
"20200722","1783","1040","1040",臺銀,5,0,5,1,0.96
"20200722","1783","9875","9800",元大-土城永寧,0,6,6,-1,1.15
"20200723","1783","9892","9800",元大-屏東,17,0,17,1,5.56
"20200723","1783","0038003400350058","8450",康和-屏東,0,19,19,-1,6.21
"20200723","1783","9268","9200",凱基-台北,25,11,14,1,4.58
"20200723","1783","9817","9800",元大-東泰,0,14,14,-1,4.58
"20200723","1783","8440","8440",摩根大通,14,1,13,1,4.25
"20200723","1783","5385","5380",第一金-桃園,0,10,10,-1,3.27
"20200723","1783","0039003200300046","9200",凱基-站前,9,0,9,1,2.94
"20200723","1783","0037003700390050","7790",國票-九鼎,0,10,10,-1,3.27
"20200723","1783","1440","1440",美林,23,15,8,1,2.61
"20200723","1783","003900380033006a","9800",元大-仁愛,0,10,10,-1,3.27
"20200723","1783","0039003800310047","9800",元大-彰化,8,0,8,1,2.61
"20200723","1783","6464","6460",大昌-新店,0,9,9,-1,2.94
"20200723","1783","0037003000300055","7000",兆豐-桃鶯,7,0,7,1,2.29
"20200723","1783","9604","9600",富邦-陽明,1,8,7,-1,2.29
"20200723","1783","0039003800390059","9800",元大-基隆,7,0,7,1,2.29
"20200723","1783","9888","9800",元大-鑫永和,0,5,5,-1,1.63
"20200723","1783","9187","9100",群益金鼎-彰化,6,0,6,1,1.96
"20200723","1783","1041","1040",臺銀-鳳山,0,4,4,-1,1.31
"20200723","1783","0039004100390055","9A00",永豐金-中正,6,0,6,1,1.96
"20200723","1783","8150","8150",台新證券,1,5,4,-1,1.31
"20200723","1783","2180","2180",亞東,5,0,5,1,1.63
"20200723","1783","0038003100350041","8150",台新-高雄,0,3,3,-1,0.98
"20200723","1783","9634","9600",富邦-羅東,5,0,5,1,1.63
"20200723","1783","8560","8560",新光,0,3,3,-1,0.98
"20200723","1783","003500330038006a","5380",第一金-安和,4,1,3,1,0.98
"20200723","1783","003900360031004b","9600",富邦-七賢,0,3,3,-1,0.98
"20200723","1783","1520","1520",瑞士信貸,3,0,3,1,0.98
"20200723","1783","9834","9800",元大-中壢,0,3,3,-1,0.98
"20200724","1783","9817","9800",元大-東泰,20,0,20,1,4.43
"20200724","1783","9252","9200",凱基-嘉義,4,33,29,-1,6.43
"20200724","1783","003900360035004b","9600",富邦-台中,18,0,18,1,3.99
"20200724","1783","9274","9200",凱基-鳳山,0,23,23,-1,5.10
"20200724","1783","9105","9100",群益金鼎-高盛,12,0,12,1,2.66
"20200724","1783","6464","6460",大昌-新店,0,20,20,-1,4.43
"20200724","1783","0035003900320045","5920",元富-城中,8,1,7,1,1.55
"20200724","1783","9835","9800",元大-員林中山,2,19,17,-1,3.77
"20200724","1783","0039003100380078","9100",群益金鼎-延平,11,4,7,1,1.55
"20200724","1783","9268","9200",凱基-台北,27,41,14,-1,3.10
"20200724","1783","0039004100390078","9A00",永豐金-桃園,7,0,7,1,1.55
"20200724","1783","0037003700390063","7790",國票-敦北法人,0,10,10,-1,2.22
"20200724","1783","0038003800340042","8840",玉山-台中,6,0,6,1,1.33
"20200724","1783","0037003700390044","7790",國票-台南,0,10,10,-1,2.22
"20200724","1783","1041","1040",臺銀-鳳山,5,0,5,1,1.11
"20200724","1783","9679","9600",富邦-延吉(停),0,10,10,-1,2.22
"20200724","1783","5387","5380",第一金-澎湖,5,0,5,1,1.11
"20200724","1783","0039003800330055","9800",元大-頭份,0,10,10,-1,2.22
"20200724","1783","0037003000300055","7000",兆豐-桃鶯,5,0,5,1,1.11
"20200724","1783","0039003800310052","9800",元大-竹山,0,8,8,-1,1.77
"20200724","1783","8583","8580",聯邦-忠孝,5,0,5,1,1.11
"20200724","1783","5921","5920",元富-高雄,0,5,5,-1,1.11
"20200724","1783","9208","9200",凱基-桃園,6,1,5,1,1.11
"20200724","1783","6460","6460",大昌,0,5,5,-1,1.11
"20200724","1783","9266","9200",凱基-新豐,5,0,5,1,1.11
"20200724","1783","003700300030005a","7000",兆豐-高雄,3,8,5,-1,1.11
"20200724","1783","9283","9200",凱基-北門,5,0,5,1,1.11
"20200724","1783","1115","1110",台灣企銀-太平,0,4,4,-1,0.89
"20200727","1783","9898","9800",元大-新莊,15,0,15,1,2.83
"20200727","1783","8563","8560",新光-新竹,1,24,23,-1,4.34
"20200727","1783","0035003900320045","5920",元富-城中,10,0,10,1,1.89
"20200727","1783","5929","5920",元富-台南,5,24,19,-1,3.58
"20200727","1783","5960","5960",日茂,10,0,10,1,1.89
"20200727","1783","9623","9600",富邦-台北,2,20,18,-1,3.40
"20200727","1783","7750","7750",北城證券,10,0,10,1,1.89
"20200727","1783","8150","8150",台新證券,0,12,12,-1,2.26
"20200727","1783","0037003700390050","7790",國票-九鼎,10,0,10,1,1.89
"20200727","1783","7797","7790",國票-中正,8,18,10,-1,1.89
"20200727","1783","9105","9100",群益金鼎-高盛,10,0,10,1,1.89
"20200727","1783","8564","8560",新光-台南,0,10,10,-1,1.89
"20200727","1783","0039004100390037","9A00",永豐金-新竹,10,0,10,1,1.89
"20200727","1783","9274","9200",凱基-鳳山,0,10,10,-1,1.89
"20200727","1783","003900410039006a","9A00",永豐金-嘉義,10,0,10,1,1.89
"20200727","1783","9333","9300",華南永昌-長虹,0,10,10,-1,1.89
"20200727","1783","0035003900320061","5920",元富-松德,10,2,8,1,1.51
"20200727","1783","0039003600330042","9600",富邦-北宜蘭(停),0,10,10,-1,1.89
"20200727","1783","9358","9300",華南永昌-東勢,8,0,8,1,1.51
"20200727","1783","9657","9600",富邦-苗栗,0,10,10,-1,1.89
"20200727","1783","0039003600310045","9600",富邦-府城,9,2,7,1,1.32
"20200727","1783","003900380033006a","9800",元大-仁愛,0,10,10,-1,1.89
"20200727","1783","9134","9100",群益金鼎-開元,16,10,6,1,1.13
"20200727","1783","9266","9200",凱基-新豐,0,10,10,-1,1.89
"20200727","1783","9838","9800",元大-豐原,6,0,6,1,1.13
"20200727","1783","0035003800350049","5850",統一-員林,10,18,8,-1,1.51
"20200727","1783","0031003000340043","1040",臺銀-高雄,5,0,5,1,0.94
"20200727","1783","5262","5260",美好-楊梅,0,7,7,-1,1.32
"20200728","1783","8440","8440",摩根大通,39,7,32,1,6.50
"20200728","1783","0037003000300055","7000",兆豐-桃鶯,0,12,12,-1,2.44
"20200728","1783","9252","9200",凱基-嘉義,16,0,16,1,3.25
"20200728","1783","9647","9600",富邦-新竹,0,12,12,-1,2.44
"20200728","1783","0039003600320044","9600",富邦-新莊,12,0,12,1,2.44
"20200728","1783","0039003600310052","9600",富邦-南員林,0,10,10,-1,2.03
"20200728","1783","9239","9200",凱基-市政,10,0,10,1,2.03
"20200728","1783","9898","9800",元大-新莊,1,10,9,-1,1.83
"20200728","1783","1520","1520",瑞士信貸,9,0,9,1,1.83
"20200728","1783","003900410039004a","9A00",永豐金-板新,0,8,8,-1,1.63
"20200728","1783","0036003300380041","6380",光和-嘉義,6,0,6,1,1.22
"20200728","1783","9285","9200",凱基-中壢,1,8,7,-1,1.42
"20200728","1783","9229","9200",凱基-中山,6,0,6,1,1.22
"20200728","1783","0035003300380042","5380",第一金-新竹,1,7,6,-1,1.22
"20200728","1783","9604","9600",富邦-陽明,7,1,6,1,1.22
"20200728","1783","0035003800350052","5850",統一-汐止,0,5,5,-1,1.02
"20200728","1783","5921","5920",元富-高雄,5,0,5,1,1.02
"20200728","1783","0035003900320072","5920",元富-城東,1,6,5,-1,1.02
"20200728","1783","9134","9100",群益金鼎-開元,4,0,4,1,0.81
"20200728","1783","6163","6160",中國信託-永康,0,5,5,-1,1.02
"20200728","1783","1470","1470",台灣摩根士丹利,4,0,4,1,0.81
"20200728","1783","003900310038004d","9100",群益金鼎-嘉義,0,5,5,-1,1.02
"20200728","1783","9800","9800",元大證券,4,0,4,1,0.81
"20200728","1783","9324","9300",華南永昌-岡山,2,7,5,-1,1.02
"20200728","1783","6463","6460",大昌-新竹,3,0,3,1,0.61
"20200728","1783","9888","9800",元大-鑫永和,0,5,5,-1,1.02
"20200728","1783","9302","9300",華南永昌-台中,3,0,3,1,0.61
"20200728","1783","0039003800390050","9800",元大-敦南,11,16,5,-1,1.02
"20200729","1783","1520","1520",瑞士信貸,64,3,61,1,10.17
"20200729","1783","9817","9800",元大-東泰,0,16,16,-1,2.67
"20200729","1783","8440","8440",摩根大通,52,15,37,1,6.17
"20200729","1783","9623","9600",富邦-台北,0,12,12,-1,2.00
"20200729","1783","1560","1560",港商野村,24,2,22,1,3.67
"20200729","1783","0037003700390050","7790",國票-九鼎,1,12,11,-1,1.83
"20200729","1783","9217","9200",凱基-松山,20,1,19,1,3.17
"20200729","1783","6910","6910",德信,0,10,10,-1,1.67
"20200729","1783","5267","5260",美好-基隆,12,0,12,1,2.00
"20200729","1783","0038003400350045","8450",康和-澎湖,0,10,10,-1,1.67
"20200729","1783","9894","9800",元大-桃興,17,6,11,1,1.83
"20200729","1783","0039003200300047","9200",凱基-彰化,0,10,10,-1,1.67
"20200729","1783","0039003600320047","9600",富邦-斗六,10,0,10,1,1.67
"20200729","1783","9239","9200",凱基-市政,0,10,10,-1,1.67
"20200729","1783","003500390032006c","5920",元富-大裕,5,0,5,1,0.83
"20200729","1783","5386","5380",第一金-彰化,7,14,7,-1,1.17
"20200729","1783","8560","8560",新光,5,0,5,1,0.83
"20200729","1783","9800","9800",元大證券,0,7,7,-1,1.17
"20200729","1783","9322","9300",華南永昌-公誠,5,0,5,1,0.83
"20200729","1783","003500330038006a","5380",第一金-安和,0,6,6,-1,1.00
"20200729","1783","2187","2180",亞東-台中,4,0,4,1,0.67
"20200729","1783","9206","9200",凱基-高雄,0,6,6,-1,1.00
"20200729","1783","5660","5660",日進,4,0,4,1,0.67
"20200729","1783","9898","9800",元大-新莊,1,7,6,-1,1.00
"20200729","1783","0035003900320041","5920",元富-緯城,4,0,4,1,0.67
"20200729","1783","5323","5320",高橋-內壢,3,8,5,-1,0.83
"20200729","1783","0035003900320062","5920",元富-板橋,3,0,3,1,0.50
"20200729","1783","0035003900320061","5920",元富-松德,1,6,5,-1,0.83
"20200730","1783","8440","8440",摩根大通,19,4,15,1,5.66
"20200730","1783","0035003300380044","5380",第一金-忠孝,0,15,15,-1,5.66
"20200730","1783","0039004100390038","9A00",永豐金-大園,10,0,10,1,3.77
"20200730","1783","0039003200300046","9200",凱基-站前,0,12,12,-1,4.53
"20200730","1783","8888","8880",國泰-敦南,10,1,9,1,3.40
"20200730","1783","8560","8560",新光,1,12,11,-1,4.15
"20200730","1783","2187","2180",亞東-台中,6,0,6,1,2.26
"20200730","1783","5921","5920",元富-高雄,0,10,10,-1,3.77
"20200730","1783","003500380035004a","5850",統一-三重,6,0,6,1,2.26
"20200730","1783","9894","9800",元大-桃興,0,10,10,-1,3.77
"20200730","1783","9322","9300",華南永昌-公誠,6,0,6,1,2.26
"20200730","1783","0039003800390050","9800",元大-敦南,1,7,6,-1,2.26
"20200730","1783","0035003800350052","5850",統一-汐止,5,0,5,1,1.89
"20200730","1783","1034","1030",土銀-嘉義,0,5,5,-1,1.89
"20200730","1783","0039003200300043","9200",凱基-雙和,5,0,5,1,1.89
"20200730","1783","9283","9200",凱基-北門,0,5,5,-1,1.89
"20200730","1783","9257","9200",凱基-林口,5,0,5,1,1.89
"20200730","1783","003900380033005a","9800",元大-鳳山,0,5,5,-1,1.89
"20200730","1783","1043","1040",臺銀-民權,4,0,4,1,1.51
"20200730","1783","003900380039004e","9800",元大-內湖,0,5,5,-1,1.89
"20200730","1783","1520","1520",瑞士信貸,5,1,4,1,1.51
"20200730","1783","0039003600320048","9600",富邦-鳳山,0,3,3,-1,1.13
"20200730","1783","5856","5850",統一-台中,4,0,4,1,1.51
"20200730","1783","9636","9600",富邦-中壢,0,3,3,-1,1.13
"20200730","1783","8150","8150",台新證券,4,0,4,1,1.51
"20200730","1783","5385","5380",第一金-桃園,0,2,2,-1,0.75
"20200730","1783","5386","5380",第一金-彰化,4,1,3,1,1.13
"20200730","1783","1590","1590",花旗環球,0,2,2,-1,0.75
"20200731","1783","8440","8440",摩根大通,28,0,28,1,6.14
"20200731","1783","9898","9800",元大-新莊,10,22,12,-1,2.63
"20200731","1783","0039003100380078","9100",群益金鼎-延平,30,10,20,1,4.39
"20200731","1783","0039003100380047","9100",群益金鼎-新莊,0,11,11,-1,2.41
"20200731","1783","0039003800390067","9800",元大-嘉義,18,0,18,1,3.95
"20200731","1783","0039003200300046","9200",凱基-站前,0,11,11,-1,2.41
"20200731","1783","0039003800320041","9800",元大-羅東,15,0,15,1,3.29
"20200731","1783","5856","5850",統一-台中,0,10,10,-1,2.19
"20200731","1783","9266","9200",凱基-新豐,12,0,12,1,2.63
"20200731","1783","0039003600310048","9600",富邦-新板,0,10,10,-1,2.19
"20200731","1783","9274","9200",凱基-鳳山,10,0,10,1,2.19
"20200731","1783","1560","1560",港商野村,6,15,9,-1,1.97
"20200731","1783","9291","9200",凱基-大安,9,0,9,1,1.97
"20200731","1783","8560","8560",新光,1,10,9,-1,1.97
"20200731","1783","7008","7000",兆豐-三重,10,3,7,1,1.54
"20200731","1783","1520","1520",瑞士信貸,0,6,6,-1,1.32
"20200731","1783","0038003100350041","8150",台新-高雄,7,0,7,1,1.54
"20200731","1783","0035003900320045","5920",元富-城中,18,24,6,-1,1.32
"20200731","1783","5386","5380",第一金-彰化,12,7,5,1,1.10
"20200731","1783","9308","9300",華南永昌-麻豆,0,6,6,-1,1.32
"20200731","1783","0039003100380043","9100",群益金鼎-古亭,5,0,5,1,1.10
"20200731","1783","0039003800310047","9800",元大-彰化,0,6,6,-1,1.32
"20200731","1783","9226","9200",凱基-汐止,5,0,5,1,1.10
"20200731","1783","0035003800350052","5850",統一-汐止,0,5,5,-1,1.10
"20200731","1783","0039003800310067","9800",元大-大里,5,0,5,1,1.10
"20200731","1783","003500390032006c","5920",元富-大裕,0,5,5,-1,1.10
"20200731","1783","003900380039006b","9800",元大-古亭,5,0,5,1,1.10
"20200731","1783","9623","9600",富邦-台北,0,5,5,-1,1.10
"20200601","1783","0039003800310079","9800",元大-善化,18,0,18,1,3.44
"20200601","1783","7798","7790",國票-內壢,0,43,43,-1,8.21
"20200601","1783","8440","8440",摩根大通,18,2,16,1,3.05
"20200601","1783","0035003800350052","5850",統一-汐止,0,20,20,-1,3.82
"20200601","1783","8560","8560",新光,16,0,16,1,3.05
"20200601","1783","003900320030004d","9200",凱基-宜蘭,0,20,20,-1,3.82
"20200601","1783","0039003600320043","9600",富邦-東門,15,0,15,1,2.86
"20200601","1783","9349","9300",華南永昌-板橋,0,15,15,-1,2.86
"20200601","1783","003900380031006d","9800",元大-前金,13,0,13,1,2.48
"20200601","1783","9205","9200",凱基-三重,0,12,12,-1,2.29
"20200601","1783","0037003000330042","7030",致和-崇德,10,0,10,1,1.91
"20200601","1783","0039003800310045","9800",元大-發財,0,11,11,-1,2.10
"20200601","1783","9352","9300",華南永昌-桃園,10,0,10,1,1.91
"20200601","1783","0037003000300049","7000",兆豐-北高雄,0,10,10,-1,1.91
"20200601","1783","0039004100390061","9A00",永豐金-苓雅,10,0,10,1,1.91
"20200601","1783","0037003700390075","7790",國票-長城,0,10,10,-1,1.91
"20200601","1783","003500330038006a","5380",第一金-安和,9,1,8,1,1.53
"20200601","1783","003900380039006a","9800",元大-樹林,0,10,10,-1,1.91
"20200601","1783","0035003800350042","5850",統一-永和,8,0,8,1,1.53
"20200601","1783","0039004100390045","9A00",永豐金-板橋,0,10,10,-1,1.91
"20200601","1783","9252","9200",凱基-嘉義,10,2,8,1,1.53
"20200601","1783","1440","1440",美林,16,24,8,-1,1.53
"20200601","1783","9634","9600",富邦-羅東,8,0,8,1,1.53
"20200601","1783","0039003100380075","9100",群益金鼎-瑞豐,0,8,8,-1,1.53
"20200601","1783","0037003700390063","7790",國票-敦北法人,7,0,7,1,1.34
"20200601","1783","003900360031004c","9600",富邦-士林,0,8,8,-1,1.53
"20200601","1783","0039003600310048","9600",富邦-新板,7,0,7,1,1.34
"20200601","1783","9814","9800",元大-大益,0,8,8,-1,1.53
"20200602","1783","6167","6160",中國信託-松江,30,0,30,1,7.25
"20200602","1783","9349","9300",華南永昌-板橋,0,20,20,-1,4.83
"20200602","1783","9268","9200",凱基-台北,36,10,26,1,6.28
"20200602","1783","8440","8440",摩根大通,13,31,18,-1,4.35
"20200602","1783","0039003600320056","9600",富邦-復興,23,0,23,1,5.56
"20200602","1783","0039003800320046","9800",元大-忠孝鼎富,0,15,15,-1,3.62
"20200602","1783","0035003300380044","5380",第一金-忠孝,20,0,20,1,4.83
"20200602","1783","003500320036004c","5260",美好-長榮(停),0,10,10,-1,2.42
"20200602","1783","1440","1440",美林,33,18,15,1,3.62
"20200602","1783","8887","8880",國泰-忠孝,0,10,10,-1,2.42
"20200602","1783","1520","1520",瑞士信貸,23,8,15,1,3.62
"20200602","1783","0038003800380041","8880",國泰-館前,0,10,10,-1,2.42
"20200602","1783","9352","9300",華南永昌-桃園,13,0,13,1,3.14
"20200602","1783","0039003100380075","9100",群益金鼎-瑞豐,0,10,10,-1,2.42
"20200602","1783","6161","6160",中國信託-三重,10,1,9,1,2.17
"20200602","1783","9224","9200",凱基-新莊,0,10,10,-1,2.42
"20200602","1783","5323","5320",高橋-內壢,5,0,5,1,1.21
"20200602","1783","003900380031004b","9800",元大-林園,1,11,10,-1,2.42
"20200602","1783","5853","5850",統一-中壢,5,0,5,1,1.21
"20200602","1783","1470","1470",台灣摩根士丹利,6,15,9,-1,2.17
"20200602","1783","003500390032006f","5920",元富-新興,5,0,5,1,1.21
"20200602","1783","9894","9800",元大-桃興,0,7,7,-1,1.69
"20200602","1783","9636","9600",富邦-中壢,5,0,5,1,1.21
"20200602","1783","7790","7790",國票證券,0,6,6,-1,1.45
"20200602","1783","0035003800350042","5850",統一-永和,4,0,4,1,0.97
"20200602","1783","7798","7790",國票-內壢,0,6,6,-1,1.45
"20200602","1783","7791","7790",國票-台東,4,0,4,1,0.97
"20200602","1783","0031003000320045","1020",合庫-桃園,0,5,5,-1,1.21
"20200603","1783","9268","9200",凱基-台北,44,4,40,1,14.18
"20200603","1783","6165","6160",中國信託-新竹,0,15,15,-1,5.32
"20200603","1783","9359","9300",華南永昌-中正,20,0,20,1,7.09
"20200603","1783","003900380031004b","9800",元大-林園,0,10,10,-1,3.55
"20200603","1783","1650","1650",新加坡商瑞銀,12,0,12,1,4.26
"20200603","1783","0035003900320044","5920",元富-大昌,0,9,9,-1,3.19
"20200603","1783","0039004100390038","9A00",永豐金-大園,8,0,8,1,2.84
"20200603","1783","8380","8380",安泰,5,14,9,-1,3.19
"20200603","1783","0039003600320056","9600",富邦-復興,7,0,7,1,2.48
"20200603","1783","9634","9600",富邦-羅東,0,8,8,-1,2.84
"20200603","1783","1470","1470",台灣摩根士丹利,6,0,6,1,2.13
"20200603","1783","0039003800390050","9800",元大-敦南,0,6,6,-1,2.13
"20200603","1783","6464","6460",大昌-新店,5,0,5,1,1.77
"20200603","1783","5323","5320",高橋-內壢,0,5,5,-1,1.77
"20200603","1783","9303","9300",華南永昌-高雄,5,0,5,1,1.77
"20200603","1783","5660","5660",日進,0,5,5,-1,1.77
"20200603","1783","0039003600310048","9600",富邦-新板,5,0,5,1,1.77
"20200603","1783","9322","9300",華南永昌-公誠,0,5,5,-1,1.77
"20200603","1783","0039003800330069","9800",元大-大雅,5,0,5,1,1.77
"20200603","1783","9825","9800",元大-新營,0,5,5,-1,1.77
"20200603","1783","0039004100390061","9A00",永豐金-苓雅,5,0,5,1,1.77
"20200603","1783","9884","9800",元大-斗信,0,5,5,-1,1.77
"20200603","1783","9189","9100",群益金鼎-桃園,4,0,4,1,1.42
"20200603","1783","003500330038004e","5380",第一金-豐原,0,4,4,-1,1.42
"20200603","1783","5460","5460",寶盛,3,0,3,1,1.06
"20200603","1783","9362","9300",華南永昌-苗栗,0,4,4,-1,1.42
"20200603","1783","5853","5850",統一-中壢,3,0,3,1,1.06
"20200603","1783","003900380039004e","9800",元大-內湖,0,4,4,-1,1.42
"20200604","1783","5858","5850",統一-嘉義,190,0,190,1,13.05
"20200604","1783","0039003800300044","9800",元大-北府,0,50,50,-1,3.43
"20200604","1783","003900380039006a","9800",元大-樹林,100,2,98,1,6.73
"20200604","1783","9636","9600",富邦-中壢,0,22,22,-1,1.51
"20200604","1783","0035003800350055","5850",統一-南京,70,0,70,1,4.81
"20200604","1783","9377","9300",華南永昌-虎尾,1,22,21,-1,1.44
"20200604","1783","9252","9200",凱基-嘉義,80,10,70,1,4.81
"20200604","1783","9105","9100",群益金鼎-高盛,0,20,20,-1,1.37
"20200604","1783","0035003900320055","5920",元富-宜蘭,60,0,60,1,4.12
"20200604","1783","9237","9200",凱基-敦北,10,30,20,-1,1.37
"20200604","1783","9207","9200",凱基-永和,50,0,50,1,3.43
"20200604","1783","9892","9800",元大-屏東,0,20,20,-1,1.37
"20200604","1783","0035003300380057","5380",第一金-華江,33,0,33,1,2.27
"20200604","1783","7790","7790",國票證券,1,20,19,-1,1.30
"20200604","1783","003900380031004e","9800",元大-金門,30,0,30,1,2.06
"20200604","1783","0035003800350052","5850",統一-汐止,0,16,16,-1,1.10
"20200604","1783","0039004100390043","9A00",永豐金-員林,24,0,24,1,1.65
"20200604","1783","0039003800390059","9800",元大-基隆,0,16,16,-1,1.10
"20200604","1783","9183","9100",群益金鼎-高雄,23,0,23,1,1.58
"20200604","1783","0039003200300057","9200",凱基-大里,0,15,15,-1,1.03
"20200604","1783","1020","1020",合庫證券,20,0,20,1,1.37
"20200604","1783","9317","9300",華南永昌-林口,0,15,15,-1,1.03
"20200604","1783","0039004100390051","9A00",永豐金-豐原,20,0,20,1,1.37
"20200604","1783","9874","9800",元大-雙和,0,15,15,-1,1.03
"20200604","1783","9218","9200",凱基-大直,14,0,14,1,0.96
"20200604","1783","1028","1020",合庫-彰化,0,14,14,-1,0.96
"20200604","1783","8560","8560",新光,12,0,12,1,0.82
"20200604","1783","003600310036004b","6160",中國信託-高雄,0,12,12,-1,0.82
"20200605","1783","9105","9100",群益金鼎-高盛,51,5,46,1,0.75
"20200605","1783","5858","5850",統一-嘉義,12,190,178,-1,2.92
"20200605","1783","0035003800350062","5850",統一-內湖,42,0,42,1,0.69
"20200605","1783","8440","8440",摩根大通,25,179,154,-1,2.52
"20200605","1783","9206","9200",凱基-高雄,55,16,39,1,0.64
"20200605","1783","003900380039006a","9800",元大-樹林,3,100,97,-1,1.59
"20200605","1783","5385","5380",第一金-桃園,37,3,34,1,0.56
"20200605","1783","003900360032004a","9600",富邦-三峽,0,75,75,-1,1.23
"20200605","1783","9202","9200",凱基-中港,40,6,34,1,0.56
"20200605","1783","9252","9200",凱基-嘉義,8,82,74,-1,1.21
"20200605","1783","003700300030005a","7000",兆豐-高雄,32,1,31,1,0.51
"20200605","1783","9268","9200",凱基-台北,43,114,71,-1,1.16
"20200605","1783","7795","7790",國票-南港,31,0,31,1,0.51
"20200605","1783","0035003800350055","5850",統一-南京,0,70,70,-1,1.15
"20200605","1783","9208","9200",凱基-桃園,43,12,31,1,0.51
"20200605","1783","0039004100390051","9A00",永豐金-豐原,1,70,69,-1,1.13
"20200605","1783","0039003600320042","9600",富邦-二林,32,1,31,1,0.51
"20200605","1783","0035003900320055","5920",元富-宜蘭,0,62,62,-1,1.02
"20200605","1783","1031","1030",土銀-台中,32,2,30,1,0.49
"20200605","1783","9207","9200",凱基-永和,1,54,53,-1,0.87
"20200605","1783","0035003900320059","5920",元富-埔里,30,0,30,1,0.49
"20200605","1783","6382","6380",光和-田中,0,50,50,-1,0.82
"20200605","1783","9227","9200",凱基-城中,38,8,30,1,0.49
"20200605","1783","5263","5260",美好-泰山,4,48,44,-1,0.72
"20200605","1783","003900380039004c","9800",元大-成功,29,1,28,1,0.46
"20200605","1783","0039003800310047","9800",元大-彰化,1,43,42,-1,0.69
"20200605","1783","9205","9200",凱基-三重,28,2,26,1,0.43
"20200605","1783","0039003200300057","9200",凱基-大里,0,37,37,-1,0.61
"20200608","1783","8382","8380",安泰-楠梓,36,0,36,1,2.35
"20200608","1783","9202","9200",凱基-中港,0,36,36,-1,2.35
"20200608","1783","0039003800300077","9800",元大-西屯,34,1,33,1,2.15
"20200608","1783","9206","9200",凱基-高雄,0,31,31,-1,2.02
"20200608","1783","0038003800340048","8840",玉山-新竹,27,0,27,1,1.76
"20200608","1783","1031","1030",土銀-台中,0,30,30,-1,1.96
"20200608","1783","0039004100390069","9A00",永豐金-新店,23,0,23,1,1.50
"20200608","1783","0035003900320059","5920",元富-埔里,0,30,30,-1,1.96
"20200608","1783","2184","2180",亞東-新竹,23,0,23,1,1.50
"20200608","1783","8440","8440",摩根大通,17,45,28,-1,1.83
"20200608","1783","9268","9200",凱基-台北,43,22,21,1,1.37
"20200608","1783","003900380039004c","9800",元大-成功,0,28,28,-1,1.83
"20200608","1783","1440","1440",美林,60,42,18,1,1.17
"20200608","1783","0039003800300043","9800",元大-斗六,1,20,19,-1,1.24
"20200608","1783","6161","6160",中國信託-三重,21,3,18,1,1.17
"20200608","1783","0039003600320048","9600",富邦-鳳山,2,20,18,-1,1.17
"20200608","1783","5386","5380",第一金-彰化,18,2,16,1,1.04
"20200608","1783","0035003900320045","5920",元富-城中,1,16,15,-1,0.98
"20200608","1783","0035003900320043","5920",元富-潮州,15,0,15,1,0.98
"20200608","1783","8583","8580",聯邦-忠孝,0,15,15,-1,0.98
"20200608","1783","9252","9200",凱基-嘉義,15,1,14,1,0.91
"20200608","1783","9327","9300",華南永昌-斗六,0,15,15,-1,0.98
"20200608","1783","9317","9300",華南永昌-林口,14,0,14,1,0.91
"20200608","1783","003900380031006d","9800",元大-前金,0,15,15,-1,0.98
"20200608","1783","8150","8150",台新證券,15,2,13,1,0.85
"20200608","1783","0037003700390050","7790",國票-九鼎,0,13,13,-1,0.85
"20200608","1783","9217","9200",凱基-松山,13,0,13,1,0.85
"20200608","1783","9137","9100",群益金鼎-士林,0,13,13,-1,0.85
"20200609","1783","003500320036004c","5260",美好-長榮(停),20,0,20,1,3.49
"20200609","1783","9834","9800",元大-中壢,24,40,16,-1,2.79
"20200609","1783","003900380031006a","9800",元大-士林,20,0,20,1,3.49
"20200609","1783","1520","1520",瑞士信貸,9,23,14,-1,2.44
"20200609","1783","9274","9200",凱基-鳳山,15,0,15,1,2.62
"20200609","1783","0037003000300066","7000",兆豐-鹿港,0,13,13,-1,2.27
"20200609","1783","0039003800310069","9800",元大-西螺,15,0,15,1,2.62
"20200609","1783","8581","8580",聯邦-高雄,0,12,12,-1,2.09
"20200609","1783","1650","1650",新加坡商瑞銀,12,0,12,1,2.09
"20200609","1783","8710","8710",陽信,0,9,9,-1,1.57
"20200609","1783","9319","9300",華南永昌-鶯歌,12,1,11,1,1.92
"20200609","1783","9252","9200",凱基-嘉義,0,9,9,-1,1.57
"20200609","1783","5921","5920",元富-高雄,12,1,11,1,1.92
"20200609","1783","9366","9300",華南永昌-豐原,0,9,9,-1,1.57
"20200609","1783","0039003800330055","9800",元大-頭份,10,0,10,1,1.75
"20200609","1783","003900380036004b","9800",元大-基隆孝二,2,11,9,-1,1.57
"20200609","1783","003900380039006d","9800",元大-信義,10,0,10,1,1.75
"20200609","1783","5460","5460",寶盛,0,8,8,-1,1.40
"20200609","1783","003500320036004b","5260",美好-富順,8,0,8,1,1.40
"20200609","1783","003900380030004b","9800",元大-竹科,1,9,8,-1,1.40
"20200609","1783","0035003900320043","5920",元富-潮州,8,0,8,1,1.40
"20200609","1783","0039003800300064","9800",元大-沙鹿,0,7,7,-1,1.22
"20200609","1783","8560","8560",新光,13,5,8,1,1.40
"20200609","1783","0039003800310061","9800",元大-歸仁,5,12,7,-1,1.22
"20200609","1783","5320","5320",高橋,6,0,6,1,1.05
"20200609","1783","003700300030004b","7000",兆豐-新營,0,6,6,-1,1.05
"20200609","1783","0039003100380069","9100",群益金鼎-竹南,6,0,6,1,1.05
"20200609","1783","9651","9600",富邦-民生(停),6,12,6,-1,1.05
"20200610","1783","003500390032006c","5920",元富-大裕,44,5,39,1,2.73
"20200610","1783","9227","9200",凱基-城中,0,33,33,-1,2.31
"20200610","1783","0035003900320058","5920",元富-草屯,30,0,30,1,2.10
"20200610","1783","8560","8560",新光,8,38,30,-1,2.10
"20200610","1783","1560","1560",港商野村,38,11,27,1,1.89
"20200610","1783","8440","8440",摩根大通,14,37,23,-1,1.61
"20200610","1783","9651","9600",富邦-民生(停),29,4,25,1,1.75
"20200610","1783","5858","5850",統一-嘉義,0,20,20,-1,1.40
"20200610","1783","1520","1520",瑞士信貸,39,15,24,1,1.68
"20200610","1783","0039003800330047","9800",元大-上新莊,1,21,20,-1,1.40
"20200610","1783","1440","1440",美林,75,54,21,1,1.47
"20200610","1783","9229","9200",凱基-中山,0,16,16,-1,1.12
"20200610","1783","0036003000310064","6010",(牛牛牛)亞-鑫豐,26,5,21,1,1.47
"20200610","1783","2184","2180",亞東-新竹,0,15,15,-1,1.05
"20200610","1783","9894","9800",元大-桃興,23,2,21,1,1.47
"20200610","1783","9624","9600",富邦-竹北,0,14,14,-1,0.98
"20200610","1783","9268","9200",凱基-台北,35,15,20,1,1.40
"20200610","1783","5323","5320",高橋-內壢,4,17,13,-1,0.91
"20200610","1783","6381","6380",光和-溪湖,20,2,18,1,1.26
"20200610","1783","0039003200300047","9200",凱基-彰化,0,13,13,-1,0.91
"20200610","1783","9333","9300",華南永昌-長虹,21,3,18,1,1.26
"20200610","1783","0035003900320062","5920",元富-板橋,6,18,12,-1,0.84
"20200610","1783","9208","9200",凱基-桃園,23,6,17,1,1.19
"20200610","1783","9329","9300",華南永昌-朴子,0,12,12,-1,0.84
"20200610","1783","8150","8150",台新證券,14,1,13,1,0.91
"20200610","1783","5925","5920",元富-台中,1,12,11,-1,0.77
"20200610","1783","9636","9600",富邦-中壢,13,0,13,1,0.91
"20200610","1783","0036003100310041","6110",台中銀-豐原,0,11,11,-1,0.77
"20200611","1783","0039003200300046","9200",凱基-站前,25,1,24,1,2.63
"20200611","1783","0035003900320045","5920",元富-城中,0,45,45,-1,4.94
"20200611","1783","9651","9600",富邦-民生(停),24,3,21,1,2.31
"20200611","1783","9268","9200",凱基-台北,21,60,39,-1,4.28
"20200611","1783","9834","9800",元大-中壢,20,1,19,1,2.09
"20200611","1783","0036003300380041","6380",光和-嘉義,0,28,28,-1,3.07
"20200611","1783","003500390032006c","5920",元富-大裕,19,1,18,1,1.98
"20200611","1783","0039003600320045","9600",富邦-樹林,3,25,22,-1,2.41
"20200611","1783","9252","9200",凱基-嘉義,21,5,16,1,1.76
"20200611","1783","9894","9800",元大-桃興,0,22,22,-1,2.41
"20200611","1783","9835","9800",元大-員林中山,18,2,16,1,1.76
"20200611","1783","9333","9300",華南永昌-長虹,0,18,18,-1,1.98
"20200611","1783","0039003800310046","9800",元大-福營,16,1,15,1,1.65
"20200611","1783","9208","9200",凱基-桃園,5,22,17,-1,1.87
"20200611","1783","5323","5320",高橋-內壢,15,1,14,1,1.54
"20200611","1783","9672","9600",富邦-員林,5,22,17,-1,1.87
"20200611","1783","6464","6460",大昌-新店,13,0,13,1,1.43
"20200611","1783","1560","1560",港商野村,1,17,16,-1,1.76
"20200611","1783","9349","9300",華南永昌-板橋,12,0,12,1,1.32
"20200611","1783","9317","9300",華南永昌-林口,0,16,16,-1,1.76
"20200611","1783","0038003100350059","8150",台新-新營,11,0,11,1,1.21
"20200611","1783","5853","5850",統一-中壢,0,15,15,-1,1.65
"20200611","1783","003900380039004e","9800",元大-內湖,12,1,11,1,1.21
"20200611","1783","9815","9800",元大-大灣,2,17,15,-1,1.65
"20200611","1783","6480","6480",福邦證券,10,0,10,1,1.10
"20200611","1783","1520","1520",瑞士信貸,3,17,14,-1,1.54
"20200611","1783","9234","9200",凱基-竹北,10,0,10,1,1.10
"20200611","1783","9366","9300",華南永昌-豐原,0,13,13,-1,1.43
"20200612","1783","8560","8560",新光,37,16,21,1,3.73
"20200612","1783","0039004100390058","9A00",永豐金-竹科,0,21,21,-1,3.73
"20200612","1783","9300","9300",華南永昌,16,0,16,1,2.84
"20200612","1783","0036003000310064","6010",(牛牛牛)亞-鑫豐,0,19,19,-1,3.37
"20200612","1783","1028","1020",合庫-彰化,16,1,15,1,2.66
"20200612","1783","9315","9300",華南永昌-苑裡,0,16,16,-1,2.84
"20200612","1783","9604","9600",富邦-陽明,14,1,13,1,2.31
"20200612","1783","9234","9200",凱基-竹北,1,16,15,-1,2.66
"20200612","1783","0039003800310046","9800",元大-福營,13,0,13,1,2.31
"20200612","1783","8581","8580",聯邦-高雄,0,11,11,-1,1.95
"20200612","1783","9268","9200",凱基-台北,31,20,11,1,1.95
"20200612","1783","8459","8450",康和-嘉義,1,11,10,-1,1.78
"20200612","1783","9274","9200",凱基-鳳山,10,0,10,1,1.78
"20200612","1783","003900380031004b","9800",元大-林園,0,10,10,-1,1.78
"20200612","1783","003900380030004b","9800",元大-竹科,10,0,10,1,1.78
"20200612","1783","0039003800300077","9800",元大-西屯,1,10,9,-1,1.60
"20200612","1783","0039003800310047","9800",元大-彰化,10,0,10,1,1.78
"20200612","1783","0039004100370039","9A00",永豐金-埔里,0,8,8,-1,1.42
"20200612","1783","1021","1020",合庫-台中,9,0,9,1,1.60
"20200612","1783","003900310038004a","9100",群益金鼎-永和,0,7,7,-1,1.24
"20200612","1783","0039004100390055","9A00",永豐金-中正,10,1,9,1,1.60
"20200612","1783","9252","9200",凱基-嘉義,1,7,6,-1,1.07
"20200612","1783","8490","8490",京城,7,0,7,1,1.24
"20200612","1783","9303","9300",華南永昌-高雄,0,6,6,-1,1.07
"20200612","1783","9233","9200",凱基-長庚,6,0,6,1,1.07
"20200612","1783","9878","9800",元大-金華,1,7,6,-1,1.07
"20200612","1783","0039003800380042","9800",元大-桃園,6,0,6,1,1.07
"20200612","1783","003700300030005a","7000",兆豐-高雄,0,5,5,-1,0.89
"20200615","1783","8440","8440",摩根大通,140,5,135,1,4.13
"20200615","1783","003900360032004a","9600",富邦-三峽,2,53,51,-1,1.56
"20200615","1783","8150","8150",台新證券,129,9,120,1,3.67
"20200615","1783","6464","6460",大昌-新店,4,41,37,-1,1.13
"20200615","1783","1520","1520",瑞士信貸,109,19,90,1,2.75
"20200615","1783","0031003100310047","1110",台灣企銀-埔墘,0,30,30,-1,0.92
"20200615","1783","9268","9200",凱基-台北,123,62,61,1,1.87
"20200615","1783","0035003800350052","5850",統一-汐止,0,27,27,-1,0.83
"20200615","1783","0039003800390043","9800",元大-板橋,50,1,49,1,1.50
"20200615","1783","9137","9100",群益金鼎-士林,0,27,27,-1,0.83
"20200615","1783","9266","9200",凱基-新豐,42,2,40,1,1.22
"20200615","1783","0035003900320043","5920",元富-潮州,0,25,25,-1,0.76
"20200615","1783","9307","9300",華南永昌-大安,103,63,40,1,1.22
"20200615","1783","9302","9300",華南永昌-台中,1,26,25,-1,0.76
"20200615","1783","9801","9800",元大-城東,42,2,40,1,1.22
"20200615","1783","9252","9200",凱基-嘉義,7,31,24,-1,0.73
"20200615","1783","1440","1440",美林,174,139,35,1,1.07
"20200615","1783","003500390032006c","5920",元富-大裕,5,28,23,-1,0.70
"20200615","1783","0039003600320044","9600",富邦-新莊,34,2,32,1,0.98
"20200615","1783","9322","9300",華南永昌-公誠,12,35,23,-1,0.70
"20200615","1783","003900380039004a","9800",元大-彰化民生,25,0,25,1,0.76
"20200615","1783","1021","1020",合庫-台中,10,32,22,-1,0.67
"20200615","1783","0039003600310050","9600",富邦-和美,26,3,23,1,0.70
"20200615","1783","9852","9800",元大-永春,6,28,22,-1,0.67
"20200615","1783","5385","5380",第一金-桃園,20,0,20,1,0.61
"20200615","1783","6461","6460",大昌-樹林,0,20,20,-1,0.61
"20200615","1783","0039003200300057","9200",凱基-大里,20,0,20,1,0.61
"20200615","1783","0037003700390063","7790",國票-敦北法人,0,20,20,-1,0.61
"20200616","1783","0039003800390050","9800",元大-敦南,45,1,44,1,2.82
"20200616","1783","8440","8440",摩根大通,13,66,53,-1,3.39
"20200616","1783","0039003600320045","9600",富邦-樹林,37,0,37,1,2.37
"20200616","1783","0039003800390043","9800",元大-板橋,1,50,49,-1,3.13
"20200616","1783","003500390032006c","5920",元富-大裕,33,1,32,1,2.05
"20200616","1783","9307","9300",華南永昌-大安,1,40,39,-1,2.50
"20200616","1783","9875","9800",元大-土城永寧,32,1,31,1,1.98
"20200616","1783","0039003800300044","9800",元大-北府,4,38,34,-1,2.18
"20200616","1783","0039003600350055","9600",富邦-彰化,27,0,27,1,1.73
"20200616","1783","0039003800310051","9800",元大-太平,0,30,30,-1,1.92
"20200616","1783","9872","9800",元大-復北,21,0,21,1,1.34
"20200616","1783","1520","1520",瑞士信貸,7,35,28,-1,1.79
"20200616","1783","5600","5600",永興,20,0,20,1,1.28
"20200616","1783","9837","9800",元大-北港,2,26,24,-1,1.54
"20200616","1783","0038003100350048","8150",台新-屏東,19,0,19,1,1.22
"20200616","1783","9278","9200",凱基-永康,0,20,20,-1,1.28
"20200616","1783","0039003200300057","9200",凱基-大里,19,0,19,1,1.22
"20200616","1783","0039003600320050","9600",富邦-頭份,1,19,18,-1,1.15
"20200616","1783","0039003200300046","9200",凱基-站前,17,1,16,1,1.02
"20200616","1783","0039003100380065","9100",群益金鼎-大安,3,20,17,-1,1.09
"20200616","1783","003900360031004d","9600",富邦-木柵,15,0,15,1,0.96
"20200616","1783","0039003800310046","9800",元大-福營,0,15,15,-1,0.96
"20200616","1783","5856","5850",統一-台中,14,0,14,1,0.90
"20200616","1783","1028","1020",合庫-彰化,0,14,14,-1,0.90
"20200616","1783","0035003900320044","5920",元富-大昌,16,2,14,1,0.90
"20200616","1783","0039003600320044","9600",富邦-新莊,0,14,14,-1,0.90
"20200616","1783","9266","9200",凱基-新豐,12,0,12,1,0.77
"20200616","1783","9852","9800",元大-永春,0,14,14,-1,0.90
"20200617","1783","9283","9200",凱基-北門,1037,665,372,1,5.08
"20200617","1783","0037003000300056","7000",兆豐-新竹,0,250,250,-1,3.41
"20200617","1783","9692","9600",富邦-嘉義,296,33,263,1,3.59
"20200617","1783","0039003600320043","9600",富邦-東門,1,138,137,-1,1.87
"20200617","1783","003900380030004b","9800",元大-竹科,150,2,148,1,2.02
"20200617","1783","003900360032004a","9600",富邦-三峽,0,123,123,-1,1.68
"20200617","1783","9287","9200",凱基-內湖,104,1,103,1,1.41
"20200617","1783","9349","9300",華南永昌-板橋,0,110,110,-1,1.50
"20200617","1783","5850","5850",統一,98,4,94,1,1.28
"20200617","1783","0039003100380046","9100",群益金鼎-新店,2,102,100,-1,1.37
"20200617","1783","003700370039005a","7790",國票-安和,80,0,80,1,1.09
"20200617","1783","0039003600320056","9600",富邦-復興,0,96,96,-1,1.31
"20200617","1783","003700370039004a","7790",國票-北高雄,85,13,72,1,0.98
"20200617","1783","5853","5850",統一-中壢,0,95,95,-1,1.30
"20200617","1783","003900310038004a","9100",群益金鼎-永和,84,14,70,1,0.96
"20200617","1783","1520","1520",瑞士信貸,24,109,85,-1,1.16
"20200617","1783","0035003300380057","5380",第一金-華江,71,2,69,1,0.94
"20200617","1783","9352","9300",華南永昌-桃園,0,57,57,-1,0.78
"20200617","1783","9206","9200",凱基-高雄,80,11,69,1,0.94
"20200617","1783","9184","9100",群益金鼎-台中,0,52,52,-1,0.71
"20200617","1783","9816","9800",元大-新竹,69,0,69,1,0.94
"20200617","1783","9208","9200",凱基-桃園,6,56,50,-1,0.68
"20200617","1783","5926","5920",元富-四維(停),64,0,64,1,0.87
"20200617","1783","003800380038004b","8880",國泰-板橋,0,46,46,-1,0.63
"20200617","1783","9853","9800",元大-南屯,91,27,64,1,0.87
"20200617","1783","0039003200300046","9200",凱基-站前,2,46,44,-1,0.60
"20200617","1783","9697","9600",富邦-虎尾,104,41,63,1,0.86
"20200617","1783","8882","8880",國泰-台中,8,50,42,-1,0.57
"20200618","1783","8150","8150",台新證券,189,64,125,1,0.94
"20200618","1783","9283","9200",凱基-北門,1,392,391,-1,2.93
"20200618","1783","5920","5920",元富,155,36,119,1,0.89
"20200618","1783","6167","6160",中國信託-松江,11,300,289,-1,2.16
"20200618","1783","9200","9200",凱基,90,2,88,1,0.66
"20200618","1783","9692","9600",富邦-嘉義,103,340,237,-1,1.77
"20200618","1783","003500390032007a","5920",元富-文心,88,1,87,1,0.65
"20200618","1783","9268","9200",凱基-台北,111,265,154,-1,1.15
"20200618","1783","0039003800300077","9800",元大-西屯,104,26,78,1,0.58
"20200618","1783","003900380030004b","9800",元大-竹科,27,171,144,-1,1.08
"20200618","1783","1520","1520",瑞士信貸,157,84,73,1,0.55
"20200618","1783","0035003900320048","5920",元富-信義,15,108,93,-1,0.70
"20200618","1783","8561","8560",新光-台中,133,61,72,1,0.54
"20200618","1783","9208","9200",凱基-桃園,53,144,91,-1,0.68
"20200618","1783","8560","8560",新光,262,194,68,1,0.51
"20200618","1783","9287","9200",凱基-內湖,28,104,76,-1,0.57
"20200618","1783","0039003800390043","9800",元大-板橋,84,18,66,1,0.49
"20200618","1783","003700370039005a","7790",國票-安和,8,81,73,-1,0.55
"20200618","1783","0038003100350042","8150",台新-台中,82,22,60,1,0.45
"20200618","1783","1440","1440",美林,491,563,72,-1,0.54
"20200618","1783","8490","8490",京城,60,0,60,1,0.45
"20200618","1783","9206","9200",凱基-高雄,13,85,72,-1,0.54
"20200618","1783","0035003900320079","5920",元富-花蓮,60,1,59,1,0.44
"20200618","1783","9697","9600",富邦-虎尾,4,76,72,-1,0.54
"20200618","1783","1031","1030",土銀-台中,49,0,49,1,0.37
"20200618","1783","003700370039004a","7790",國票-北高雄,14,84,70,-1,0.52
"20200618","1783","9659","9600",富邦-高雄,57,9,48,1,0.36
"20200618","1783","003900310038004a","9100",群益金鼎-永和,5,75,70,-1,0.52
"20200619","1783","003900380039006a","9800",元大-樹林,70,0,70,1,1.08
"20200619","1783","1520","1520",瑞士信貸,30,248,218,-1,3.35
"20200619","1783","0037003700390063","7790",國票-敦北法人,61,0,61,1,0.94
"20200619","1783","8150","8150",台新證券,28,183,155,-1,2.39
"20200619","1783","0039003600320046","9600",富邦-北桃園(停),62,1,61,1,0.94
"20200619","1783","5850","5850",統一,17,119,102,-1,1.57
"20200619","1783","6910","6910",德信,51,0,51,1,0.78
"20200619","1783","6464","6460",大昌-新店,17,119,102,-1,1.57
"20200619","1783","0039004100300030","9A00",永豐金證券,37,1,36,1,0.55
"20200619","1783","9326","9300",華南永昌-南京,1,83,82,-1,1.26
"20200619","1783","0039004100390055","9A00",永豐金-中正,38,3,35,1,0.54
"20200619","1783","6167","6160",中國信託-松江,0,80,80,-1,1.23
"20200619","1783","003500330038004d","5380",第一金-嘉義,58,27,31,1,0.48
"20200619","1783","8490","8490",京城,0,60,60,-1,0.92
"20200619","1783","8847","8840",玉山-台南,33,2,31,1,0.48
"20200619","1783","0039003800390061","9800",元大-苑裡,14,69,55,-1,0.85
"20200619","1783","9331","9300",華南永昌-鳳山,31,0,31,1,0.48
"20200619","1783","1440","1440",美林,209,261,52,-1,0.80
"20200619","1783","6465","6460",大昌-桃園,27,0,27,1,0.42
"20200619","1783","9659","9600",富邦-高雄,5,43,38,-1,0.58
"20200619","1783","0039003800310061","9800",元大-歸仁,30,3,27,1,0.42
"20200619","1783","9349","9300",華南永昌-板橋,0,34,34,-1,0.52
"20200619","1783","0039004100390038","9A00",永豐金-大園,29,2,27,1,0.42
"20200619","1783","0039003800300044","9800",元大-北府,9,42,33,-1,0.51
"20200619","1783","0038003400350045","8450",康和-澎湖,68,43,25,1,0.38
"20200619","1783","0039004100380046","9A00",永豐金-敦南,5,37,32,-1,0.49
"20200619","1783","6164","6160",中國信託-文心,31,7,24,1,0.37
"20200619","1783","0039003200310043","9200",凱基-民權,0,32,32,-1,0.49
"20200622","1783","1520","1520",瑞士信貸,87,17,70,1,2.24
"20200622","1783","8150","8150",台新證券,8,86,78,-1,2.50
"20200622","1783","003500390032007a","5920",元富-文心,59,2,57,1,1.83
"20200622","1783","0039003600320046","9600",富邦-北桃園(停),8,64,56,-1,1.79
"20200622","1783","0037003700390063","7790",國票-敦北法人,50,0,50,1,1.60
"20200622","1783","1031","1030",土銀-台中,0,47,47,-1,1.51
"20200622","1783","8881","8880",國泰-高雄,34,0,34,1,1.09
"20200622","1783","003900410039004c","9A00",永豐金-台中,0,42,42,-1,1.35
"20200622","1783","9283","9200",凱基-北門,33,0,33,1,1.06
"20200622","1783","0039003800300077","9800",元大-西屯,0,40,40,-1,1.28
"20200622","1783","6910","6910",德信,30,0,30,1,0.96
"20200622","1783","0039003600310050","9600",富邦-和美,3,32,29,-1,0.93
"20200622","1783","0039003200300057","9200",凱基-大里,32,6,26,1,0.83
"20200622","1783","0037003700390056","7790",國票-天祥,3,30,27,-1,0.87
"20200622","1783","9103","9100",群益金鼎-松山,25,0,25,1,0.80
"20200622","1783","5385","5380",第一金-桃園,0,22,22,-1,0.71
"20200622","1783","0039003600320058","9600",富邦-文化,23,0,23,1,0.74
"20200622","1783","003500330038004e","5380",第一金-豐原,0,19,19,-1,0.61
"20200622","1783","9676","9600",富邦-仁愛,39,16,23,1,0.74
"20200622","1783","8440","8440",摩根大通,24,43,19,-1,0.61
"20200622","1783","003800380034004a","8840",玉山-大里,24,2,22,1,0.71
"20200622","1783","003900380039006a","9800",元大-樹林,1,20,19,-1,0.61
"20200622","1783","6465","6460",大昌-桃園,21,1,20,1,0.64
"20200622","1783","6163","6160",中國信託-永康,0,18,18,-1,0.58
"20200622","1783","1440","1440",美林,181,162,19,1,0.61
"20200622","1783","0039003600390043","9600",富邦-北港,8,26,18,-1,0.58
"20200622","1783","9800","9800",元大證券,19,0,19,1,0.61
"20200622","1783","9871","9800",元大-忠孝,5,23,18,-1,0.58
"20200623","1783","7003","7000",兆豐-台中,32,1,31,1,0.84
"20200623","1783","0039003600320050","9600",富邦-頭份,2,64,62,-1,1.68
"20200623","1783","6620","6620",口袋證券,30,0,30,1,0.81
"20200623","1783","8560","8560",新光,13,56,43,-1,1.16
"20200623","1783","0037003700390063","7790",國票-敦北法人,31,1,30,1,0.81
"20200623","1783","8150","8150",台新證券,20,58,38,-1,1.03
"20200623","1783","5385","5380",第一金-桃園,31,4,27,1,0.73
"20200623","1783","8440","8440",摩根大通,10,44,34,-1,0.92
"20200623","1783","003500330038004d","5380",第一金-嘉義,28,1,27,1,0.73
"20200623","1783","8382","8380",安泰-楠梓,0,32,32,-1,0.87
"20200623","1783","0039003200300057","9200",凱基-大里,41,14,27,1,0.73
"20200623","1783","003900380031006a","9800",元大-士林,5,35,30,-1,0.81
"20200623","1783","9208","9200",凱基-桃園,27,6,21,1,0.57
"20200623","1783","9676","9600",富邦-仁愛,22,47,25,-1,0.68
"20200623","1783","003900380039006a","9800",元大-樹林,21,1,20,1,0.54
"20200623","1783","1650","1650",新加坡商瑞銀,0,23,23,-1,0.62
"20200623","1783","003900410039004c","9A00",永豐金-台中,21,1,20,1,0.54
"20200623","1783","0039003600360046","9600",富邦-左營,0,21,21,-1,0.57
"20200623","1783","0039003800300043","9800",元大-斗六,22,5,17,1,0.46
"20200623","1783","9654","9600",富邦-永和,1,20,19,-1,0.51
"20200623","1783","0039003800310045","9800",元大-發財,16,0,16,1,0.43
"20200623","1783","6460","6460",大昌,3,21,18,-1,0.49
"20200623","1783","003500390032006c","5920",元富-大裕,29,14,15,1,0.41
"20200623","1783","0035003300380042","5380",第一金-新竹,1,17,16,-1,0.43
"20200623","1783","9274","9200",凱基-鳳山,15,0,15,1,0.41
"20200623","1783","0039003600310048","9600",富邦-新板,5,21,16,-1,0.43
"20200623","1783","9278","9200",凱基-永康,15,0,15,1,0.41
"20200623","1783","1560","1560",港商野村,16,31,15,-1,0.41
"20200624","1783","9853","9800",元大-南屯,37,1,36,1,1.82
"20200624","1783","1520","1520",瑞士信貸,9,56,47,-1,2.37
"20200624","1783","0039003800300043","9800",元大-斗六,33,0,33,1,1.66
"20200624","1783","0039003800320046","9800",元大-忠孝鼎富,0,44,44,-1,2.22
"20200624","1783","6620","6620",口袋證券,30,0,30,1,1.51
"20200624","1783","1440","1440",美林,64,99,35,-1,1.77
"20200624","1783","6950","6950",福勝,21,0,21,1,1.06
"20200624","1783","003900380039006b","9800",元大-古亭,0,32,32,-1,1.61
"20200624","1783","0039004100300030","9A00",永豐金證券,20,0,20,1,1.01
"20200624","1783","9871","9800",元大-忠孝,0,31,31,-1,1.56
"20200624","1783","8560","8560",新光,50,32,18,1,0.91
"20200624","1783","5385","5380",第一金-桃園,0,30,30,-1,1.51
"20200624","1783","9217","9200",凱基-松山,18,0,18,1,0.91
"20200624","1783","003900380039006a","9800",元大-樹林,2,30,28,-1,1.41
"20200624","1783","003500390032006c","5920",元富-大裕,23,6,17,1,0.86
"20200624","1783","9692","9600",富邦-嘉義,4,29,25,-1,1.26
"20200624","1783","0035003900320058","5920",元富-草屯,16,0,16,1,0.81
"20200624","1783","0039003600320045","9600",富邦-樹林,0,20,20,-1,1.01
"20200624","1783","003900380033005a","9800",元大-鳳山,15,0,15,1,0.76
"20200624","1783","0039003600320046","9600",富邦-北桃園(停),1,21,20,-1,1.01
"20200624","1783","9275","9200",凱基-三多,15,1,14,1,0.71
"20200624","1783","1560","1560",港商野村,6,22,16,-1,0.81
"20200624","1783","9835","9800",元大-員林中山,15,1,14,1,0.71
"20200624","1783","9624","9600",富邦-竹北,0,16,16,-1,0.81
"20200624","1783","0039004100390055","9A00",永豐金-中正,14,0,14,1,0.71
"20200624","1783","9317","9300",華南永昌-林口,0,15,15,-1,0.76
"20200624","1783","9604","9600",富邦-陽明,17,4,13,1,0.66
"20200624","1783","003500330038004d","5380",第一金-嘉義,3,17,14,-1,0.71
"20200629","1783","9333","9300",華南永昌-長虹,48,16,32,1,1.72
"20200629","1783","0039003800300043","9800",元大-斗六,3,43,40,-1,2.15
"20200629","1783","0039003600320045","9600",富邦-樹林,21,0,21,1,1.13
"20200629","1783","9875","9800",元大-土城永寧,2,41,39,-1,2.09
"20200629","1783","0039004100390064","9A00",永豐金-古亭,22,1,21,1,1.13
"20200629","1783","9651","9600",富邦-民生(停),0,35,35,-1,1.88
"20200629","1783","003900410039004d","9A00",永豐金-南投,18,0,18,1,0.97
"20200629","1783","0039003800300077","9800",元大-西屯,3,34,31,-1,1.66
"20200629","1783","0039003800310041","9800",元大-鶯歌,17,0,17,1,0.91
"20200629","1783","0036003000310064","6010",(牛牛牛)亞-鑫豐,0,24,24,-1,1.29
"20200629","1783","003500330038004d","5380",第一金-嘉義,16,3,13,1,0.70
"20200629","1783","8440","8440",摩根大通,12,35,23,-1,1.23
"20200629","1783","003900380039006a","9800",元大-樹林,15,2,13,1,0.70
"20200629","1783","003900360031004d","9600",富邦-木柵,0,22,22,-1,1.18
"20200629","1783","003500390032005a","5920",元富-安南,14,2,12,1,0.64
"20200629","1783","003500390032006c","5920",元富-大裕,2,22,20,-1,1.07
"20200629","1783","9871","9800",元大-忠孝,22,10,12,1,0.64
"20200629","1783","1470","1470",台灣摩根士丹利,6,23,17,-1,0.91
"20200629","1783","0038003100350059","8150",台新-新營,12,1,11,1,0.59
"20200629","1783","9208","9200",凱基-桃園,3,20,17,-1,0.91
"20200629","1783","0039003200300046","9200",凱基-站前,11,0,11,1,0.59
"20200629","1783","9275","9200",凱基-三多,0,17,17,-1,0.91
"20200629","1783","0039003800390051","9800",元大-汐止,11,0,11,1,0.59
"20200629","1783","0039004100390055","9A00",永豐金-中正,2,18,16,-1,0.86
"20200629","1783","0031003100310045","1110",台灣企銀-桃園,10,0,10,1,0.54
"20200629","1783","9331","9300",華南永昌-鳳山,0,15,15,-1,0.80
"20200629","1783","1262","1260",宏遠-桃園,10,0,10,1,0.54
"20200629","1783","0039004100370039","9A00",永豐金-埔里,0,13,13,-1,0.70
"20200630","1783","9100","9100",群益金鼎,17,0,17,1,1.75
"20200630","1783","003500330038004d","5380",第一金-嘉義,2,38,36,-1,3.70
"20200630","1783","9835","9800",元大-員林中山,15,0,15,1,1.54
"20200630","1783","1520","1520",瑞士信貸,5,34,29,-1,2.98
"20200630","1783","0039004100300030","9A00",永豐金證券,15,0,15,1,1.54
"20200630","1783","9303","9300",華南永昌-高雄,1,30,29,-1,2.98
"20200630","1783","0038003400350045","8450",康和-澎湖,13,0,13,1,1.33
"20200630","1783","9604","9600",富邦-陽明,1,20,19,-1,1.95
"20200630","1783","9672","9600",富邦-員林,13,0,13,1,1.33
"20200630","1783","0037003700390072","7790",國票-桃園,0,12,12,-1,1.23
"20200630","1783","2184","2180",亞東-新竹,12,0,12,1,1.23
"20200630","1783","0039003800310067","9800",元大-大里,0,12,12,-1,1.23
"20200630","1783","9268","9200",凱基-台北,33,21,12,1,1.23
"20200630","1783","5921","5920",元富-高雄,0,10,10,-1,1.03
"20200630","1783","6910","6910",德信,10,0,10,1,1.03
"20200630","1783","6110","6110",台中銀,0,10,10,-1,1.03
"20200630","1783","9288","9200",凱基-埔墘,10,0,10,1,1.03
"20200630","1783","0038003400350041","8450",康和-內湖,0,10,10,-1,1.03
"20200630","1783","9347","9300",華南永昌-敦南,10,0,10,1,1.03
"20200630","1783","0039003100380041","9100",群益金鼎-中壢,0,10,10,-1,1.03
"20200630","1783","003900360031004e","9600",富邦-西壢,20,10,10,1,1.03
"20200630","1783","0039003200300048","9200",凱基-基隆,0,10,10,-1,1.03
"20200630","1783","9654","9600",富邦-永和,10,0,10,1,1.03
"20200630","1783","0039003600320045","9600",富邦-樹林,0,10,10,-1,1.03
"20200630","1783","0039003800390055","9800",元大-大甲,10,0,10,1,1.03
"20200630","1783","9661","9600",富邦-新店,0,10,10,-1,1.03
"20200630","1783","1560","1560",港商野村,14,5,9,1,0.92
"20200630","1783","0039003800390066","9800",元大-東港,0,10,10,-1,1.03
"20200504","1783","003900380033006a","9800",元大-仁愛,72,3,69,1,1.75
"20200504","1783","0039003800390067","9800",元大-嘉義,2,52,50,-1,1.27
"20200504","1783","1520","1520",瑞士信貸,52,0,52,1,1.32
"20200504","1783","1650","1650",新加坡商瑞銀,0,47,47,-1,1.20
"20200504","1783","9377","9300",華南永昌-虎尾,43,2,41,1,1.04
"20200504","1783","0037003000300048","7000",兆豐-東門,3,47,44,-1,1.12
"20200504","1783","9893","9800",元大-大天母,38,0,38,1,0.97
"20200504","1783","8843","8840",玉山-高雄,1,45,44,-1,1.12
"20200504","1783","9233","9200",凱基-長庚,41,4,37,1,0.94
"20200504","1783","0039003800340043","9800",元大-新店中正,0,43,43,-1,1.09
"20200504","1783","6451","6450",永全-南崁,36,0,36,1,0.92
"20200504","1783","0039003600320048","9600",富邦-鳳山,20,61,41,-1,1.04
"20200504","1783","9319","9300",華南永昌-鶯歌,39,7,32,1,0.81
"20200504","1783","0037003000300068","7000",兆豐-三民,1,37,36,-1,0.92
"20200504","1783","0035003900320076","5920",元富-桃園,39,10,29,1,0.74
"20200504","1783","9899","9800",元大-淡水,0,36,36,-1,0.92
"20200504","1783","8885","8880",國泰-桃園,27,0,27,1,0.69
"20200504","1783","9834","9800",元大-中壢,9,42,33,-1,0.84
"20200504","1783","9624","9600",富邦-竹北,22,0,22,1,0.56
"20200504","1783","9211","9200",凱基-台南,2,34,32,-1,0.81
"20200504","1783","0035003800350052","5850",統一-汐止,21,0,21,1,0.53
"20200504","1783","9657","9600",富邦-苗栗,0,30,30,-1,0.76
"20200504","1783","9817","9800",元大-東泰,23,2,21,1,0.53
"20200504","1783","8560","8560",新光,40,68,28,-1,0.71
"20200504","1783","0039003800330047","9800",元大-上新莊,21,0,21,1,0.53
"20200504","1783","9215","9200",凱基-高美館,10,38,28,-1,0.71
"20200504","1783","0039003200300047","9200",凱基-彰化,20,0,20,1,0.51
"20200504","1783","9352","9300",華南永昌-桃園,3,31,28,-1,0.71
"20200505","1783","003900360032004a","9600",富邦-三峽,50,1,49,1,1.98
"20200505","1783","0039004100390053","9A00",永豐金-南京,2,93,91,-1,3.67
"20200505","1783","003900380036004b","9800",元大-基隆孝二,38,1,37,1,1.49
"20200505","1783","8880","8880",國泰證券,0,86,86,-1,3.47
"20200505","1783","0039003200300057","9200",凱基-大里,41,5,36,1,1.45
"20200505","1783","0038003800340048","8840",玉山-新竹,0,78,78,-1,3.15
"20200505","1783","0039003800390059","9800",元大-基隆,39,3,36,1,1.45
"20200505","1783","0039003600310043","9600",富邦-南京,15,69,54,-1,2.18
"20200505","1783","9283","9200",凱基-北門,36,1,35,1,1.41
"20200505","1783","1520","1520",瑞士信貸,1,50,49,-1,1.98
"20200505","1783","1470","1470",台灣摩根士丹利,42,11,31,1,1.25
"20200505","1783","1440","1440",美林,24,64,40,-1,1.61
"20200505","1783","7798","7790",國票-內壢,21,0,21,1,0.85
"20200505","1783","0037003000300071","7000",兆豐-內湖,0,26,26,-1,1.05
"20200505","1783","6382","6380",光和-田中,20,0,20,1,0.81
"20200505","1783","0039003600310047","9600",富邦-成功,5,31,26,-1,1.05
"20200505","1783","0038003800380041","8880",國泰-館前,21,1,20,1,0.81
"20200505","1783","0037003700390063","7790",國票-敦北法人,0,26,26,-1,1.05
"20200505","1783","0039004100390058","9A00",永豐金-竹科,20,0,20,1,0.81
"20200505","1783","8150","8150",台新證券,30,54,24,-1,0.97
"20200505","1783","0039003600310052","9600",富邦-南員林,20,2,18,1,0.73
"20200505","1783","003900380033004b","9800",元大-學甲,0,21,21,-1,0.85
"20200505","1783","0039003600320043","9600",富邦-東門,17,0,17,1,0.69
"20200505","1783","9300","9300",華南永昌,18,38,20,-1,0.81
"20200505","1783","0037003000300043","7000",兆豐-來福,16,1,15,1,0.61
"20200505","1783","0039003800390047","9800",元大-大同,0,20,20,-1,0.81
"20200505","1783","0039003200300043","9200",凱基-雙和,15,0,15,1,0.61
"20200505","1783","0035003900320061","5920",元富-松德,0,18,18,-1,0.73
"20200506","1783","8440","8440",摩根大通,81,12,69,1,2.04
"20200506","1783","8880","8880",國泰證券,0,56,56,-1,1.65
"20200506","1783","0039003600320043","9600",富邦-東門,56,8,48,1,1.42
"20200506","1783","9266","9200",凱基-新豐,0,55,55,-1,1.62
"20200506","1783","6165","6160",中國信託-新竹,47,0,47,1,1.39
"20200506","1783","0035003900320072","5920",元富-城東,1,55,54,-1,1.59
"20200506","1783","9252","9200",凱基-嘉義,46,1,45,1,1.33
"20200506","1783","0035003900320076","5920",元富-桃園,5,48,43,-1,1.27
"20200506","1783","003900310033004e","9100",群益金鼎-土城,41,0,41,1,1.21
"20200506","1783","9206","9200",凱基-高雄,2,40,38,-1,1.12
"20200506","1783","003900360032004a","9600",富邦-三峽,40,0,40,1,1.18
"20200506","1783","6451","6450",永全-南崁,1,36,35,-1,1.03
"20200506","1783","0039003800390059","9800",元大-基隆,43,15,28,1,0.83
"20200506","1783","9215","9200",凱基-高美館,5,38,33,-1,0.97
"20200506","1783","1470","1470",台灣摩根士丹利,71,47,24,1,0.71
"20200506","1783","0035003900320044","5920",元富-大昌,10,37,27,-1,0.80
"20200506","1783","0039004100390062","9A00",永豐金-虎尾,28,5,23,1,0.68
"20200506","1783","5853","5850",統一-中壢,1,26,25,-1,0.74
"20200506","1783","0036003100310041","6110",台中銀-豐原,22,0,22,1,0.65
"20200506","1783","0035003300380057","5380",第一金-華江,3,27,24,-1,0.71
"20200506","1783","0039003800310061","9800",元大-歸仁,21,0,21,1,0.62
"20200506","1783","0037003000300044","7000",兆豐-西螺,0,24,24,-1,0.71
"20200506","1783","003900380034004b","9800",元大-館前,27,6,21,1,0.62
"20200506","1783","9625","9600",富邦-竹東,2,25,23,-1,0.68
"20200506","1783","6382","6380",光和-田中,20,0,20,1,0.59
"20200506","1783","8846","8840",玉山-板橋,1,22,21,-1,0.62
"20200506","1783","0039003200300048","9200",凱基-基隆,22,2,20,1,0.59
"20200506","1783","9217","9200",凱基-松山,0,20,20,-1,0.59
"20200507","1783","9283","9200",凱基-北門,25,0,25,1,2.52
"20200507","1783","6162","6160",中國信託-忠孝,0,25,25,-1,2.52
"20200507","1783","0037003000300056","7000",兆豐-新竹,22,0,22,1,2.22
"20200507","1783","0039004100390062","9A00",永豐金-虎尾,0,23,23,-1,2.32
"20200507","1783","9135","9100",群益金鼎-東大,17,0,17,1,1.71
"20200507","1783","003900380031005a","9800",元大-潮州,0,20,20,-1,2.02
"20200507","1783","6464","6460",大昌-新店,22,10,12,1,1.21
"20200507","1783","1560","1560",港商野村,8,25,17,-1,1.71
"20200507","1783","003500390032005a","5920",元富-安南,11,0,11,1,1.11
"20200507","1783","0039004100390053","9A00",永豐金-南京,0,16,16,-1,1.61
"20200507","1783","0037003700390058","7790",國票-中和,11,0,11,1,1.11
"20200507","1783","0035003800350052","5850",統一-汐止,0,15,15,-1,1.51
"20200507","1783","0039003200300047","9200",凱基-彰化,11,0,11,1,1.11
"20200507","1783","9359","9300",華南永昌-中正,0,15,15,-1,1.51
"20200507","1783","9647","9600",富邦-新竹,11,0,11,1,1.11
"20200507","1783","003900380033006a","9800",元大-仁愛,10,25,15,-1,1.51
"20200507","1783","1025","1020",合庫-基隆,10,0,10,1,1.01
"20200507","1783","0035003900320065","5920",元富-古亭,0,14,14,-1,1.41
"20200507","1783","6161","6160",中國信託-三重,10,0,10,1,1.01
"20200507","1783","6160","6160",中國信託,0,13,13,-1,1.31
"20200507","1783","7009","7000",兆豐-景美,10,0,10,1,1.01
"20200507","1783","7032","7030",致和-佳里,0,12,12,-1,1.21
"20200507","1783","9331","9300",華南永昌-鳳山,10,0,10,1,1.01
"20200507","1783","8560","8560",新光,5,17,12,-1,1.21
"20200507","1783","9333","9300",華南永昌-長虹,10,0,10,1,1.01
"20200507","1783","003900360031004e","9600",富邦-西壢,2,14,12,-1,1.21
"20200507","1783","003900360032004a","9600",富邦-三峽,10,0,10,1,1.01
"20200507","1783","0031003100310045","1110",台灣企銀-桃園,0,11,11,-1,1.11
"20200508","1783","8440","8440",摩根大通,81,1,80,1,5.31
"20200508","1783","003900310033004e","9100",群益金鼎-土城,0,41,41,-1,2.72
"20200508","1783","9300","9300",華南永昌,77,1,76,1,5.04
"20200508","1783","0037003700390058","7790",國票-中和,0,32,32,-1,2.12
"20200508","1783","5853","5850",統一-中壢,50,0,50,1,3.32
"20200508","1783","9266","9200",凱基-新豐,0,31,31,-1,2.06
"20200508","1783","6167","6160",中國信託-松江,45,1,44,1,2.92
"20200508","1783","9377","9300",華南永昌-虎尾,10,40,30,-1,1.99
"20200508","1783","9349","9300",華南永昌-板橋,40,0,40,1,2.65
"20200508","1783","0039003600310043","9600",富邦-南京,2,30,28,-1,1.86
"20200508","1783","1520","1520",瑞士信貸,35,8,27,1,1.79
"20200508","1783","003900380036004b","9800",元大-基隆孝二,0,28,28,-1,1.86
"20200508","1783","9834","9800",元大-中壢,27,2,25,1,1.66
"20200508","1783","0035003900320071","5920",元富-屏東,0,25,25,-1,1.66
"20200508","1783","003900360032004a","9600",富邦-三峽,20,0,20,1,1.33
"20200508","1783","9252","9200",凱基-嘉義,2,25,23,-1,1.53
"20200508","1783","1560","1560",港商野村,24,8,16,1,1.06
"20200508","1783","9319","9300",華南永昌-鶯歌,0,23,23,-1,1.53
"20200508","1783","9283","9200",凱基-北門,15,0,15,1,0.99
"20200508","1783","0038003400350044","8450",康和-板橋,0,22,22,-1,1.46
"20200508","1783","0031003200360055","1260",宏遠-館前,18,6,12,1,0.80
"20200508","1783","0035003300380042","5380",第一金-新竹,0,20,20,-1,1.33
"20200508","1783","9317","9300",華南永昌-林口,12,0,12,1,0.80
"20200508","1783","9135","9100",群益金鼎-東大,0,20,20,-1,1.33
"20200508","1783","0039003600310048","9600",富邦-新板,15,3,12,1,0.80
"20200508","1783","0039004100390058","9A00",永豐金-竹科,1,21,20,-1,1.33
"20200508","1783","9268","9200",凱基-台北,15,4,11,1,0.73
"20200508","1783","003900310038004a","9100",群益金鼎-永和,0,18,18,-1,1.19
"20200511","1783","1440","1440",美林,51,13,38,1,4.34
"20200511","1783","1470","1470",台灣摩根士丹利,23,60,37,-1,4.23
"20200511","1783","0035003900320072","5920",元富-城東,38,0,38,1,4.34
"20200511","1783","9898","9800",元大-新莊,0,29,29,-1,3.31
"20200511","1783","5853","5850",統一-中壢,25,1,24,1,2.74
"20200511","1783","0038003800340044","8840",玉山-左營,0,20,20,-1,2.29
"20200511","1783","9300","9300",華南永昌,28,7,21,1,2.40
"20200511","1783","0039003800310061","9800",元大-歸仁,2,20,18,-1,2.06
"20200511","1783","9252","9200",凱基-嘉義,15,0,15,1,1.71
"20200511","1783","9138","9100",群益金鼎-中港,0,12,12,-1,1.37
"20200511","1783","1480","1480",美商高盛,14,0,14,1,1.60
"20200511","1783","1113","1110",台灣企銀-九如,0,10,10,-1,1.14
"20200511","1783","0037003000300046","7000",兆豐-虎尾,14,0,14,1,1.60
"20200511","1783","1035","1030",土銀-新竹,0,10,10,-1,1.14
"20200511","1783","9875","9800",元大-土城永寧,13,0,13,1,1.49
"20200511","1783","0035003900320050","5920",元富-同大,0,10,10,-1,1.14
"20200511","1783","0035003800350052","5850",統一-汐止,14,3,11,1,1.26
"20200511","1783","0037003700390050","7790",國票-九鼎,11,21,10,-1,1.14
"20200511","1783","003900360035004b","9600",富邦-台中,11,0,11,1,1.26
"20200511","1783","9814","9800",元大-大益,1,11,10,-1,1.14
"20200511","1783","9349","9300",華南永昌-板橋,10,0,10,1,1.14
"20200511","1783","0039003800310051","9800",元大-太平,0,10,10,-1,1.14
"20200511","1783","9366","9300",華南永昌-豐原,10,0,10,1,1.14
"20200511","1783","9835","9800",元大-員林中山,1,11,10,-1,1.14
"20200511","1783","9663","9600",富邦-敦南,10,0,10,1,1.14
"20200511","1783","9862","9800",元大-南京,0,10,10,-1,1.14
"20200511","1783","003900380031004e","9800",元大-金門,10,0,10,1,1.14
"20200511","1783","0039003800390050","9800",元大-敦南,0,10,10,-1,1.14
"20200512","1783","0037003000300046","7000",兆豐-虎尾,14,0,14,1,3.65
"20200512","1783","1440","1440",美林,3,38,35,-1,9.11
"20200512","1783","1520","1520",瑞士信貸,19,7,12,1,3.13
"20200512","1783","0035003800350052","5850",統一-汐止,2,22,20,-1,5.21
"20200512","1783","9898","9800",元大-新莊,11,0,11,1,2.86
"20200512","1783","0038003800340046","8840",玉山-桃園,0,20,20,-1,5.21
"20200512","1783","0031003100310042","1110",台灣企銀-建成,10,0,10,1,2.60
"20200512","1783","9875","9800",元大-土城永寧,3,23,20,-1,5.21
"20200512","1783","5263","5260",美好-泰山,10,0,10,1,2.60
"20200512","1783","0039003800390059","9800",元大-基隆,17,33,16,-1,4.17
"20200512","1783","5853","5850",統一-中壢,10,0,10,1,2.60
"20200512","1783","0039003800310067","9800",元大-大里,0,12,12,-1,3.13
"20200512","1783","0038003100350042","8150",台新-台中,10,0,10,1,2.60
"20200512","1783","1560","1560",港商野村,0,11,11,-1,2.86
"20200512","1783","9317","9300",華南永昌-林口,10,0,10,1,2.60
"20200512","1783","9636","9600",富邦-中壢,0,10,10,-1,2.60
"20200512","1783","003900360032004a","9600",富邦-三峽,10,0,10,1,2.60
"20200512","1783","1590","1590",花旗環球,0,7,7,-1,1.82
"20200512","1783","003900380031004b","9800",元大-林園,8,0,8,1,2.08
"20200512","1783","0031003200360055","1260",宏遠-館前,2,9,7,-1,1.82
"20200512","1783","8888","8880",國泰-敦南,6,0,6,1,1.56
"20200512","1783","003700300030006a","7000",兆豐-大安,0,6,6,-1,1.56
"20200512","1783","0039003100380047","9100",群益金鼎-新莊,8,2,6,1,1.56
"20200512","1783","9651","9600",富邦-民生(停),0,6,6,-1,1.56
"20200512","1783","9208","9200",凱基-桃園,8,2,6,1,1.56
"20200512","1783","0039003100330052","9100",群益金鼎-北高雄,0,5,5,-1,1.30
"20200512","1783","0031003200360058","1260",宏遠-新化,5,0,5,1,1.30
"20200512","1783","003900360031005a","9600",富邦-永康,5,10,5,-1,1.30
"20200513","1783","1440","1440",美林,67,13,54,1,5.16
"20200513","1783","0035003900320072","5920",元富-城東,0,41,41,-1,3.92
"20200513","1783","1025","1020",合庫-基隆,50,0,50,1,4.78
"20200513","1783","8440","8440",摩根大通,5,40,35,-1,3.35
"20200513","1783","5263","5260",美好-泰山,30,0,30,1,2.87
"20200513","1783","9676","9600",富邦-仁愛,0,29,29,-1,2.77
"20200513","1783","0039003600360046","9600",富邦-左營,20,0,20,1,1.91
"20200513","1783","9208","9200",凱基-桃園,14,41,27,-1,2.58
"20200513","1783","5960","5960",日茂,17,0,17,1,1.63
"20200513","1783","8151","8150",台新-建北,0,21,21,-1,2.01
"20200513","1783","003500320036004b","5260",美好-富順,20,4,16,1,1.53
"20200513","1783","9238","9200",凱基-士林,0,21,21,-1,2.01
"20200513","1783","9834","9800",元大-中壢,12,0,12,1,1.15
"20200513","1783","1520","1520",瑞士信貸,7,25,18,-1,1.72
"20200513","1783","1560","1560",港商野村,11,1,10,1,0.96
"20200513","1783","6452","6450",永全-八德,0,16,16,-1,1.53
"20200513","1783","9206","9200",凱基-高雄,10,0,10,1,0.96
"20200513","1783","0035003900320043","5920",元富-潮州,7,20,13,-1,1.24
"20200513","1783","0039003800310056","9800",元大-民雄,10,0,10,1,0.96
"20200513","1783","9816","9800",元大-新竹,0,12,12,-1,1.15
"20200513","1783","9831","9800",元大-四維,10,0,10,1,0.96
"20200513","1783","0039003800310067","9800",元大-大里,0,12,12,-1,1.15
"20200513","1783","003900320031004d","9200",凱基-八德,9,0,9,1,0.86
"20200513","1783","003700370039006a","7790",國票-和平,0,11,11,-1,1.05
"20200513","1783","0039004100300030","9A00",永豐金證券,9,0,9,1,0.86
"20200513","1783","9377","9300",華南永昌-虎尾,0,11,11,-1,1.05
"20200513","1783","8844","8840",玉山-松江(停),8,0,8,1,0.76
"20200513","1783","2184","2180",亞東-新竹,0,10,10,-1,0.96
"20200514","1783","1470","1470",台灣摩根士丹利,21,6,15,1,2.65
"20200514","1783","1440","1440",美林,2,68,66,-1,11.68
"20200514","1783","0035003900320072","5920",元富-城東,10,0,10,1,1.77
"20200514","1783","003500320036004b","5260",美好-富順,0,20,20,-1,3.54
"20200514","1783","0036003100310041","6110",台中銀-豐原,10,0,10,1,1.77
"20200514","1783","0035003800350044","5850",統一-新台中,4,24,20,-1,3.54
"20200514","1783","6382","6380",光和-田中,10,0,10,1,1.77
"20200514","1783","9838","9800",元大-豐原,0,16,16,-1,2.83
"20200514","1783","9813","9800",元大-八德,10,0,10,1,1.77
"20200514","1783","5381","5380",第一金-員林,0,11,11,-1,1.95
"20200514","1783","9835","9800",元大-員林中山,10,0,10,1,1.77
"20200514","1783","1560","1560",港商野村,0,10,10,-1,1.77
"20200514","1783","0039003800340048","9800",元大-景美,10,0,10,1,1.77
"20200514","1783","003900380039006a","9800",元大-樹林,0,10,10,-1,1.77
"20200514","1783","7790","7790",國票證券,9,0,9,1,1.59
"20200514","1783","0039004100300030","9A00",永豐金證券,0,9,9,-1,1.59
"20200514","1783","8150","8150",台新證券,10,1,9,1,1.59
"20200514","1783","9837","9800",元大-北港,0,8,8,-1,1.42
"20200514","1783","8560","8560",新光,10,1,9,1,1.59
"20200514","1783","9852","9800",元大-永春,0,7,7,-1,1.24
"20200514","1783","9283","9200",凱基-北門,8,0,8,1,1.42
"20200514","1783","5266","5260",美好-中壢,0,5,5,-1,0.88
"20200514","1783","5323","5320",高橋-內壢,7,0,7,1,1.24
"20200514","1783","5855","5850",統一-台南,0,5,5,-1,0.88
"20200514","1783","9234","9200",凱基-竹北,7,0,7,1,1.24
"20200514","1783","0037003000300070","7000",兆豐-復興,0,5,5,-1,0.88
"20200514","1783","0031003200360055","1260",宏遠-館前,7,1,6,1,1.06
"20200514","1783","7791","7790",國票-台東,0,5,5,-1,0.88
"20200515","1783","8440","8440",摩根大通,24,0,24,1,4.96
"20200515","1783","003900380034004b","9800",元大-館前,2,25,23,-1,4.75
"20200515","1783","9324","9300",華南永昌-岡山,20,0,20,1,4.13
"20200515","1783","0037003000300049","7000",兆豐-北高雄,0,20,20,-1,4.13
"20200515","1783","1440","1440",美林,30,14,16,1,3.31
"20200515","1783","9815","9800",元大-大灣,0,20,20,-1,4.13
"20200515","1783","0039003600310043","9600",富邦-南京,16,0,16,1,3.31
"20200515","1783","9834","9800",元大-中壢,0,16,16,-1,3.31
"20200515","1783","9217","9200",凱基-松山,13,0,13,1,2.69
"20200515","1783","0039003100380041","9100",群益金鼎-中壢,0,15,15,-1,3.10
"20200515","1783","9898","9800",元大-新莊,12,2,10,1,2.07
"20200515","1783","0039003800380042","9800",元大-桃園,1,15,14,-1,2.89
"20200515","1783","0039003200310045","9200",凱基-三峽,8,0,8,1,1.65
"20200515","1783","0035003800350045","5850",統一-新營,0,11,11,-1,2.27
"20200515","1783","9672","9600",富邦-員林,8,0,8,1,1.65
"20200515","1783","1118","1110",台灣企銀-豐原,0,10,10,-1,2.07
"20200515","1783","0039003800330069","9800",元大-大雅,8,0,8,1,1.65
"20200515","1783","0039003600310052","9600",富邦-南員林,0,10,10,-1,2.07
"20200515","1783","0039003800390051","9800",元大-汐止,10,2,8,1,1.65
"20200515","1783","9663","9600",富邦-敦南,0,10,10,-1,2.07
"20200515","1783","8150","8150",台新證券,7,0,7,1,1.45
"20200515","1783","1470","1470",台灣摩根士丹利,6,14,8,-1,1.65
"20200515","1783","0036003100310041","6110",台中銀-豐原,6,0,6,1,1.24
"20200515","1783","8885","8880",國泰-桃園,0,8,8,-1,1.65
"20200515","1783","9317","9300",華南永昌-林口,6,0,6,1,1.24
"20200515","1783","0039003200300056","9200",凱基-新店,0,8,8,-1,1.65
"20200515","1783","9874","9800",元大-雙和,6,0,6,1,1.24
"20200515","1783","0039003600320052","9600",富邦-園區,0,8,8,-1,1.65
"20200518","1783","9268","9200",凱基-台北,91,1,90,1,2.65
"20200518","1783","9317","9300",華南永昌-林口,0,56,56,-1,1.65
"20200518","1783","0039003200300041","9200",凱基-板橋,70,0,70,1,2.06
"20200518","1783","1470","1470",台灣摩根士丹利,45,100,55,-1,1.62
"20200518","1783","9352","9300",華南永昌-桃園,68,1,67,1,1.97
"20200518","1783","9892","9800",元大-屏東,5,59,54,-1,1.59
"20200518","1783","9287","9200",凱基-內湖,66,0,66,1,1.94
"20200518","1783","9217","9200",凱基-松山,0,26,26,-1,0.77
"20200518","1783","0035003900320045","5920",元富-城中,50,0,50,1,1.47
"20200518","1783","6382","6380",光和-田中,0,20,20,-1,0.59
"20200518","1783","0035003900320055","5920",元富-宜蘭,60,30,30,1,0.88
"20200518","1783","9324","9300",華南永昌-岡山,0,20,20,-1,0.59
"20200518","1783","9187","9100",群益金鼎-彰化,28,3,25,1,0.74
"20200518","1783","0039004100390072","9A00",永豐金-北高雄,0,20,20,-1,0.59
"20200518","1783","9853","9800",元大-南屯,35,12,23,1,0.68
"20200518","1783","1520","1520",瑞士信貸,27,44,17,-1,0.50
"20200518","1783","9666","9600",富邦-南屯,31,10,21,1,0.62
"20200518","1783","0039003800390059","9800",元大-基隆,17,34,17,-1,0.50
"20200518","1783","9858","9800",元大-龍潭,21,0,21,1,0.62
"20200518","1783","5386","5380",第一金-彰化,3,18,15,-1,0.44
"20200518","1783","0039003600310045","9600",富邦-府城,22,4,18,1,0.53
"20200518","1783","9835","9800",元大-員林中山,0,15,15,-1,0.44
"20200518","1783","9815","9800",元大-大灣,20,2,18,1,0.53
"20200518","1783","9377","9300",華南永昌-虎尾,1,15,14,-1,0.41
"20200518","1783","9894","9800",元大-桃興,22,6,16,1,0.47
"20200518","1783","7790","7790",國票證券,5,18,13,-1,0.38
"20200518","1783","9300","9300",華南永昌,20,5,15,1,0.44
"20200518","1783","9283","9200",凱基-北門,0,13,13,-1,0.38
"20200519","1783","0037003000300056","7000",兆豐-新竹,79,24,55,1,2.29
"20200519","1783","9268","9200",凱基-台北,14,105,91,-1,3.79
"20200519","1783","0039003200320043","9200",凱基-屏東,54,0,54,1,2.25
"20200519","1783","1470","1470",台灣摩根士丹利,1,75,74,-1,3.08
"20200519","1783","003900380031006d","9800",元大-前金,55,2,53,1,2.21
"20200519","1783","1520","1520",瑞士信貸,1,75,74,-1,3.08
"20200519","1783","0035003900320048","5920",元富-信義,47,0,47,1,1.96
"20200519","1783","0039003200300041","9200",凱基-板橋,2,71,69,-1,2.88
"20200519","1783","003900320030004e","9200",凱基-湖口,45,0,45,1,1.88
"20200519","1783","9352","9300",華南永昌-桃園,0,68,68,-1,2.83
"20200519","1783","9894","9800",元大-桃興,45,5,40,1,1.67
"20200519","1783","9287","9200",凱基-內湖,0,66,66,-1,2.75
"20200519","1783","9349","9300",華南永昌-板橋,36,2,34,1,1.42
"20200519","1783","8440","8440",摩根大通,4,56,52,-1,2.17
"20200519","1783","0037003000300048","7000",兆豐-東門,33,2,31,1,1.29
"20200519","1783","6452","6450",永全-八德,0,39,39,-1,1.63
"20200519","1783","7750","7750",北城證券,30,0,30,1,1.25
"20200519","1783","0035003900320055","5920",元富-宜蘭,0,30,30,-1,1.25
"20200519","1783","0039003100380041","9100",群益金鼎-中壢,26,3,23,1,0.96
"20200519","1783","003900360035004b","9600",富邦-台中,13,42,29,-1,1.21
"20200519","1783","0037003700390050","7790",國票-九鼎,22,1,21,1,0.88
"20200519","1783","5263","5260",美好-泰山,2,30,28,-1,1.17
"20200519","1783","9871","9800",元大-忠孝,23,4,19,1,0.79
"20200519","1783","9187","9100",群益金鼎-彰化,3,31,28,-1,1.17
"20200519","1783","1030","1030",土銀,15,0,15,1,0.63
"20200519","1783","9300","9300",華南永昌,1,28,27,-1,1.13
"20200519","1783","9237","9200",凱基-敦北,15,0,15,1,0.63
"20200519","1783","9853","9800",元大-南屯,1,25,24,-1,1.00
"20200520","1783","6167","6160",中國信託-松江,40,0,40,1,5.83
"20200520","1783","8440","8440",摩根大通,3,39,36,-1,5.25
"20200520","1783","0037003000300048","7000",兆豐-東門,29,6,23,1,3.35
"20200520","1783","5266","5260",美好-中壢,0,32,32,-1,4.66
"20200520","1783","0035003900320044","5920",元富-大昌,20,0,20,1,2.92
"20200520","1783","0031003200360055","1260",宏遠-館前,1,24,23,-1,3.35
"20200520","1783","0037003000300056","7000",兆豐-新竹,21,1,20,1,2.92
"20200520","1783","9875","9800",元大-土城永寧,0,17,17,-1,2.48
"20200520","1783","9300","9300",華南永昌,16,0,16,1,2.33
"20200520","1783","8150","8150",台新證券,4,16,12,-1,1.75
"20200520","1783","0037003700390065","7790",國票-南科,15,0,15,1,2.19
"20200520","1783","0035003800350045","5850",統一-新營,0,10,10,-1,1.46
"20200520","1783","1470","1470",台灣摩根士丹利,23,10,13,1,1.90
"20200520","1783","0035003800350055","5850",統一-南京,0,10,10,-1,1.46
"20200520","1783","7798","7790",國票-內壢,13,0,13,1,1.90
"20200520","1783","9867","9800",元大-北成功,0,10,10,-1,1.46
"20200520","1783","0039003600320056","9600",富邦-復興,13,0,13,1,1.90
"20200520","1783","0039003800390051","9800",元大-汐止,3,13,10,-1,1.46
"20200520","1783","0035003300380044","5380",第一金-忠孝,10,0,10,1,1.46
"20200520","1783","0039004100390050","9A00",永豐金-竹北,0,10,10,-1,1.46
"20200520","1783","9366","9300",華南永昌-豐原,10,0,10,1,1.46
"20200520","1783","0035003900320065","5920",元富-古亭,2,10,8,-1,1.17
"20200520","1783","9651","9600",富邦-民生(停),10,0,10,1,1.46
"20200520","1783","9624","9600",富邦-竹北,0,8,8,-1,1.17
"20200520","1783","9892","9800",元大-屏東,10,1,9,1,1.31
"20200520","1783","8157","8150",台新-左楠,2,9,7,-1,1.02
"20200520","1783","9359","9300",華南永昌-中正,8,0,8,1,1.17
"20200520","1783","5853","5850",統一-中壢,10,16,6,-1,0.87
"20200521","1783","0037003000300056","7000",兆豐-新竹,40,0,40,1,4.93
"20200521","1783","1260","1260",宏遠證券,3,41,38,-1,4.69
"20200521","1783","9215","9200",凱基-高美館,20,0,20,1,2.47
"20200521","1783","003900320030004e","9200",凱基-湖口,0,35,35,-1,4.32
"20200521","1783","0035003900320058","5920",元富-草屯,16,0,16,1,1.97
"20200521","1783","9234","9200",凱基-竹北,6,40,34,-1,4.19
"20200521","1783","9349","9300",華南永昌-板橋,16,0,16,1,1.97
"20200521","1783","0039003600320045","9600",富邦-樹林,0,19,19,-1,2.34
"20200521","1783","9872","9800",元大-復北,23,8,15,1,1.85
"20200521","1783","9206","9200",凱基-高雄,0,15,15,-1,1.85
"20200521","1783","9217","9200",凱基-松山,11,0,11,1,1.36
"20200521","1783","9854","9800",元大-文心興安,0,13,13,-1,1.60
"20200521","1783","1040","1040",臺銀,10,0,10,1,1.23
"20200521","1783","0039004100390053","9A00",永豐金-南京,0,12,12,-1,1.48
"20200521","1783","0035003800350052","5850",統一-汐止,10,0,10,1,1.23
"20200521","1783","1650","1650",新加坡商瑞銀,0,10,10,-1,1.23
"20200521","1783","0039003100380065","9100",群益金鼎-大安,10,0,10,1,1.23
"20200521","1783","0037003700390056","7790",國票-天祥,0,10,10,-1,1.23
"20200521","1783","0039003200300044","9200",凱基-市府,10,0,10,1,1.23
"20200521","1783","9366","9300",華南永昌-豐原,0,10,10,-1,1.23
"20200521","1783","9327","9300",華南永昌-斗六,10,0,10,1,1.23
"20200521","1783","003900410039004e","9A00",永豐金-桃盛,0,10,10,-1,1.23
"20200521","1783","9894","9800",元大-桃興,10,0,10,1,1.23
"20200521","1783","8560","8560",新光,2,11,9,-1,1.11
"20200521","1783","0039004100390045","9A00",永豐金-板橋,10,0,10,1,1.23
"20200521","1783","8565","8560",新光-桃園,0,9,9,-1,1.11
"20200521","1783","5321","5320",高橋-龍潭,7,0,7,1,0.86
"20200521","1783","8881","8880",國泰-高雄,1,10,9,-1,1.11
"20200522","1783","5660","5660",日進,70,0,70,1,5.97
"20200522","1783","8440","8440",摩根大通,19,57,38,-1,3.24
"20200522","1783","0037003000300056","7000",兆豐-新竹,24,1,23,1,1.96
"20200522","1783","0035003800350045","5850",統一-新營,0,29,29,-1,2.47
"20200522","1783","9137","9100",群益金鼎-士林,20,0,20,1,1.71
"20200522","1783","7798","7790",國票-內壢,0,28,28,-1,2.39
"20200522","1783","0039003600320050","9600",富邦-頭份,20,1,19,1,1.62
"20200522","1783","9208","9200",凱基-桃園,0,15,15,-1,1.28
"20200522","1783","9636","9600",富邦-中壢,16,2,14,1,1.19
"20200522","1783","0037003700390065","7790",國票-南科,0,11,11,-1,0.94
"20200522","1783","5853","5850",統一-中壢,12,0,12,1,1.02
"20200522","1783","0031003100310042","1110",台灣企銀-建成,0,10,10,-1,0.85
"20200522","1783","0038003800380041","8880",國泰-館前,15,3,12,1,1.02
"20200522","1783","1470","1470",台灣摩根士丹利,5,15,10,-1,0.85
"20200522","1783","0039003800330042","9800",元大-林森,11,0,11,1,0.94
"20200522","1783","6452","6450",永全-八德,0,10,10,-1,0.85
"20200522","1783","0039003800390061","9800",元大-苑裡,17,6,11,1,0.94
"20200522","1783","9134","9100",群益金鼎-開元,0,10,10,-1,0.85
"20200522","1783","0035003300380044","5380",第一金-忠孝,10,0,10,1,0.85
"20200522","1783","9252","9200",凱基-嘉義,5,15,10,-1,0.85
"20200522","1783","6162","6160",中國信託-忠孝,10,0,10,1,0.85
"20200522","1783","9647","9600",富邦-新竹,0,10,10,-1,0.85
"20200522","1783","8849","8840",玉山-景美,10,0,10,1,0.85
"20200522","1783","0039003800310044","9800",元大-南投,0,10,10,-1,0.85
"20200522","1783","8887","8880",國泰-忠孝,10,0,10,1,0.85
"20200522","1783","0039003800310067","9800",元大-大里,1,11,10,-1,0.85
"20200522","1783","9869","9800",元大-新盛,10,0,10,1,0.85
"20200522","1783","9825","9800",元大-新營,0,10,10,-1,0.85
"20200525","1783","0039003600320045","9600",富邦-樹林,61,1,60,1,2.03
"20200525","1783","8440","8440",摩根大通,19,54,35,-1,1.18
"20200525","1783","1440","1440",美林,127,73,54,1,1.82
"20200525","1783","0039003800390059","9800",元大-基隆,6,41,35,-1,1.18
"20200525","1783","9366","9300",華南永昌-豐原,35,1,34,1,1.15
"20200525","1783","8560","8560",新光,19,51,32,-1,1.08
"20200525","1783","003900360033004c","9600",富邦-豐原,31,0,31,1,1.05
"20200525","1783","0039003800310046","9800",元大-福營,3,34,31,-1,1.05
"20200525","1783","6620","6620",口袋證券,30,0,30,1,1.01
"20200525","1783","003900360032004a","9600",富邦-三峽,1,31,30,-1,1.01
"20200525","1783","0038003400350045","8450",康和-澎湖,30,0,30,1,1.01
"20200525","1783","9329","9300",華南永昌-朴子,0,22,22,-1,0.74
"20200525","1783","9208","9200",凱基-桃園,29,3,26,1,0.88
"20200525","1783","6161","6160",中國信託-三重,0,21,21,-1,0.71
"20200525","1783","0039003100330055","9100",群益金鼎-崇德,25,1,24,1,0.81
"20200525","1783","9634","9600",富邦-羅東,0,21,21,-1,0.71
"20200525","1783","9307","9300",華南永昌-大安,30,6,24,1,0.81
"20200525","1783","1470","1470",台灣摩根士丹利,0,17,17,-1,0.57
"20200525","1783","0037003700390063","7790",國票-敦北法人,21,0,21,1,0.71
"20200525","1783","1030","1030",土銀,0,15,15,-1,0.51
"20200525","1783","0039004100390044","9A00",永豐金-忠孝,22,1,21,1,0.71
"20200525","1783","0035003300380041","5380",第一金-新興,0,15,15,-1,0.51
"20200525","1783","5660","5660",日進,20,0,20,1,0.68
"20200525","1783","0035003900320058","5920",元富-草屯,0,15,15,-1,0.51
"20200525","1783","9105","9100",群益金鼎-高盛,27,7,20,1,0.68
"20200525","1783","0039003800390064","9800",元大-北屯,0,14,14,-1,0.47
"20200525","1783","9852","9800",元大-永春,37,18,19,1,0.64
"20200525","1783","9234","9200",凱基-竹北,1,14,13,-1,0.44
"20200526","1783","1043","1040",臺銀-民權,50,0,50,1,3.28
"20200526","1783","1440","1440",美林,33,74,41,-1,2.69
"20200526","1783","0037003000300056","7000",兆豐-新竹,42,12,30,1,1.97
"20200526","1783","9894","9800",元大-桃興,0,32,32,-1,2.10
"20200526","1783","8458","8450",康和-台南,30,0,30,1,1.97
"20200526","1783","003900360033004c","9600",富邦-豐原,0,31,31,-1,2.03
"20200526","1783","9801","9800",元大-城東,31,3,28,1,1.83
"20200526","1783","6162","6160",中國信託-忠孝,2,28,26,-1,1.70
"20200526","1783","0039004100390044","9A00",永豐金-忠孝,25,1,24,1,1.57
"20200526","1783","9852","9800",元大-永春,0,26,26,-1,1.70
"20200526","1783","9657","9600",富邦-苗栗,20,1,19,1,1.25
"20200526","1783","9307","9300",華南永昌-大安,0,24,24,-1,1.57
"20200526","1783","0035003900320058","5920",元富-草屯,15,0,15,1,0.98
"20200526","1783","9215","9200",凱基-高美館,0,20,20,-1,1.31
"20200526","1783","9234","9200",凱基-竹北,15,0,15,1,0.98
"20200526","1783","9233","9200",凱基-長庚,7,27,20,-1,1.31
"20200526","1783","0035003800350052","5850",統一-汐止,13,0,13,1,0.85
"20200526","1783","0039003600310045","9600",富邦-府城,0,20,20,-1,1.31
"20200526","1783","0035003900320051","5920",元富-敦南,13,0,13,1,0.85
"20200526","1783","1470","1470",台灣摩根士丹利,0,18,18,-1,1.18
"20200526","1783","0039004100390058","9A00",永豐金-竹科,20,7,13,1,0.85
"20200526","1783","0039003800310046","9800",元大-福營,2,20,18,-1,1.18
"20200526","1783","0035003300380041","5380",第一金-新興,11,0,11,1,0.72
"20200526","1783","0035003300380059","5380",第一金-中壢,0,17,17,-1,1.11
"20200526","1783","0039003600390043","9600",富邦-北港,38,27,11,1,0.72
"20200526","1783","1480","1480",美商高盛,9,25,16,-1,1.05
"20200526","1783","1028","1020",合庫-彰化,10,0,10,1,0.66
"20200526","1783","003900360032004a","9600",富邦-三峽,4,20,16,-1,1.05
"20200527","1783","0037003000300056","7000",兆豐-新竹,33,2,31,1,3.07
"20200527","1783","0031003200360058","1260",宏遠-新化,2,50,48,-1,4.75
"20200527","1783","9801","9800",元大-城東,40,14,26,1,2.57
"20200527","1783","1025","1020",合庫-基隆,5,50,45,-1,4.46
"20200527","1783","9352","9300",華南永昌-桃園,25,0,25,1,2.48
"20200527","1783","0039003100330055","9100",群益金鼎-崇德,0,25,25,-1,2.48
"20200527","1783","0039003600320056","9600",富邦-復興,24,1,23,1,2.28
"20200527","1783","8458","8450",康和-台南,0,22,22,-1,2.18
"20200527","1783","0039003600320043","9600",富邦-東門,21,1,20,1,1.98
"20200527","1783","9105","9100",群益金鼎-高盛,6,28,22,-1,2.18
"20200527","1783","9227","9200",凱基-城中,16,0,16,1,1.58
"20200527","1783","5660","5660",日進,0,20,20,-1,1.98
"20200527","1783","1560","1560",港商野村,16,1,15,1,1.49
"20200527","1783","9872","9800",元大-復北,0,20,20,-1,1.98
"20200527","1783","1650","1650",新加坡商瑞銀,13,0,13,1,1.29
"20200527","1783","9657","9600",富邦-苗栗,0,19,19,-1,1.88
"20200527","1783","9317","9300",華南永昌-林口,14,1,13,1,1.29
"20200527","1783","9894","9800",元大-桃興,2,18,16,-1,1.58
"20200527","1783","1440","1440",美林,38,27,11,1,1.09
"20200527","1783","0037003700390050","7790",國票-九鼎,4,19,15,-1,1.49
"20200527","1783","9349","9300",華南永昌-板橋,11,0,11,1,1.09
"20200527","1783","9815","9800",元大-大灣,0,15,15,-1,1.49
"20200527","1783","0039003800310046","9800",元大-福營,16,5,11,1,1.09
"20200527","1783","9359","9300",華南永昌-中正,42,55,13,-1,1.29
"20200527","1783","9873","9800",元大-西門,11,0,11,1,1.09
"20200527","1783","6950","6950",福勝,0,10,10,-1,0.99
"20200527","1783","7792","7790",國票-北投,10,0,10,1,0.99
"20200527","1783","0037003000300043","7000",兆豐-來福,0,10,10,-1,0.99
"20200528","1783","0035003300380044","5380",第一金-忠孝,40,1,39,1,5.76
"20200528","1783","0038003400350045","8450",康和-澎湖,0,30,30,-1,4.43
"20200528","1783","9352","9300",華南永昌-桃園,21,2,19,1,2.81
"20200528","1783","9892","9800",元大-屏東,3,29,26,-1,3.84
"20200528","1783","0039003600320056","9600",富邦-復興,18,0,18,1,2.66
"20200528","1783","7798","7790",國票-內壢,0,25,25,-1,3.69
"20200528","1783","6161","6160",中國信託-三重,11,0,11,1,1.62
"20200528","1783","9800","9800",元大證券,1,22,21,-1,3.10
"20200528","1783","9366","9300",華南永昌-豐原,11,0,11,1,1.62
"20200528","1783","0039003800310044","9800",元大-南投,0,16,16,-1,2.36
"20200528","1783","9377","9300",華南永昌-虎尾,11,0,11,1,1.62
"20200528","1783","1040","1040",臺銀,0,15,15,-1,2.22
"20200528","1783","9189","9100",群益金鼎-桃園,10,0,10,1,1.48
"20200528","1783","1560","1560",港商野村,2,16,14,-1,2.07
"20200528","1783","9268","9200",凱基-台北,18,8,10,1,1.48
"20200528","1783","9233","9200",凱基-長庚,5,18,13,-1,1.92
"20200528","1783","0039004100390069","9A00",永豐金-新店,10,0,10,1,1.48
"20200528","1783","1035","1030",土銀-新竹,0,11,11,-1,1.62
"20200528","1783","0039003800390050","9800",元大-敦南,9,0,9,1,1.33
"20200528","1783","7797","7790",國票-中正,0,11,11,-1,1.62
"20200528","1783","0039004100390044","9A00",永豐金-忠孝,9,0,9,1,1.33
"20200528","1783","7009","7000",兆豐-景美,0,10,10,-1,1.48
"20200528","1783","1650","1650",新加坡商瑞銀,8,0,8,1,1.18
"20200528","1783","0037003000300043","7000",兆豐-來福,0,10,10,-1,1.48
"20200528","1783","8843","8840",玉山-高雄,10,3,7,1,1.03
"20200528","1783","0037003700390050","7790",國票-九鼎,2,12,10,-1,1.48
"20200528","1783","003900310038004a","9100",群益金鼎-永和,7,0,7,1,1.03
"20200528","1783","003700370039005a","7790",國票-安和,0,10,10,-1,1.48
"20200529","1783","1520","1520",瑞士信貸,22,0,22,1,6.06
"20200529","1783","003800380038004b","8880",國泰-板橋,0,21,21,-1,5.79
"20200529","1783","0035003800350052","5850",統一-汐止,20,0,20,1,5.51
"20200529","1783","0035003900320044","5920",元富-大昌,0,17,17,-1,4.68
"20200529","1783","1440","1440",美林,24,11,13,1,3.58
"20200529","1783","8560","8560",新光,0,16,16,-1,4.41
"20200529","1783","0039003600310048","9600",富邦-新板,13,0,13,1,3.58
"20200529","1783","9366","9300",華南永昌-豐原,0,11,11,-1,3.03
"20200529","1783","9352","9300",華南永昌-桃園,11,0,11,1,3.03
"20200529","1783","9300","9300",華南永昌,1,11,10,-1,2.75
"20200529","1783","9308","9300",華南永昌-麻豆,10,1,9,1,2.48
"20200529","1783","0039003800390045","9800",元大-草屯,1,11,10,-1,2.75
"20200529","1783","9898","9800",元大-新莊,11,2,9,1,2.48
"20200529","1783","9252","9200",凱基-嘉義,3,11,8,-1,2.20
"20200529","1783","8440","8440",摩根大通,10,3,7,1,1.93
"20200529","1783","0039003800390044","9800",元大-左營,0,8,8,-1,2.20
"20200529","1783","8849","8840",玉山-景美,7,0,7,1,1.93
"20200529","1783","0039004100390068","9A00",永豐金-台南,0,7,7,-1,1.93
"20200529","1783","8561","8560",新光-台中,8,2,6,1,1.65
"20200529","1783","5323","5320",高橋-內壢,2,8,6,-1,1.65
"20200529","1783","9268","9200",凱基-台北,8,3,5,1,1.38
"20200529","1783","9283","9200",凱基-北門,0,6,6,-1,1.65
"20200529","1783","0039003600320041","9600",富邦-信義,5,0,5,1,1.38
"20200529","1783","5381","5380",第一金-員林,0,5,5,-1,1.38
"20200529","1783","003900410039004a","9A00",永豐金-板新,5,0,5,1,1.38
"20200529","1783","6160","6160",中國信託,0,5,5,-1,1.38
"20200529","1783","003500330038004e","5380",第一金-豐原,4,0,4,1,1.10
"20200529","1783","9634","9600",富邦-羅東,0,5,5,-1,1.38
"20200401","1783","0039003200320048","9200",凱基-復興,21,0,21,1,17.07
"20200401","1783","8560","8560",新光,0,10,10,-1,8.13
"20200401","1783","6464","6460",大昌-新店,10,0,10,1,8.13
"20200401","1783","9315","9300",華南永昌-苑裡,0,10,10,-1,8.13
"20200401","1783","0035003800350057","5850",統一-金門,5,0,5,1,4.07
"20200401","1783","0039003800370041","9800",元大-楊梅,0,10,10,-1,8.13
"20200401","1783","0031003100310042","1110",台灣企銀-建成,5,0,5,1,4.07
"20200401","1783","1520","1520",瑞士信貸,0,7,7,-1,5.69
"20200401","1783","0039003600320042","9600",富邦-二林,5,0,5,1,4.07
"20200401","1783","0035003900320075","5920",元富-世貿,0,7,7,-1,5.69
"20200401","1783","9672","9600",富邦-員林,4,0,4,1,3.25
"20200401","1783","7750","7750",北城證券,0,6,6,-1,4.88
"20200401","1783","9898","9800",元大-新莊,4,0,4,1,3.25
"20200401","1783","8451","8450",康和-延平,0,6,6,-1,4.88
"20200401","1783","0039003800390059","9800",元大-基隆,4,0,4,1,3.25
"20200401","1783","003900360035004b","9600",富邦-台中,1,7,6,-1,4.88
"20200401","1783","0039003600310043","9600",富邦-南京,3,0,3,1,2.44
"20200401","1783","1020","1020",合庫證券,0,5,5,-1,4.07
"20200401","1783","1440","1440",美林,2,0,2,1,1.63
"20200401","1783","0039003200300046","9200",凱基-站前,0,5,5,-1,4.07
"20200401","1783","0039003800390041","9800",元大-北投,6,4,2,1,1.63
"20200401","1783","0039004100390053","9A00",永豐金-南京,0,4,4,-1,3.25
"20200401","1783","0039004100390038","9A00",永豐金-大園,2,0,2,1,1.63
"20200401","1783","6460","6460",大昌,0,2,2,-1,1.63
"20200401","1783","003600310036004b","6160",中國信託-高雄,1,0,1,1,0.81
"20200401","1783","0038003100350041","8150",台新-高雄,0,2,2,-1,1.63
"20200401","1783","5323","5320",高橋-內壢,2,1,1,1,0.81
"20200401","1783","8882","8880",國泰-台中,0,2,2,-1,1.63
"20200406","1783","1440","1440",美林,37,4,33,1,10.78
"20200406","1783","1041","1040",臺銀-鳳山,0,29,29,-1,9.48
"20200406","1783","003700300030004d","7000",兆豐-桃園,15,0,15,1,4.90
"20200406","1783","6464","6460",大昌-新店,0,20,20,-1,6.54
"20200406","1783","6167","6160",中國信託-松江,12,0,12,1,3.92
"20200406","1783","9324","9300",華南永昌-岡山,0,20,20,-1,6.54
"20200406","1783","5265","5260",美好-苗栗,10,0,10,1,3.27
"20200406","1783","1020","1020",合庫證券,0,14,14,-1,4.58
"20200406","1783","0037003700390065","7790",國票-南科,10,0,10,1,3.27
"20200406","1783","0039003800310053","9800",元大-崇德,0,11,11,-1,3.59
"20200406","1783","9138","9100",群益金鼎-中港,10,0,10,1,3.27
"20200406","1783","0035003300380057","5380",第一金-華江,0,10,10,-1,3.27
"20200406","1783","0039003100380041","9100",群益金鼎-中壢,10,0,10,1,3.27
"20200406","1783","8849","8840",玉山-景美,0,10,10,-1,3.27
"20200406","1783","9891","9800",元大-永和,10,0,10,1,3.27
"20200406","1783","8585","8580",聯邦-三重,0,8,8,-1,2.61
"20200406","1783","8882","8880",國泰-台中,7,0,7,1,2.29
"20200406","1783","0035003800350057","5850",統一-金門,0,5,5,-1,1.63
"20200406","1783","9672","9600",富邦-員林,13,6,7,1,2.29
"20200406","1783","8842","8840",玉山-新莊,0,5,5,-1,1.63
"20200406","1783","0035003300380049","5380",第一金-頭份,6,0,6,1,1.96
"20200406","1783","9238","9200",凱基-士林,0,5,5,-1,1.63
"20200406","1783","1560","1560",港商野村,6,0,6,1,1.96
"20200406","1783","003900360035004b","9600",富邦-台中,0,5,5,-1,1.63
"20200406","1783","1021","1020",合庫-台中,6,0,6,1,1.96
"20200406","1783","5323","5320",高橋-內壢,0,4,4,-1,1.31
"20200406","1783","9863","9800",元大-和平,6,0,6,1,1.96
"20200406","1783","1520","1520",瑞士信貸,7,11,4,-1,1.31
"20200407","1783","003900360035004b","9600",富邦-台中,30,0,30,1,9.74
"20200407","1783","003900360031004a","9600",富邦-興業,0,20,20,-1,6.49
"20200407","1783","6167","6160",中國信託-松江,22,0,22,1,7.14
"20200407","1783","0037003700390050","7790",國票-九鼎,0,15,15,-1,4.87
"20200407","1783","0031003100310042","1110",台灣企銀-建成,20,0,20,1,6.49
"20200407","1783","9206","9200",凱基-高雄,0,15,15,-1,4.87
"20200407","1783","0039003600320043","9600",富邦-東門,20,0,20,1,6.49
"20200407","1783","0039004100390037","9A00",永豐金-新竹,0,14,14,-1,4.55
"20200407","1783","9663","9600",富邦-敦南,20,0,20,1,6.49
"20200407","1783","1520","1520",瑞士信貸,0,13,13,-1,4.22
"20200407","1783","003900320031004d","9200",凱基-八德,15,0,15,1,4.87
"20200407","1783","0039003800310053","9800",元大-崇德,0,11,11,-1,3.57
"20200407","1783","0038003400350044","8450",康和-板橋,12,3,9,1,2.92
"20200407","1783","0039003100380041","9100",群益金鼎-中壢,0,10,10,-1,3.25
"20200407","1783","8150","8150",台新證券,7,0,7,1,2.27
"20200407","1783","1440","1440",美林,5,14,9,-1,2.92
"20200407","1783","0039003100330045","9100",群益金鼎-基隆,5,0,5,1,1.62
"20200407","1783","1041","1040",臺銀-鳳山,0,8,8,-1,2.60
"20200407","1783","9226","9200",凱基-汐止,5,0,5,1,1.62
"20200407","1783","0037003000300049","7000",兆豐-北高雄,0,8,8,-1,2.60
"20200407","1783","0031003000320043","1020",合庫-自強,3,0,3,1,0.97
"20200407","1783","6460","6460",大昌,0,7,7,-1,2.27
"20200407","1783","0035003800350057","5850",統一-金門,3,0,3,1,0.97
"20200407","1783","0039003800390041","9800",元大-北投,5,12,7,-1,2.27
"20200407","1783","8884","8880",國泰-台南,3,0,3,1,0.97
"20200407","1783","8560","8560",新光,2,8,6,-1,1.95
"20200407","1783","0039003200320048","9200",凱基-復興,3,0,3,1,0.97
"20200407","1783","003700370039004a","7790",國票-北高雄,0,5,5,-1,1.62
"20200408","1783","6162","6160",中國信託-忠孝,15,0,15,1,6.22
"20200408","1783","1520","1520",瑞士信貸,2,10,8,-1,3.32
"20200408","1783","003900380039004c","9800",元大-成功,32,18,14,1,5.81
"20200408","1783","0039003800390056","9800",元大-北三重,0,8,8,-1,3.32
"20200408","1783","0039003600320043","9600",富邦-東門,12,0,12,1,4.98
"20200408","1783","0035003300380049","5380",第一金-頭份,0,6,6,-1,2.49
"20200408","1783","1440","1440",美林,13,3,10,1,4.15
"20200408","1783","9835","9800",元大-員林中山,0,6,6,-1,2.49
"20200408","1783","6167","6160",中國信託-松江,10,0,10,1,4.15
"20200408","1783","9859","9800",元大-新竹經國,0,6,6,-1,2.49
"20200408","1783","9325","9300",華南永昌-忠孝,10,0,10,1,4.15
"20200408","1783","1020","1020",合庫證券,0,5,5,-1,2.07
"20200408","1783","0038003100350041","8150",台新-高雄,7,0,7,1,2.90
"20200408","1783","0035003800350067","5850",統一-平鎮,0,5,5,-1,2.07
"20200408","1783","0039004100390053","9A00",永豐金-南京,6,0,6,1,2.49
"20200408","1783","6461","6460",大昌-樹林,2,7,5,-1,2.07
"20200408","1783","9672","9600",富邦-員林,10,5,5,1,2.07
"20200408","1783","6912","6910",德信-中正,0,5,5,-1,2.07
"20200408","1783","0031003200360069","1260",宏遠-光隆,5,0,5,1,2.07
"20200408","1783","6950","6950",福勝,0,5,5,-1,2.07
"20200408","1783","9349","9300",華南永昌-板橋,5,0,5,1,2.07
"20200408","1783","7032","7030",致和-佳里,0,5,5,-1,2.07
"20200408","1783","9303","9300",華南永昌-高雄,5,1,4,1,1.66
"20200408","1783","0039003100330045","9100",群益金鼎-基隆,0,5,5,-1,2.07
"20200408","1783","0035003900320047","5920",元富-新竹,4,0,4,1,1.66
"20200408","1783","5267","5260",美好-基隆,0,4,4,-1,1.66
"20200408","1783","1115","1110",台灣企銀-太平,3,0,3,1,1.24
"20200408","1783","9894","9800",元大-桃興,0,4,4,-1,1.66
"20200409","1783","0039003600320043","9600",富邦-東門,15,0,15,1,6.17
"20200409","1783","0039003100380044","9100",群益金鼎-東門,0,14,14,-1,5.76
"20200409","1783","0037003000300056","7000",兆豐-新竹,11,0,11,1,4.53
"20200409","1783","9211","9200",凱基-台南,0,12,12,-1,4.94
"20200409","1783","0038003800380041","8880",國泰-館前,10,0,10,1,4.12
"20200409","1783","1440","1440",美林,7,18,11,-1,4.53
"20200409","1783","0039003600320056","9600",富邦-復興,10,0,10,1,4.12
"20200409","1783","9815","9800",元大-大灣,0,11,11,-1,4.53
"20200409","1783","6167","6160",中國信託-松江,8,0,8,1,3.29
"20200409","1783","9208","9200",凱基-桃園,0,10,10,-1,4.12
"20200409","1783","5320","5320",高橋,6,0,6,1,2.47
"20200409","1783","8843","8840",玉山-高雄,0,8,8,-1,3.29
"20200409","1783","0031003100310042","1110",台灣企銀-建成,6,0,6,1,2.47
"20200409","1783","1520","1520",瑞士信貸,1,8,7,-1,2.88
"20200409","1783","9893","9800",元大-大天母,6,0,6,1,2.47
"20200409","1783","8156","8150",台新-三民,1,7,6,-1,2.47
"20200409","1783","1118","1110",台灣企銀-豐原,5,0,5,1,2.06
"20200409","1783","8560","8560",新光,2,8,6,-1,2.47
"20200409","1783","7798","7790",國票-內壢,5,0,5,1,2.06
"20200409","1783","8150","8150",台新證券,0,5,5,-1,2.06
"20200409","1783","003700370039004a","7790",國票-北高雄,5,0,5,1,2.06
"20200409","1783","9343","9300",華南永昌-頭份,0,5,5,-1,2.06
"20200409","1783","0038003400350041","8450",康和-內湖,5,0,5,1,2.06
"20200409","1783","9672","9600",富邦-員林,0,5,5,-1,2.06
"20200409","1783","9875","9800",元大-土城永寧,4,0,4,1,1.65
"20200409","1783","0039003100380073","9100",群益金鼎-丹鳳,0,4,4,-1,1.65
"20200409","1783","5323","5320",高橋-內壢,4,1,3,1,1.23
"20200409","1783","0039003800350043","9800",元大-鳳中,0,4,4,-1,1.65
"20200410","1783","8382","8380",安泰-楠梓,51,0,51,1,12.09
"20200410","1783","9325","9300",華南永昌-忠孝,0,25,25,-1,5.92
"20200410","1783","1440","1440",美林,30,7,23,1,5.45
"20200410","1783","0039003100330044","9100",群益金鼎-潭子,0,20,20,-1,4.74
"20200410","1783","003900360035004b","9600",富邦-台中,20,1,19,1,4.50
"20200410","1783","0039003200300044","9200",凱基-市府,0,20,20,-1,4.74
"20200410","1783","8440","8440",摩根大通,15,0,15,1,3.55
"20200410","1783","9206","9200",凱基-高雄,0,13,13,-1,3.08
"20200410","1783","0039003800320042","9800",元大-博愛,15,0,15,1,3.55
"20200410","1783","9366","9300",華南永昌-豐原,0,13,13,-1,3.08
"20200410","1783","0039003200300057","9200",凱基-大里,13,0,13,1,3.08
"20200410","1783","0038003800380041","8880",國泰-館前,0,10,10,-1,2.37
"20200410","1783","0035003900320044","5920",元富-大昌,12,1,11,1,2.61
"20200410","1783","5265","5260",美好-苗栗,0,7,7,-1,1.66
"20200410","1783","0037003000300056","7000",兆豐-新竹,10,0,10,1,2.37
"20200410","1783","5320","5320",高橋,0,7,7,-1,1.66
"20200410","1783","9208","9200",凱基-桃園,10,0,10,1,2.37
"20200410","1783","9859","9800",元大-新竹經國,3,10,7,-1,1.66
"20200410","1783","8840","8840",玉山證券,9,0,9,1,2.13
"20200410","1783","9303","9300",華南永昌-高雄,0,7,7,-1,1.66
"20200410","1783","0031003100310042","1110",台灣企銀-建成,6,0,6,1,1.42
"20200410","1783","5323","5320",高橋-內壢,3,9,6,-1,1.42
"20200410","1783","0035003900320065","5920",元富-古亭,6,0,6,1,1.42
"20200410","1783","0039003200300046","9200",凱基-站前,0,6,6,-1,1.42
"20200410","1783","0039003800310046","9800",元大-福營,6,0,6,1,1.42
"20200410","1783","1118","1110",台灣企銀-豐原,0,5,5,-1,1.18
"20200410","1783","1023","1020",合庫-高雄,5,0,5,1,1.18
"20200410","1783","5962","5960",日茂-南投,0,5,5,-1,1.18
"20200413","1783","0039003600320056","9600",富邦-復興,27,0,27,1,5.30
"20200413","1783","1520","1520",瑞士信貸,0,34,34,-1,6.68
"20200413","1783","9875","9800",元大-土城永寧,17,1,16,1,3.14
"20200413","1783","1440","1440",美林,16,45,29,-1,5.70
"20200413","1783","0039003600320043","9600",富邦-東門,15,0,15,1,2.95
"20200413","1783","1650","1650",新加坡商瑞銀,0,20,20,-1,3.93
"20200413","1783","003900320031004d","9200",凱基-八德,13,0,13,1,2.55
"20200413","1783","9333","9300",華南永昌-長虹,0,20,20,-1,3.93
"20200413","1783","9622","9600",富邦-園區(停),12,0,12,1,2.36
"20200413","1783","9663","9600",富邦-敦南,0,20,20,-1,3.93
"20200413","1783","1041","1040",臺銀-鳳山,11,0,11,1,2.16
"20200413","1783","003900310038004d","9100",群益金鼎-嘉義,0,11,11,-1,2.16
"20200413","1783","9366","9300",華南永昌-豐原,11,0,11,1,2.16
"20200413","1783","8564","8560",新光-台南,0,10,10,-1,1.96
"20200413","1783","0031003100310045","1110",台灣企銀-桃園,10,0,10,1,1.96
"20200413","1783","9138","9100",群益金鼎-中港,0,10,10,-1,1.96
"20200413","1783","0035003800350042","5850",統一-永和,10,0,10,1,1.96
"20200413","1783","1560","1560",港商野村,0,8,8,-1,1.57
"20200413","1783","8847","8840",玉山-台南,10,0,10,1,1.96
"20200413","1783","8440","8440",摩根大通,0,7,7,-1,1.38
"20200413","1783","0039003100380044","9100",群益金鼎-東門,10,0,10,1,1.96
"20200413","1783","0039003800350043","9800",元大-鳳中,0,6,6,-1,1.18
"20200413","1783","9312","9300",華南永昌-民權,10,0,10,1,1.96
"20200413","1783","1023","1020",合庫-高雄,0,5,5,-1,0.98
"20200413","1783","8380","8380",安泰,10,1,9,1,1.77
"20200413","1783","0035003900320065","5920",元富-古亭,0,5,5,-1,0.98
"20200413","1783","9898","9800",元大-新莊,9,1,8,1,1.57
"20200413","1783","003500390032007a","5920",元富-文心,0,5,5,-1,0.98
"20200414","1783","0037003000300056","7000",兆豐-新竹,170,0,170,1,20.07
"20200414","1783","9324","9300",華南永昌-岡山,0,40,40,-1,4.72
"20200414","1783","5850","5850",統一,66,0,66,1,7.79
"20200414","1783","9315","9300",華南永昌-苑裡,0,24,24,-1,2.83
"20200414","1783","6167","6160",中國信託-松江,21,0,21,1,2.48
"20200414","1783","9217","9200",凱基-松山,0,23,23,-1,2.72
"20200414","1783","8380","8380",安泰,20,0,20,1,2.36
"20200414","1783","9333","9300",華南永昌-長虹,0,20,20,-1,2.36
"20200414","1783","1440","1440",美林,34,15,19,1,2.24
"20200414","1783","9623","9600",富邦-台北,4,22,18,-1,2.13
"20200414","1783","003900320031004d","9200",凱基-八德,16,0,16,1,1.89
"20200414","1783","9859","9800",元大-新竹經國,5,21,16,-1,1.89
"20200414","1783","0037003000300045","7000",兆豐-斗南(停),15,0,15,1,1.77
"20200414","1783","003500390032007a","5920",元富-文心,0,15,15,-1,1.77
"20200414","1783","003600310036004b","6160",中國信託-高雄,11,0,11,1,1.30
"20200414","1783","003700300030004d","7000",兆豐-桃園,0,15,15,-1,1.77
"20200414","1783","9692","9600",富邦-嘉義,10,0,10,1,1.18
"20200414","1783","003700370039004a","7790",國票-北高雄,0,14,14,-1,1.65
"20200414","1783","0031003100310042","1110",台灣企銀-建成,8,0,8,1,0.94
"20200414","1783","003900380039006b","9800",元大-古亭,0,12,12,-1,1.42
"20200414","1783","0039003100380043","9100",群益金鼎-古亭,7,1,6,1,0.71
"20200414","1783","0035003800350042","5850",統一-永和,0,10,10,-1,1.18
"20200414","1783","0038003100350041","8150",台新-高雄,5,0,5,1,0.59
"20200414","1783","0035003900320055","5920",元富-宜蘭,0,10,10,-1,1.18
"20200414","1783","6452","6450",永全-八德,5,0,5,1,0.59
"20200414","1783","9238","9200",凱基-士林,0,10,10,-1,1.18
"20200414","1783","003700300030004a","7000",兆豐-公益,5,0,5,1,0.59
"20200414","1783","9312","9300",華南永昌-民權,0,10,10,-1,1.18
"20200415","1783","9663","9600",富邦-敦南,20,0,20,1,2.51
"20200415","1783","0039004100300030","9A00",永豐金證券,2,52,50,-1,6.27
"20200415","1783","0039003600310059","9600",富邦-屏東,13,0,13,1,1.63
"20200415","1783","1440","1440",美林,3,47,44,-1,5.51
"20200415","1783","0031003100310042","1110",台灣企銀-建成,12,0,12,1,1.50
"20200415","1783","1520","1520",瑞士信貸,0,40,40,-1,5.01
"20200415","1783","003900380039006b","9800",元大-古亭,14,2,12,1,1.50
"20200415","1783","0039004100390066","9A00",永豐金-中盛,0,32,32,-1,4.01
"20200415","1783","9189","9100",群益金鼎-桃園,11,0,11,1,1.38
"20200415","1783","9667","9600",富邦-台南,6,29,23,-1,2.88
"20200415","1783","9349","9300",華南永昌-板橋,13,2,11,1,1.38
"20200415","1783","9647","9600",富邦-新竹,0,16,16,-1,2.01
"20200415","1783","003900360031005a","9600",富邦-永康,11,0,11,1,1.38
"20200415","1783","9875","9800",元大-土城永寧,3,18,15,-1,1.88
"20200415","1783","1020","1020",合庫證券,10,0,10,1,1.25
"20200415","1783","0035003900320047","5920",元富-新竹,0,13,13,-1,1.63
"20200415","1783","0031003100310045","1110",台灣企銀-桃園,10,0,10,1,1.25
"20200415","1783","0039003200300057","9200",凱基-大里,0,12,12,-1,1.50
"20200415","1783","5381","5380",第一金-員林,10,0,10,1,1.25
"20200415","1783","9217","9200",凱基-松山,1,10,9,-1,1.13
"20200415","1783","0035003900320049","5920",元富-嘉義,10,0,10,1,1.25
"20200415","1783","9837","9800",元大-北港,0,9,9,-1,1.13
"20200415","1783","0035003900320072","5920",元富-城東,10,0,10,1,1.25
"20200415","1783","8440","8440",摩根大通,0,8,8,-1,1.00
"20200415","1783","7034","7030",致和-金華,10,0,10,1,1.25
"20200415","1783","9333","9300",華南永昌-長虹,2,10,8,-1,1.00
"20200415","1783","8847","8840",玉山-台南,11,1,10,1,1.25
"20200415","1783","9366","9300",華南永昌-豐原,3,11,8,-1,1.00
"20200416","1783","5853","5850",統一-中壢,19,0,19,1,5.94
"20200416","1783","9211","9200",凱基-台南,0,12,12,-1,3.75
"20200416","1783","0039003600310045","9600",富邦-府城,15,0,15,1,4.69
"20200416","1783","003600310036004b","6160",中國信託-高雄,0,10,10,-1,3.13
"20200416","1783","0039003800310044","9800",元大-南投,15,0,15,1,4.69
"20200416","1783","7034","7030",致和-金華,0,10,10,-1,3.13
"20200416","1783","9366","9300",華南永昌-豐原,11,0,11,1,3.44
"20200416","1783","9103","9100",群益金鼎-松山,0,10,10,-1,3.13
"20200416","1783","8158","8150",台新-松江,10,0,10,1,3.13
"20200416","1783","9138","9100",群益金鼎-中港,0,10,10,-1,3.13
"20200416","1783","0039003100380041","9100",群益金鼎-中壢,10,0,10,1,3.13
"20200416","1783","0039003100380044","9100",群益金鼎-東門,0,10,10,-1,3.13
"20200416","1783","0031003100310042","1110",台灣企銀-建成,9,0,9,1,2.81
"20200416","1783","9326","9300",華南永昌-南京,0,10,10,-1,3.13
"20200416","1783","1021","1020",合庫-台中,9,0,9,1,2.81
"20200416","1783","9816","9800",元大-新竹,0,10,10,-1,3.13
"20200416","1783","5927","5920",元富-林園,8,0,8,1,2.50
"20200416","1783","003900410039004d","9A00",永豐金-南投,0,9,9,-1,2.81
"20200416","1783","7798","7790",國票-內壢,7,0,7,1,2.19
"20200416","1783","9859","9800",元大-新竹經國,0,6,6,-1,1.88
"20200416","1783","1043","1040",臺銀-民權,6,0,6,1,1.88
"20200416","1783","8560","8560",新光,0,6,6,-1,1.88
"20200416","1783","6461","6460",大昌-樹林,10,4,6,1,1.88
"20200416","1783","0037003700390065","7790",國票-南科,0,5,5,-1,1.56
"20200416","1783","0037003000300046","7000",兆豐-虎尾,7,1,6,1,1.88
"20200416","1783","0039003800350043","9800",元大-鳳中,0,5,5,-1,1.56
"20200416","1783","0039004100390078","9A00",永豐金-桃園,6,0,6,1,1.88
"20200416","1783","5323","5320",高橋-內壢,1,5,4,-1,1.25
"20200417","1783","5853","5850",統一-中壢,25,0,25,1,7.35
"20200417","1783","1520","1520",瑞士信貸,0,26,26,-1,7.65
"20200417","1783","9692","9600",富邦-嘉義,18,1,17,1,5.00
"20200417","1783","9238","9200",凱基-士林,0,25,25,-1,7.35
"20200417","1783","8710","8710",陽信,15,0,15,1,4.41
"20200417","1783","0039003800310044","9800",元大-南投,0,15,15,-1,4.41
"20200417","1783","0031003100310042","1110",台灣企銀-建成,12,0,12,1,3.53
"20200417","1783","0039003800310046","9800",元大-福營,1,14,13,-1,3.82
"20200417","1783","003900380031004e","9800",元大-金門,10,0,10,1,2.94
"20200417","1783","9366","9300",華南永昌-豐原,0,11,11,-1,3.24
"20200417","1783","9623","9600",富邦-台北,9,0,9,1,2.65
"20200417","1783","003500380035005a","5850",統一-松江,0,10,10,-1,2.94
"20200417","1783","5386","5380",第一金-彰化,9,1,8,1,2.35
"20200417","1783","9315","9300",華南永昌-苑裡,0,10,10,-1,2.94
"20200417","1783","8884","8880",國泰-台南,6,0,6,1,1.76
"20200417","1783","5927","5920",元富-林園,0,8,8,-1,2.35
"20200417","1783","0039003800390044","9800",元大-左營,6,0,6,1,1.76
"20200417","1783","8560","8560",新光,0,8,8,-1,2.35
"20200417","1783","7005","7000",兆豐-台中港,5,0,5,1,1.47
"20200417","1783","6461","6460",大昌-樹林,0,6,6,-1,1.76
"20200417","1783","5262","5260",美好-楊梅,5,0,5,1,1.47
"20200417","1783","9654","9600",富邦-永和,0,6,6,-1,1.76
"20200417","1783","6160","6160",中國信託,5,0,5,1,1.47
"20200417","1783","0031003200360069","1260",宏遠-光隆,0,5,5,-1,1.47
"20200417","1783","7798","7790",國票-內壢,5,0,5,1,1.47
"20200417","1783","0039003100380041","9100",群益金鼎-中壢,5,10,5,-1,1.47
"20200417","1783","9233","9200",凱基-長庚,5,0,5,1,1.47
"20200417","1783","9308","9300",華南永昌-麻豆,0,5,5,-1,1.47
"20200420","1783","5853","5850",統一-中壢,44,10,34,1,3.51
"20200420","1783","9692","9600",富邦-嘉義,10,40,30,-1,3.09
"20200420","1783","0035003900320045","5920",元富-城中,28,0,28,1,2.89
"20200420","1783","003900380039006b","9800",元大-古亭,4,26,22,-1,2.27
"20200420","1783","9300","9300",華南永昌,27,1,26,1,2.68
"20200420","1783","8490","8490",京城,0,20,20,-1,2.06
"20200420","1783","003900320031004d","9200",凱基-八德,25,0,25,1,2.58
"20200420","1783","9333","9300",華南永昌-長虹,0,20,20,-1,2.06
"20200420","1783","9103","9100",群益金鼎-松山,40,20,20,1,2.06
"20200420","1783","9349","9300",華南永昌-板橋,0,15,15,-1,1.55
"20200420","1783","0039003600310048","9600",富邦-新板,20,1,19,1,1.96
"20200420","1783","5386","5380",第一金-彰化,20,32,12,-1,1.24
"20200420","1783","1033","1030",土銀-高雄,15,0,15,1,1.55
"20200420","1783","003900310038004d","9100",群益金鼎-嘉義,0,12,12,-1,1.24
"20200420","1783","5385","5380",第一金-桃園,15,0,15,1,1.55
"20200420","1783","1041","1040",臺銀-鳳山,0,11,11,-1,1.13
"20200420","1783","003900310038007a","9100",群益金鼎-宜蘭,15,0,15,1,1.55
"20200420","1783","6160","6160",中國信託,0,11,11,-1,1.13
"20200420","1783","5112","5110",富隆-長安(停),14,0,14,1,1.44
"20200420","1783","003700370039004a","7790",國票-北高雄,0,11,11,-1,1.13
"20200420","1783","9672","9600",富邦-員林,12,0,12,1,1.24
"20200420","1783","8847","8840",玉山-台南,3,14,11,-1,1.13
"20200420","1783","0035003900320063","5920",元富-烏日,10,0,10,1,1.03
"20200420","1783","0039004100390037","9A00",永豐金-新竹,0,11,11,-1,1.13
"20200420","1783","9308","9300",華南永昌-麻豆,10,0,10,1,1.03
"20200420","1783","1020","1020",合庫證券,0,10,10,-1,1.03
"20200420","1783","9366","9300",華南永昌-豐原,10,0,10,1,1.03
"20200420","1783","0035003300380041","5380",第一金-新興,0,10,10,-1,1.03
"20200421","1783","003900380039006b","9800",元大-古亭,18,0,18,1,3.11
"20200421","1783","1520","1520",瑞士信貸,0,41,41,-1,7.09
"20200421","1783","5853","5850",統一-中壢,15,0,15,1,2.60
"20200421","1783","0037003000300071","7000",兆豐-內湖,0,30,30,-1,5.19
"20200421","1783","0039003800310046","9800",元大-福營,14,0,14,1,2.42
"20200421","1783","9300","9300",華南永昌,1,27,26,-1,4.50
"20200421","1783","9205","9200",凱基-三重,12,0,12,1,2.08
"20200421","1783","0039004100390078","9A00",永豐金-桃園,0,23,23,-1,3.98
"20200421","1783","9349","9300",華南永昌-板橋,12,0,12,1,2.08
"20200421","1783","9103","9100",群益金鼎-松山,0,20,20,-1,3.46
"20200421","1783","0031003100310045","1110",台灣企銀-桃園,10,0,10,1,1.73
"20200421","1783","0039003600310048","9600",富邦-新板,1,21,20,-1,3.46
"20200421","1783","0037003000300047","7000",兆豐-麻豆,10,0,10,1,1.73
"20200421","1783","9266","9200",凱基-新豐,1,16,15,-1,2.60
"20200421","1783","9835","9800",元大-員林中山,10,0,10,1,1.73
"20200421","1783","8440","8440",摩根大通,0,14,14,-1,2.42
"20200421","1783","0031003200360055","1260",宏遠-館前,11,3,8,1,1.38
"20200421","1783","0038003400350044","8450",康和-板橋,8,22,14,-1,2.42
"20200421","1783","0039003800310069","9800",元大-西螺,8,0,8,1,1.38
"20200421","1783","0039003800300051","9800",元大-南崁,0,10,10,-1,1.73
"20200421","1783","0039003800370041","9800",元大-楊梅,8,0,8,1,1.38
"20200421","1783","6950","6950",福勝,0,10,10,-1,1.73
"20200421","1783","0031003100310042","1110",台灣企銀-建成,7,0,7,1,1.21
"20200421","1783","8710","8710",陽信,0,10,10,-1,1.73
"20200421","1783","6383","6380",光和-和美,7,0,7,1,1.21
"20200421","1783","0039004100390066","9A00",永豐金-中盛,0,10,10,-1,1.73
"20200421","1783","0039004100390068","9A00",永豐金-台南,7,0,7,1,1.21
"20200421","1783","1020","1020",合庫證券,0,7,7,-1,1.21
"20200422","1783","0039003600320043","9600",富邦-東門,30,0,30,1,6.91
"20200422","1783","003900380039004c","9800",元大-成功,0,33,33,-1,7.60
"20200422","1783","0037003000300056","7000",兆豐-新竹,24,0,24,1,5.53
"20200422","1783","9315","9300",華南永昌-苑裡,30,60,30,-1,6.91
"20200422","1783","1440","1440",美林,27,4,23,1,5.30
"20200422","1783","9672","9600",富邦-員林,0,30,30,-1,6.91
"20200422","1783","0031003200360055","1260",宏遠-館前,35,18,17,1,3.92
"20200422","1783","5320","5320",高橋,0,24,24,-1,5.53
"20200422","1783","1520","1520",瑞士信貸,17,2,15,1,3.46
"20200422","1783","5385","5380",第一金-桃園,0,15,15,-1,3.46
"20200422","1783","0031003100310042","1110",台灣企銀-建成,11,0,11,1,2.53
"20200422","1783","9206","9200",凱基-高雄,0,11,11,-1,2.53
"20200422","1783","8440","8440",摩根大通,11,0,11,1,2.53
"20200422","1783","9322","9300",華南永昌-公誠,1,12,11,-1,2.53
"20200422","1783","1041","1040",臺銀-鳳山,10,0,10,1,2.30
"20200422","1783","8380","8380",安泰,0,10,10,-1,2.30
"20200422","1783","6167","6160",中國信託-松江,10,0,10,1,2.30
"20200422","1783","0038003800340043","8840",玉山-南京東路,0,10,10,-1,2.30
"20200422","1783","7798","7790",國票-內壢,9,0,9,1,2.07
"20200422","1783","0039003200300046","9200",凱基-站前,2,7,5,-1,1.15
"20200422","1783","0039004100390068","9A00",永豐金-台南,9,1,8,1,1.84
"20200422","1783","9829","9800",元大-永康,0,4,4,-1,0.92
"20200422","1783","6464","6460",大昌-新店,6,0,6,1,1.38
"20200422","1783","9874","9800",元大-雙和,1,5,4,-1,0.92
"20200422","1783","0039003200300057","9200",凱基-大里,6,0,6,1,1.38
"20200422","1783","1020","1020",合庫證券,0,3,3,-1,0.69
"20200422","1783","1560","1560",港商野村,10,5,5,1,1.15
"20200422","1783","0035003800350046","5850",統一-彰化,0,3,3,-1,0.69
"20200423","1783","5853","5850",統一-中壢,10,0,10,1,3.95
"20200423","1783","0035003900320044","5920",元富-大昌,0,11,11,-1,4.35
"20200423","1783","7750","7750",北城證券,10,0,10,1,3.95
"20200423","1783","1041","1040",臺銀-鳳山,0,10,10,-1,3.95
"20200423","1783","9657","9600",富邦-苗栗,10,0,10,1,3.95
"20200423","1783","9138","9100",群益金鼎-中港,0,10,10,-1,3.95
"20200423","1783","9692","9600",富邦-嘉義,12,2,10,1,3.95
"20200423","1783","9205","9200",凱基-三重,0,7,7,-1,2.77
"20200423","1783","1520","1520",瑞士信貸,11,4,7,1,2.77
"20200423","1783","0039003800350043","9800",元大-鳳中,0,7,7,-1,2.77
"20200423","1783","0031003000320043","1020",合庫-自強,7,0,7,1,2.77
"20200423","1783","9898","9800",元大-新莊,5,12,7,-1,2.77
"20200423","1783","9366","9300",華南永昌-豐原,6,0,6,1,2.37
"20200423","1783","1021","1020",合庫-台中,0,5,5,-1,1.98
"20200423","1783","5323","5320",高橋-內壢,6,1,5,1,1.98
"20200423","1783","003900310038007a","9100",群益金鼎-宜蘭,0,5,5,-1,1.98
"20200423","1783","6381","6380",光和-溪湖,5,0,5,1,1.98
"20200423","1783","0039003800390043","9800",元大-板橋,0,5,5,-1,1.98
"20200423","1783","9105","9100",群益金鼎-高盛,5,0,5,1,1.98
"20200423","1783","5386","5380",第一金-彰化,2,6,4,-1,1.58
"20200423","1783","9302","9300",華南永昌-台中,5,0,5,1,1.98
"20200423","1783","0039003800320043","9800",元大-六合,0,4,4,-1,1.58
"20200423","1783","0039003800390056","9800",元大-北三重,5,0,5,1,1.98
"20200423","1783","0039004100360031","9A00",永豐金-鳳山,0,4,4,-1,1.58
"20200423","1783","0039003200300057","9200",凱基-大里,4,0,4,1,1.58
"20200423","1783","9667","9600",富邦-台南,2,6,4,-1,1.58
"20200423","1783","9306","9300",華南永昌-台南,5,1,4,1,1.58
"20200423","1783","1440","1440",美林,17,20,3,-1,1.19
"20200424","1783","003900380031006a","9800",元大-士林,1,30,29,-1,3.03
"20200424","1783","1260","1260",宏遠證券,26,3,23,1,2.40
"20200424","1783","9835","9800",元大-員林中山,0,21,21,-1,2.19
"20200424","1783","1440","1440",美林,51,31,20,1,2.09
"20200424","1783","9324","9300",華南永昌-岡山,5,24,19,-1,1.99
"20200424","1783","9208","9200",凱基-桃園,25,7,18,1,1.88
"20200424","1783","0039003600310045","9600",富邦-府城,0,17,17,-1,1.78
"20200424","1783","8560","8560",新光,19,4,15,1,1.57
"20200424","1783","9898","9800",元大-新莊,8,20,12,-1,1.25
"20200424","1783","9283","9200",凱基-北門,15,0,15,1,1.57
"20200424","1783","8847","8840",玉山-台南,1,12,11,-1,1.15
"20200424","1783","003900380031005a","9800",元大-潮州,15,0,15,1,1.57
"20200424","1783","0035003900320055","5920",元富-宜蘭,0,10,10,-1,1.04
"20200424","1783","9834","9800",元大-中壢,15,0,15,1,1.57
"20200424","1783","0039003800390064","9800",元大-北屯,0,10,10,-1,1.04
"20200424","1783","0039003800310047","9800",元大-彰化,14,0,14,1,1.46
"20200424","1783","5112","5110",富隆-長安(停),0,9,9,-1,0.94
"20200424","1783","003900380033006a","9800",元大-仁愛,14,0,14,1,1.46
"20200424","1783","0035003300380042","5380",第一金-新竹,1,10,9,-1,0.94
"20200424","1783","2180","2180",亞東,11,0,11,1,1.15
"20200424","1783","003700370039004a","7790",國票-北高雄,0,9,9,-1,0.94
"20200424","1783","0039003100380044","9100",群益金鼎-東門,12,1,11,1,1.15
"20200424","1783","0039003800390043","9800",元大-板橋,0,9,9,-1,0.94
"20200424","1783","003900380039004a","9800",元大-彰化民生,10,0,10,1,1.04
"20200424","1783","8440","8440",摩根大通,0,8,8,-1,0.84
"20200424","1783","0031003200360055","1260",宏遠-館前,24,15,9,1,0.94
"20200424","1783","9306","9300",華南永昌-台南,0,7,7,-1,0.73
"20200427","1783","0036003000310064","6010",(牛牛牛)亞-鑫豐,30,4,26,1,2.58
"20200427","1783","9324","9300",華南永昌-岡山,1,21,20,-1,1.99
"20200427","1783","0038003800340048","8840",玉山-新竹,26,0,26,1,2.58
"20200427","1783","0039003200320048","9200",凱基-復興,0,19,19,-1,1.89
"20200427","1783","0035003800350044","5850",統一-新台中,20,0,20,1,1.99
"20200427","1783","5386","5380",第一金-彰化,0,17,17,-1,1.69
"20200427","1783","0039004100390062","9A00",永豐金-虎尾,20,0,20,1,1.99
"20200427","1783","0035003900320072","5920",元富-城東,1,15,14,-1,1.39
"20200427","1783","9359","9300",華南永昌-中正,16,0,16,1,1.59
"20200427","1783","0039003800310047","9800",元大-彰化,1,14,13,-1,1.29
"20200427","1783","1260","1260",宏遠證券,16,0,16,1,1.59
"20200427","1783","0037003700390045","7790",國票-南崁,0,12,12,-1,1.19
"20200427","1783","0039003800390059","9800",元大-基隆,16,0,16,1,1.59
"20200427","1783","5112","5110",富隆-長安(停),0,11,11,-1,1.09
"20200427","1783","0035003800350045","5850",統一-新營,15,0,15,1,1.49
"20200427","1783","9838","9800",元大-豐原,15,0,15,1,1.49
"20200427","1783","2180","2180",亞東,1,11,10,-1,0.99
"20200427","1783","0039003600310052","9600",富邦-南員林,13,0,13,1,1.29
"20200427","1783","0035003900320055","5920",元富-宜蘭,0,10,10,-1,0.99
"20200427","1783","8882","8880",國泰-台中,13,1,12,1,1.19
"20200427","1783","9349","9300",華南永昌-板橋,0,10,10,-1,0.99
"20200427","1783","8561","8560",新光-台中,12,1,11,1,1.09
"20200427","1783","003900410039004e","9A00",永豐金-桃盛,0,10,10,-1,0.99
"20200427","1783","0039003200300057","9200",凱基-大里,11,0,11,1,1.09
"20200427","1783","0039003100330044","9100",群益金鼎-潭子,1,10,9,-1,0.89
"20200427","1783","0038003100350041","8150",台新-高雄,12,2,10,1,0.99
"20200427","1783","9853","9800",元大-南屯,1,10,9,-1,0.89
"20200428","1783","0038003800340048","8840",玉山-新竹,24,0,24,1,3.33
"20200428","1783","0039003100380047","9100",群益金鼎-新莊,1,34,33,-1,4.58
"20200428","1783","0038003800340044","8840",玉山-左營,20,0,20,1,2.77
"20200428","1783","1440","1440",美林,11,39,28,-1,3.88
"20200428","1783","9813","9800",元大-八德,20,0,20,1,2.77
"20200428","1783","0037003000300070","7000",兆豐-復興,0,20,20,-1,2.77
"20200428","1783","9302","9300",華南永昌-台中,16,0,16,1,2.22
"20200428","1783","0039004100390062","9A00",永豐金-虎尾,0,20,20,-1,2.77
"20200428","1783","0035003800350044","5850",統一-新台中,13,1,12,1,1.66
"20200428","1783","1560","1560",港商野村,4,22,18,-1,2.50
"20200428","1783","9211","9200",凱基-台南,12,0,12,1,1.66
"20200428","1783","003900410039004d","9A00",永豐金-南投,0,18,18,-1,2.50
"20200428","1783","7798","7790",國票-內壢,21,10,11,1,1.53
"20200428","1783","0035003900320049","5920",元富-嘉義,10,0,10,1,1.39
"20200428","1783","0037003000300043","7000",兆豐-來福,0,11,11,-1,1.53
"20200428","1783","7791","7790",國票-台東,10,0,10,1,1.39
"20200428","1783","9308","9300",華南永昌-麻豆,0,10,10,-1,1.39
"20200428","1783","0039003200300057","9200",凱基-大里,10,0,10,1,1.39
"20200428","1783","9366","9300",華南永昌-豐原,0,10,10,-1,1.39
"20200428","1783","9352","9300",華南永昌-桃園,10,0,10,1,1.39
"20200428","1783","0031003000320043","1020",合庫-自強,0,9,9,-1,1.25
"20200428","1783","0039003800300064","9800",元大-沙鹿,10,0,10,1,1.39
"20200428","1783","0039003800390061","9800",元大-苑裡,0,9,9,-1,1.25
"20200428","1783","9207","9200",凱基-永和,10,1,9,1,1.25
"20200428","1783","1520","1520",瑞士信貸,0,8,8,-1,1.11
"20200428","1783","9623","9600",富邦-台北,10,1,9,1,1.25
"20200428","1783","0039003600310057","9600",富邦-東花蓮,0,7,7,-1,0.97
"20200429","1783","9255","9200",凱基-和平,70,0,70,1,4.09
"20200429","1783","0039003800390059","9800",元大-基隆,2,37,35,-1,2.05
"20200429","1783","0035003900320072","5920",元富-城東,65,4,61,1,3.57
"20200429","1783","9813","9800",元大-八德,0,30,30,-1,1.75
"20200429","1783","9616","9600",富邦-岡山,51,0,51,1,2.98
"20200429","1783","9317","9300",華南永昌-林口,0,28,28,-1,1.64
"20200429","1783","0038003800340041","8840",玉山-士林,50,1,49,1,2.86
"20200429","1783","5385","5380",第一金-桃園,0,20,20,-1,1.17
"20200429","1783","1440","1440",美林,77,45,32,1,1.87
"20200429","1783","9105","9100",群益金鼎-高盛,0,20,20,-1,1.17
"20200429","1783","0031003000340041","1040",臺銀-臺中,36,6,30,1,1.75
"20200429","1783","0039003200300044","9200",凱基-市府,0,20,20,-1,1.17
"20200429","1783","0035003800350046","5850",統一-彰化,25,0,25,1,1.46
"20200429","1783","9663","9600",富邦-敦南,0,20,20,-1,1.17
"20200429","1783","0035003900320043","5920",元富-潮州,21,0,21,1,1.23
"20200429","1783","0039003800380043","9800",元大-三重,0,20,20,-1,1.17
"20200429","1783","7792","7790",國票-北投,30,10,20,1,1.17
"20200429","1783","9894","9800",元大-桃興,0,19,19,-1,1.11
"20200429","1783","8847","8840",玉山-台南,16,0,16,1,0.94
"20200429","1783","003900380039005a","9800",元大-小港,0,16,16,-1,0.94
"20200429","1783","9697","9600",富邦-虎尾,20,4,16,1,0.94
"20200429","1783","9308","9300",華南永昌-麻豆,0,15,15,-1,0.88
"20200429","1783","003900380031005a","9800",元大-潮州,16,0,16,1,0.94
"20200429","1783","0039004100390038","9A00",永豐金-大園,0,15,15,-1,0.88
"20200429","1783","8560","8560",新光,43,28,15,1,0.88
"20200429","1783","0035003300380042","5380",第一金-新竹,0,14,14,-1,0.82
"20200429","1783","5921","5920",元富-高雄,15,2,13,1,0.76
"20200429","1783","9834","9800",元大-中壢,1,15,14,-1,0.82
"20200430","1783","9215","9200",凱基-高美館,67,1,66,1,1.81
"20200430","1783","003900380034004b","9800",元大-館前,7,134,127,-1,3.49
"20200430","1783","9266","9200",凱基-新豐,59,1,58,1,1.59
"20200430","1783","9676","9600",富邦-仁愛,1,101,100,-1,2.74
"20200430","1783","9300","9300",華南永昌,74,23,51,1,1.40
"20200430","1783","9255","9200",凱基-和平,0,70,70,-1,1.92
"20200430","1783","0035003900320044","5920",元富-大昌,52,2,50,1,1.37
"20200430","1783","0035003800350048","5850",統一-桃園,4,72,68,-1,1.87
"20200430","1783","5853","5850",統一-中壢,46,4,42,1,1.15
"20200430","1783","0035003900320045","5920",元富-城中,1,59,58,-1,1.59
"20200430","1783","0039003600320048","9600",富邦-鳳山,61,19,42,1,1.15
"20200430","1783","9686","9600",富邦-宜蘭,4,60,56,-1,1.54
"20200430","1783","9892","9800",元大-屏東,37,0,37,1,1.02
"20200430","1783","9616","9600",富邦-岡山,0,51,51,-1,1.40
"20200430","1783","9899","9800",元大-淡水,38,1,37,1,1.02
"20200430","1783","0031003000330041","1030",土銀-建國,0,50,50,-1,1.37
"20200430","1783","0039003600320045","9600",富邦-樹林,31,0,31,1,0.85
"20200430","1783","0038003800340041","8840",玉山-士林,2,52,50,-1,1.37
"20200430","1783","0039004100390055","9A00",永豐金-中正,31,0,31,1,0.85
"20200430","1783","003900310033004e","9100",群益金鼎-土城,0,48,48,-1,1.32
"20200430","1783","0037003000300068","7000",兆豐-三民,36,6,30,1,0.82
"20200430","1783","9208","9200",凱基-桃園,7,50,43,-1,1.18
"20200430","1783","9329","9300",華南永昌-朴子,35,5,30,1,0.82
"20200430","1783","1440","1440",美林,50,87,37,-1,1.02
"20200430","1783","7001","7000",兆豐-嘉義,28,0,28,1,0.77
"20200430","1783","0031003000340041","1040",臺銀-臺中,1,36,35,-1,0.96
"20200430","1783","7795","7790",國票-南港,30,2,28,1,0.77
"20200430","1783","9697","9600",富邦-虎尾,3,38,35,-1,0.96
"20200302","1783","1440","1440",美林,33,0,33,1,14.41
"20200302","1783","0039003100330055","9100",群益金鼎-崇德,1,30,29,-1,12.66
"20200302","1783","8440","8440",摩根大通,30,0,30,1,13.10
"20200302","1783","0039003600310043","9600",富邦-南京,0,23,23,-1,10.04
"20200302","1783","9349","9300",華南永昌-板橋,10,0,10,1,4.37
"20200302","1783","0039003800390067","9800",元大-嘉義,0,20,20,-1,8.73
"20200302","1783","1021","1020",合庫-台中,7,0,7,1,3.06
"20200302","1783","1470","1470",台灣摩根士丹利,0,10,10,-1,4.37
"20200302","1783","5922","5920",元富-新店,5,0,5,1,2.18
"20200302","1783","0037003000300043","7000",兆豐-來福,0,10,10,-1,4.37
"20200302","1783","9894","9800",元大-桃興,5,0,5,1,2.18
"20200302","1783","8150","8150",台新證券,0,10,10,-1,4.37
"20200302","1783","0037003700390058","7790",國票-中和,4,0,4,1,1.75
"20200302","1783","9692","9600",富邦-嘉義,0,10,10,-1,4.37
"20200302","1783","0039003800300051","9800",元大-南崁,4,0,4,1,1.75
"20200302","1783","0039003100330049","9100",群益金鼎-萬華,0,8,8,-1,3.49
"20200302","1783","8880","8880",國泰證券,4,1,3,1,1.31
"20200302","1783","003900380039006d","9800",元大-信義,0,7,7,-1,3.06
"20200302","1783","8888","8880",國泰-敦南,4,1,3,1,1.31
"20200302","1783","0031003200360051","1260",宏遠-高雄,0,5,5,-1,2.18
"20200302","1783","9134","9100",群益金鼎-開元,3,0,3,1,1.31
"20200302","1783","0035003300380057","5380",第一金-華江,0,4,4,-1,1.75
"20200302","1783","003900320030004e","9200",凱基-湖口,3,0,3,1,1.31
"20200302","1783","0037003000300052","7000",兆豐-小港,0,4,4,-1,1.75
"20200302","1783","9233","9200",凱基-長庚,3,0,3,1,1.31
"20200302","1783","003800380038004b","8880",國泰-板橋,0,4,4,-1,1.75
"20200302","1783","0039003600310048","9600",富邦-新板,3,0,3,1,1.31
"20200302","1783","9665","9600",富邦-桃園,0,4,4,-1,1.75
"20200303","1783","0037003000300052","7000",兆豐-小港,5,0,5,1,6.76
"20200303","1783","0037003000300064","7000",兆豐-彰化,0,5,5,-1,6.76
"20200303","1783","9339","9300",華南永昌-竹北,5,0,5,1,6.76
"20200303","1783","0039003100330055","9100",群益金鼎-崇德,2,5,3,-1,4.05
"20200303","1783","003500390032006f","5920",元富-新興,3,0,3,1,4.05
"20200303","1783","9252","9200",凱基-嘉義,0,3,3,-1,4.05
"20200303","1783","0039003600320041","9600",富邦-信義,3,0,3,1,4.05
"20200303","1783","1480","1480",美商高盛,0,2,2,-1,2.70
"20200303","1783","0039003200300041","9200",凱基-板橋,2,0,2,1,2.70
"20200303","1783","1440","1440",美林,0,2,2,-1,2.70
"20200303","1783","0039003600320056","9600",富邦-復興,2,0,2,1,2.70
"20200303","1783","6950","6950",福勝,0,2,2,-1,2.70
"20200303","1783","9667","9600",富邦-台南,3,1,2,1,2.70
"20200303","1783","003700300030004e","7000",兆豐-埔墘,0,2,2,-1,2.70
"20200303","1783","0039003800390064","9800",元大-北屯,2,0,2,1,2.70
"20200303","1783","8880","8880",國泰證券,0,2,2,-1,2.70
"20200303","1783","1470","1470",台灣摩根士丹利,1,0,1,1,1.35
"20200303","1783","8883","8880",國泰-松江,0,2,2,-1,2.70
"20200303","1783","5927","5920",元富-林園,1,0,1,1,1.35
"20200303","1783","003900360031004c","9600",富邦-士林,0,2,2,-1,2.70
"20200303","1783","0035003900320071","5920",元富-屏東,1,0,1,1,1.35
"20200303","1783","0039003600310057","9600",富邦-東花蓮,0,2,2,-1,2.70
"20200303","1783","1033","1030",土銀-高雄,1,0,1,1,1.35
"20200303","1783","003500380035006d","5850",統一-竹南,0,1,1,-1,1.35
"20200303","1783","0035003800350067","5850",統一-平鎮,1,0,1,1,1.35
"20200303","1783","0035003900320063","5920",元富-烏日,0,1,1,-1,1.35
"20200303","1783","5322","5320",高橋-中壢,1,0,1,1,1.35
"20200303","1783","0031003000340044","1040",臺銀-金山,0,1,1,-1,1.35
"20200304","1783","8380","8380",安泰,5,0,5,1,8.06
"20200304","1783","8849","8840",玉山-景美,1,5,4,-1,6.45
"20200304","1783","9217","9200",凱基-松山,5,0,5,1,8.06
"20200304","1783","0038003800380041","8880",國泰-館前,0,3,3,-1,4.84
"20200304","1783","9856","9800",元大-花蓮,5,0,5,1,8.06
"20200304","1783","0031003000340043","1040",臺銀-高雄,0,2,2,-1,3.23
"20200304","1783","0035003900320071","5920",元富-屏東,4,0,4,1,6.45
"20200304","1783","1440","1440",美林,0,1,1,-1,1.61
"20200304","1783","9667","9600",富邦-台南,4,0,4,1,6.45
"20200304","1783","1260","1260",宏遠證券,0,1,1,-1,1.61
"20200304","1783","9216","9200",凱基-信義,2,0,2,1,3.23
"20200304","1783","5850","5850",統一,0,1,1,-1,1.61
"20200304","1783","003900380031004e","9800",元大-金門,2,0,2,1,3.23
"20200304","1783","003500390032006c","5920",元富-大裕,0,1,1,-1,1.61
"20200304","1783","0039003800350043","9800",元大-鳳中,2,0,2,1,3.23
"20200304","1783","5927","5920",元富-林園,0,1,1,-1,1.61
"20200304","1783","9362","9300",華南永昌-苗栗,1,0,1,1,1.61
"20200304","1783","6164","6160",中國信託-文心,0,1,1,-1,1.61
"20200304","1783","0035003900320079","5920",元富-花蓮,1,0,1,1,1.61
"20200304","1783","0038003800340042","8840",玉山-台中,0,1,1,-1,1.61
"20200304","1783","0035003900320049","5920",元富-嘉義,1,0,1,1,1.61
"20200304","1783","8887","8880",國泰-忠孝,0,1,1,-1,1.61
"20200304","1783","1470","1470",台灣摩根士丹利,1,0,1,1,1.61
"20200304","1783","0039003100330044","9100",群益金鼎-潭子,0,1,1,-1,1.61
"20200304","1783","1043","1040",臺銀-民權,1,0,1,1,1.61
"20200304","1783","9184","9100",群益金鼎-台中,0,1,1,-1,1.61
"20200304","1783","1021","1020",合庫-台中,1,0,1,1,1.61
"20200304","1783","9801","9800",元大-城東,0,1,1,-1,1.61
"20200305","1783","0039003800310056","9800",元大-民雄,5,0,5,1,9.26
"20200305","1783","9814","9800",元大-大益,0,5,5,-1,9.26
"20200305","1783","0039003100330055","9100",群益金鼎-崇德,5,0,5,1,9.26
"20200305","1783","1440","1440",美林,0,4,4,-1,7.41
"20200305","1783","9834","9800",元大-中壢,8,4,4,1,7.41
"20200305","1783","1040","1040",臺銀,0,2,2,-1,3.70
"20200305","1783","7750","7750",北城證券,3,0,3,1,5.56
"20200305","1783","6462","6460",大昌-安康,0,2,2,-1,3.70
"20200305","1783","1260","1260",宏遠證券,2,0,2,1,3.70
"20200305","1783","003700370039007a","7790",國票-博愛,0,2,2,-1,3.70
"20200305","1783","9873","9800",元大-西門,2,0,2,1,3.70
"20200305","1783","0039003200300043","9200",凱基-雙和,0,2,2,-1,3.70
"20200305","1783","0035003900320076","5920",元富-桃園,1,0,1,1,1.85
"20200305","1783","9216","9200",凱基-信義,0,2,2,-1,3.70
"20200305","1783","0035003900320071","5920",元富-屏東,1,0,1,1,1.85
"20200305","1783","003900360031004c","9600",富邦-士林,0,2,2,-1,3.70
"20200305","1783","7790","7790",國票證券,1,0,1,1,1.85
"20200305","1783","9634","9600",富邦-羅東,0,2,2,-1,3.70
"20200305","1783","0038003100350048","8150",台新-屏東,1,0,1,1,1.85
"20200305","1783","003900380031004e","9800",元大-金門,0,2,2,-1,3.70
"20200305","1783","0038003100350059","8150",台新-新營,1,0,1,1,1.85
"20200305","1783","9872","9800",元大-復北,0,2,2,-1,3.70
"20200305","1783","0038003400350045","8450",康和-澎湖,1,0,1,1,1.85
"20200305","1783","9889","9800",元大-員林,0,2,2,-1,3.70
"20200305","1783","9257","9200",凱基-林口,1,0,1,1,1.85
"20200305","1783","6460","6460",大昌,0,1,1,-1,1.85
"20200305","1783","9333","9300",華南永昌-長虹,1,0,1,1,1.85
"20200305","1783","7007","7000",兆豐-竹北,0,1,1,-1,1.85
"20200306","1783","9667","9600",富邦-台南,16,4,12,1,3.53
"20200306","1783","0037003000300077","7000",兆豐-新莊,0,19,19,-1,5.59
"20200306","1783","9623","9600",富邦-台北,10,0,10,1,2.94
"20200306","1783","0039003100330055","9100",群益金鼎-崇德,20,35,15,-1,4.41
"20200306","1783","8150","8150",台新證券,8,0,8,1,2.35
"20200306","1783","1021","1020",合庫-台中,5,14,9,-1,2.65
"20200306","1783","0039004100390065","9A00",永豐金-高雄,6,0,6,1,1.76
"20200306","1783","9825","9800",元大-新營,0,8,8,-1,2.35
"20200306","1783","0035003300380044","5380",第一金-忠孝,5,0,5,1,1.47
"20200306","1783","1440","1440",美林,6,12,6,-1,1.76
"20200306","1783","9186","9100",群益金鼎-新竹,5,0,5,1,1.47
"20200306","1783","003900320030004e","9200",凱基-湖口,1,6,5,-1,1.47
"20200306","1783","9202","9200",凱基-中港,5,0,5,1,1.47
"20200306","1783","9339","9300",華南永昌-竹北,0,5,5,-1,1.47
"20200306","1783","5321","5320",高橋-龍潭,5,1,4,1,1.18
"20200306","1783","003900360035004b","9600",富邦-台中,4,9,5,-1,1.47
"20200306","1783","0039003600320048","9600",富邦-鳳山,4,0,4,1,1.18
"20200306","1783","6464","6460",大昌-新店,0,4,4,-1,1.18
"20200306","1783","5858","5850",統一-嘉義,7,4,3,1,0.88
"20200306","1783","0038003800380041","8880",國泰-館前,0,4,4,-1,1.18
"20200306","1783","003500390032006e","5920",元富-西松,3,0,3,1,0.88
"20200306","1783","9307","9300",華南永昌-大安,0,4,4,-1,1.18
"20200306","1783","003700300030006b","7000",兆豐-員林,5,2,3,1,0.88
"20200306","1783","0031003200360048","1260",宏遠-中和,0,3,3,-1,0.88
"20200306","1783","0038003800340042","8840",玉山-台中,3,0,3,1,0.88
"20200306","1783","0038003100350042","8150",台新-台中,0,3,3,-1,0.88
"20200306","1783","003900380033006a","9800",元大-仁愛,3,0,3,1,0.88
"20200306","1783","0039003800390049","9800",元大-蘆洲,0,3,3,-1,0.88
"20200309","1783","9323","9300",華南永昌-小港,17,0,17,1,2.81
"20200309","1783","0037003700390050","7790",國票-九鼎,3,28,25,-1,4.14
"20200309","1783","5262","5260",美好-楊梅,16,0,16,1,2.65
"20200309","1783","8440","8440",摩根大通,0,19,19,-1,3.15
"20200309","1783","0031003000320045","1020",合庫-桃園,10,0,10,1,1.66
"20200309","1783","8560","8560",新光,21,38,17,-1,2.81
"20200309","1783","9208","9200",凱基-桃園,15,5,10,1,1.66
"20200309","1783","0039003100380067","9100",群益金鼎-大甲,2,18,16,-1,2.65
"20200309","1783","9317","9300",華南永昌-林口,10,0,10,1,1.66
"20200309","1783","0039003800310053","9800",元大-崇德,1,16,15,-1,2.48
"20200309","1783","003900380031006a","9800",元大-士林,10,0,10,1,1.66
"20200309","1783","5386","5380",第一金-彰化,4,15,11,-1,1.82
"20200309","1783","9211","9200",凱基-台南,10,1,9,1,1.49
"20200309","1783","9859","9800",元大-新竹經國,0,11,11,-1,1.82
"20200309","1783","0039003600320041","9600",富邦-信義,8,0,8,1,1.32
"20200309","1783","0037003000300052","7000",兆豐-小港,0,10,10,-1,1.66
"20200309","1783","9852","9800",元大-永春,7,0,7,1,1.16
"20200309","1783","9623","9600",富邦-台北,1,10,9,-1,1.49
"20200309","1783","0035003900320076","5920",元富-桃園,7,1,6,1,0.99
"20200309","1783","5321","5320",高橋-龍潭,1,9,8,-1,1.32
"20200309","1783","0039003600310057","9600",富邦-東花蓮,6,0,6,1,0.99
"20200309","1783","8849","8840",玉山-景美,0,7,7,-1,1.16
"20200309","1783","0039004100390068","9A00",永豐金-台南,11,5,6,1,0.99
"20200309","1783","003900360031004b","9600",富邦-七賢,0,7,7,-1,1.16
"20200309","1783","5385","5380",第一金-桃園,5,0,5,1,0.83
"20200309","1783","1440","1440",美林,9,15,6,-1,0.99
"20200309","1783","0035003800350045","5850",統一-新營,5,0,5,1,0.83
"20200309","1783","6380","6380",光和,0,6,6,-1,0.99
"20200310","1783","9377","9300",華南永昌-虎尾,13,0,13,1,6.95
"20200310","1783","9875","9800",元大-土城永寧,0,15,15,-1,8.02
"20200310","1783","1590","1590",花旗環球,9,0,9,1,4.81
"20200310","1783","0039003800310053","9800",元大-崇德,0,14,14,-1,7.49
"20200310","1783","8440","8440",摩根大通,7,0,7,1,3.74
"20200310","1783","0036003100310041","6110",台中銀-豐原,0,10,10,-1,5.35
"20200310","1783","9816","9800",元大-新竹,7,0,7,1,3.74
"20200310","1783","0037003000300055","7000",兆豐-桃鶯,0,10,10,-1,5.35
"20200310","1783","5386","5380",第一金-彰化,6,0,6,1,3.21
"20200310","1783","0039003800310065","9800",元大-佳里,0,7,7,-1,3.74
"20200310","1783","0037003700390045","7790",國票-南崁,6,0,6,1,3.21
"20200310","1783","1440","1440",美林,7,13,6,-1,3.21
"20200310","1783","0039003100380047","9100",群益金鼎-新莊,6,0,6,1,3.21
"20200310","1783","1041","1040",臺銀-鳳山,0,5,5,-1,2.67
"20200310","1783","5922","5920",元富-新店,5,0,5,1,2.67
"20200310","1783","0037003700390050","7790",國票-九鼎,0,5,5,-1,2.67
"20200310","1783","0036003300380041","6380",光和-嘉義,5,0,5,1,2.67
"20200310","1783","0039003600310048","9600",富邦-新板,1,6,5,-1,2.67
"20200310","1783","0037003000300052","7000",兆豐-小港,5,0,5,1,2.67
"20200310","1783","0039004100300030","9A00",永豐金證券,0,5,5,-1,2.67
"20200310","1783","9835","9800",元大-員林中山,5,0,5,1,2.67
"20200310","1783","003500390032006d","5920",元富-成功,0,4,4,-1,2.14
"20200310","1783","5385","5380",第一金-桃園,4,0,4,1,2.14
"20200310","1783","8159","8150",台新-台南,0,4,4,-1,2.14
"20200310","1783","0035003900320049","5920",元富-嘉義,4,0,4,1,2.14
"20200310","1783","8560","8560",新光,5,9,4,-1,2.14
"20200310","1783","0035003900320071","5920",元富-屏東,4,0,4,1,2.14
"20200310","1783","9235","9200",凱基-永華,0,4,4,-1,2.14
"20200311","1783","0039003800380043","9800",元大-三重,20,0,20,1,13.07
"20200311","1783","1440","1440",美林,2,12,10,-1,6.54
"20200311","1783","9667","9600",富邦-台南,7,1,6,1,3.92
"20200311","1783","9208","9200",凱基-桃園,0,10,10,-1,6.54
"20200311","1783","0035003800350042","5850",統一-永和,5,0,5,1,3.27
"20200311","1783","1470","1470",台灣摩根士丹利,0,7,7,-1,4.58
"20200311","1783","003900410039004d","9A00",永豐金-南投,5,0,5,1,3.27
"20200311","1783","0035003900320071","5920",元富-屏東,0,6,6,-1,3.92
"20200311","1783","0039003600320041","9600",富邦-信義,3,0,3,1,1.96
"20200311","1783","0035003900320076","5920",元富-桃園,0,6,6,-1,3.92
"20200311","1783","9892","9800",元大-屏東,3,0,3,1,1.96
"20200311","1783","0038003100350048","8150",台新-屏東,0,6,6,-1,3.92
"20200311","1783","0039003800390056","9800",元大-北三重,3,0,3,1,1.96
"20200311","1783","5385","5380",第一金-桃園,0,3,3,-1,1.96
"20200311","1783","1233","1230",彰銀-台中,2,0,2,1,1.31
"20200311","1783","003500390032006c","5920",元富-大裕,0,3,3,-1,1.96
"20200311","1783","0031003000320043","1020",合庫-自強,2,0,2,1,1.31
"20200311","1783","8560","8560",新光,5,8,3,-1,1.96
"20200311","1783","6464","6460",大昌-新店,2,0,2,1,1.31
"20200311","1783","0039003200300045","9200",凱基-東門,0,3,3,-1,1.96
"20200311","1783","9234","9200",凱基-竹北,2,0,2,1,1.31
"20200311","1783","003900380036004b","9800",元大-基隆孝二,0,3,3,-1,1.96
"20200311","1783","9655","9600",富邦-板橋,2,0,2,1,1.31
"20200311","1783","0039004100390068","9A00",永豐金-台南,3,6,3,-1,1.96
"20200311","1783","0039003100330055","9100",群益金鼎-崇德,1,0,1,1,0.65
"20200311","1783","5602","5600",永興-水湳,0,2,2,-1,1.31
"20200311","1783","0039003100330052","9100",群益金鼎-北高雄,1,0,1,1,0.65
"20200311","1783","8440","8440",摩根大通,0,2,2,-1,1.31
"20200312","1783","9349","9300",華南永昌-板橋,32,0,32,1,5.38
"20200312","1783","9651","9600",富邦-民生(停),0,50,50,-1,8.40
"20200312","1783","9315","9300",華南永昌-苑裡,30,0,30,1,5.04
"20200312","1783","9238","9200",凱基-士林,0,20,20,-1,3.36
"20200312","1783","9300","9300",華南永昌,26,0,26,1,4.37
"20200312","1783","003900380039004c","9800",元大-成功,0,20,20,-1,3.36
"20200312","1783","003500390032007a","5920",元富-文心,21,0,21,1,3.53
"20200312","1783","0039003100380047","9100",群益金鼎-新莊,1,20,19,-1,3.19
"20200312","1783","0035003300380044","5380",第一金-忠孝,15,0,15,1,2.52
"20200312","1783","9858","9800",元大-龍潭,1,14,13,-1,2.18
"20200312","1783","0035003300380057","5380",第一金-華江,15,3,12,1,2.02
"20200312","1783","003900380033006a","9800",元大-仁愛,0,12,12,-1,2.02
"20200312","1783","0039003100330055","9100",群益金鼎-崇德,19,8,11,1,1.85
"20200312","1783","0039003800310053","9800",元大-崇德,10,20,10,-1,1.68
"20200312","1783","5853","5850",統一-中壢,10,0,10,1,1.68
"20200312","1783","003900410039004d","9A00",永豐金-南投,2,12,10,-1,1.68
"20200312","1783","0035003900320055","5920",元富-宜蘭,10,0,10,1,1.68
"20200312","1783","003700370039007a","7790",國票-博愛,0,9,9,-1,1.51
"20200312","1783","1021","1020",合庫-台中,9,0,9,1,1.51
"20200312","1783","9202","9200",凱基-中港,0,9,9,-1,1.51
"20200312","1783","0039004100390064","9A00",永豐金-古亭,7,0,7,1,1.18
"20200312","1783","5389","5380",第一金-中山,0,7,7,-1,1.18
"20200312","1783","9317","9300",華南永昌-林口,6,0,6,1,1.01
"20200312","1783","9266","9200",凱基-新豐,0,7,7,-1,1.18
"20200312","1783","6950","6950",福勝,5,0,5,1,0.84
"20200312","1783","0035003900320075","5920",元富-世貿,0,6,6,-1,1.01
"20200312","1783","9134","9100",群益金鼎-開元,5,0,5,1,0.84
"20200312","1783","0039003600310050","9600",富邦-和美,0,6,6,-1,1.01
"20200313","1783","8560","8560",新光,15,0,15,1,4.90
"20200313","1783","0039003100380067","9100",群益金鼎-大甲,0,31,31,-1,10.13
"20200313","1783","003500390032007a","5920",元富-文心,11,0,11,1,3.59
"20200313","1783","8710","8710",陽信,0,29,29,-1,9.48
"20200313","1783","9134","9100",群益金鼎-開元,10,0,10,1,3.27
"20200313","1783","0035003300380057","5380",第一金-華江,0,22,22,-1,7.19
"20200313","1783","9875","9800",元大-土城永寧,10,0,10,1,3.27
"20200313","1783","5262","5260",美好-楊梅,0,16,16,-1,5.23
"20200313","1783","0031003100310042","1110",台灣企銀-建成,6,0,6,1,1.96
"20200313","1783","0039003800390041","9800",元大-北投,0,15,15,-1,4.90
"20200313","1783","1021","1020",合庫-台中,5,0,5,1,1.63
"20200313","1783","0039003200300041","9200",凱基-板橋,1,15,14,-1,4.58
"20200313","1783","5856","5850",統一-台中,5,0,5,1,1.63
"20200313","1783","003800380038004b","8880",國泰-板橋,0,10,10,-1,3.27
"20200313","1783","0035003900320071","5920",元富-屏東,5,0,5,1,1.63
"20200313","1783","0039003600320052","9600",富邦-園區,1,10,9,-1,2.94
"20200313","1783","0037003000300066","7000",兆豐-鹿港,5,0,5,1,1.63
"20200313","1783","0031003200360055","1260",宏遠-館前,0,5,5,-1,1.63
"20200313","1783","9233","9200",凱基-長庚,5,0,5,1,1.63
"20200313","1783","003500390032006e","5920",元富-西松,0,5,5,-1,1.63
"20200313","1783","003900380031006a","9800",元大-士林,5,0,5,1,1.63
"20200313","1783","0039003800300077","9800",元大-西屯,0,4,4,-1,1.31
"20200313","1783","9874","9800",元大-雙和,5,0,5,1,1.63
"20200313","1783","1040","1040",臺銀,0,3,3,-1,0.98
"20200313","1783","5267","5260",美好-基隆,4,0,4,1,1.31
"20200313","1783","0038003400350055","8450",康和-台北,0,3,3,-1,0.98
"20200313","1783","003500390032006c","5920",元富-大裕,4,0,4,1,1.31
"20200313","1783","8563","8560",新光-新竹,0,3,3,-1,0.98
"20200316","1783","0039003200320048","9200",凱基-復興,27,2,25,1,8.33
"20200316","1783","9211","9200",凱基-台南,0,17,17,-1,5.67
"20200316","1783","1035","1030",土銀-新竹,19,0,19,1,6.33
"20200316","1783","1470","1470",台灣摩根士丹利,0,16,16,-1,5.33
"20200316","1783","0035003300380042","5380",第一金-新竹,10,0,10,1,3.33
"20200316","1783","0039003600320058","9600",富邦-文化,0,16,16,-1,5.33
"20200316","1783","0037003000300071","7000",兆豐-內湖,10,0,10,1,3.33
"20200316","1783","0035003800350050","5850",統一-板橋,0,12,12,-1,4.00
"20200316","1783","0039003800310051","9800",元大-太平,10,0,10,1,3.33
"20200316","1783","0037003000300061","7000",兆豐-忠孝,0,12,12,-1,4.00
"20200316","1783","0039003800310055","9800",元大-華山,10,0,10,1,3.33
"20200316","1783","5859","5850",統一-屏東,0,10,10,-1,3.33
"20200316","1783","003900410039004a","9A00",永豐金-板新,10,0,10,1,3.33
"20200316","1783","0035003800350052","5850",統一-汐止,0,10,10,-1,3.33
"20200316","1783","8564","8560",新光-台南,10,1,9,1,3.00
"20200316","1783","6012","6010",(牛牛牛)亞-網路,0,10,10,-1,3.33
"20200316","1783","9667","9600",富邦-台南,9,0,9,1,3.00
"20200316","1783","0037003700390057","7790",國票-彰化,0,10,10,-1,3.33
"20200316","1783","0031003100310042","1110",台灣企銀-建成,6,0,6,1,2.00
"20200316","1783","0031003000340044","1040",臺銀-金山,0,8,8,-1,2.67
"20200316","1783","6950","6950",福勝,6,0,6,1,2.00
"20200316","1783","0039003800330056","9800",元大-竹南,0,8,8,-1,2.67
"20200316","1783","0037003700390050","7790",國票-九鼎,13,7,6,1,2.00
"20200316","1783","003500390032007a","5920",元富-文心,0,6,6,-1,2.00
"20200316","1783","0039003200300046","9200",凱基-站前,5,0,5,1,1.67
"20200316","1783","0039003600320052","9600",富邦-園區,0,6,6,-1,2.00
"20200316","1783","0039003800390049","9800",元大-蘆洲,7,2,5,1,1.67
"20200316","1783","0039003800330057","9800",元大-大里德芳,0,4,4,-1,1.33
"20200317","1783","1041","1040",臺銀-鳳山,42,1,41,1,6.90
"20200317","1783","5263","5260",美好-泰山,0,63,63,-1,10.61
"20200317","1783","0039003200320048","9200",凱基-復興,33,6,27,1,4.55
"20200317","1783","0039003200300057","9200",凱基-大里,2,56,54,-1,9.09
"20200317","1783","1520","1520",瑞士信貸,22,0,22,1,3.70
"20200317","1783","9363","9300",華南永昌-彰化,0,31,31,-1,5.22
"20200317","1783","9324","9300",華南永昌-岡山,20,0,20,1,3.37
"20200317","1783","9317","9300",華南永昌-林口,0,20,20,-1,3.37
"20200317","1783","1480","1480",美商高盛,14,1,13,1,2.19
"20200317","1783","5320","5320",高橋,0,15,15,-1,2.53
"20200317","1783","0039003800390041","9800",元大-北投,13,0,13,1,2.19
"20200317","1783","9255","9200",凱基-和平,0,13,13,-1,2.19
"20200317","1783","9349","9300",華南永昌-板橋,11,0,11,1,1.85
"20200317","1783","9692","9600",富邦-嘉義,0,12,12,-1,2.02
"20200317","1783","9238","9200",凱基-士林,10,0,10,1,1.68
"20200317","1783","003900410039004a","9A00",永豐金-板新,0,10,10,-1,1.68
"20200317","1783","9326","9300",華南永昌-南京,10,0,10,1,1.68
"20200317","1783","0035003300380057","5380",第一金-華江,0,9,9,-1,1.52
"20200317","1783","0039003800320042","9800",元大-博愛,10,0,10,1,1.68
"20200317","1783","003700300030004a","7000",兆豐-公益,0,6,6,-1,1.01
"20200317","1783","0031003100310042","1110",台灣企銀-建成,9,0,9,1,1.52
"20200317","1783","8560","8560",新光,17,23,6,-1,1.01
"20200317","1783","0037003700390065","7790",國票-南科,6,0,6,1,1.01
"20200317","1783","9343","9300",華南永昌-頭份,5,11,6,-1,1.01
"20200317","1783","0038003400350055","8450",康和-台北,8,2,6,1,1.01
"20200317","1783","0039003600310048","9600",富邦-新板,1,7,6,-1,1.01
"20200317","1783","8563","8560",新光-新竹,6,0,6,1,1.01
"20200317","1783","9857","9800",元大-東蘆,0,6,6,-1,1.01
"20200318","1783","0037003000300071","7000",兆豐-內湖,27,0,27,1,8.33
"20200318","1783","0031003000330046","1030",土銀-南港,0,22,22,-1,6.79
"20200318","1783","0039003200320048","9200",凱基-復興,27,2,25,1,7.72
"20200318","1783","1035","1030",土銀-新竹,0,19,19,-1,5.86
"20200318","1783","0039003800310053","9800",元大-崇德,12,0,12,1,3.70
"20200318","1783","0039003600320046","9600",富邦-北桃園(停),0,12,12,-1,3.70
"20200318","1783","0031003100310042","1110",台灣企銀-建成,10,0,10,1,3.09
"20200318","1783","0035003300380057","5380",第一金-華江,0,10,10,-1,3.09
"20200318","1783","7032","7030",致和-佳里,10,0,10,1,3.09
"20200318","1783","0039003800310069","9800",元大-西螺,0,10,10,-1,3.09
"20200318","1783","8560","8560",新光,26,16,10,1,3.09
"20200318","1783","1470","1470",台灣摩根士丹利,0,8,8,-1,2.47
"20200318","1783","9326","9300",華南永昌-南京,10,0,10,1,3.09
"20200318","1783","0039003600310051","9600",富邦-重新,0,8,8,-1,2.47
"20200318","1783","0039003100330055","9100",群益金鼎-崇德,10,2,8,1,2.47
"20200318","1783","9211","9200",凱基-台南,2,9,7,-1,2.16
"20200318","1783","7003","7000",兆豐-台中,6,0,6,1,1.85
"20200318","1783","0037003700390047","7790",國票-新莊,0,6,6,-1,1.85
"20200318","1783","0039003800390059","9800",元大-基隆,6,0,6,1,1.85
"20200318","1783","8563","8560",新光-新竹,1,7,6,-1,1.85
"20200318","1783","0039004100380046","9A00",永豐金-敦南,6,0,6,1,1.85
"20200318","1783","1480","1480",美商高盛,0,5,5,-1,1.54
"20200318","1783","0037003700390065","7790",國票-南科,5,0,5,1,1.54
"20200318","1783","1040","1040",臺銀,0,5,5,-1,1.54
"20200318","1783","9300","9300",華南永昌,5,0,5,1,1.54
"20200318","1783","0035003800350067","5850",統一-平鎮,0,5,5,-1,1.54
"20200318","1783","5850","5850",統一,4,0,4,1,1.23
"20200318","1783","0037003700390056","7790",國票-天祥,0,5,5,-1,1.54
"20200319","1783","003500390032007a","5920",元富-文心,39,3,36,1,6.65
"20200319","1783","0035003900320049","5920",元富-嘉義,0,50,50,-1,9.24
"20200319","1783","9300","9300",華南永昌,32,0,32,1,5.91
"20200319","1783","0037003000300066","7000",兆豐-鹿港,0,25,25,-1,4.62
"20200319","1783","0039003100330055","9100",群益金鼎-崇德,27,0,27,1,4.99
"20200319","1783","9343","9300",華南永昌-頭份,0,19,19,-1,3.51
"20200319","1783","0039003200320048","9200",凱基-復興,30,3,27,1,4.99
"20200319","1783","0038003800340045","8840",玉山-城中,8,24,16,-1,2.96
"20200319","1783","8560","8560",新光,35,13,22,1,4.07
"20200319","1783","0035003300380057","5380",第一金-華江,0,14,14,-1,2.59
"20200319","1783","9208","9200",凱基-桃園,21,0,21,1,3.88
"20200319","1783","8150","8150",台新證券,0,11,11,-1,2.03
"20200319","1783","9324","9300",華南永昌-岡山,21,0,21,1,3.88
"20200319","1783","003900320030005a","9200",凱基-台東,0,10,10,-1,1.85
"20200319","1783","9134","9100",群益金鼎-開元,13,0,13,1,2.40
"20200319","1783","9362","9300",華南永昌-苗栗,0,10,10,-1,1.85
"20200319","1783","9875","9800",元大-土城永寧,13,0,13,1,2.40
"20200319","1783","9386","9300",華南永昌-東昇,0,10,10,-1,1.85
"20200319","1783","0039003600320041","9600",富邦-信義,12,0,12,1,2.22
"20200319","1783","9636","9600",富邦-中壢,0,10,10,-1,1.85
"20200319","1783","0037003700390047","7790",國票-新莊,11,0,11,1,2.03
"20200319","1783","9665","9600",富邦-桃園,0,10,10,-1,1.85
"20200319","1783","2181","2180",亞東-板橋,10,0,10,1,1.85
"20200319","1783","5320","5320",高橋,0,9,9,-1,1.66
"20200319","1783","9315","9300",華南永昌-苑裡,10,0,10,1,1.85
"20200319","1783","6913","6910",德信-新營,0,8,8,-1,1.48
"20200319","1783","9859","9800",元大-新竹經國,10,0,10,1,1.85
"20200319","1783","9339","9300",華南永昌-竹北,0,8,8,-1,1.48
"20200320","1783","0039003200320048","9200",凱基-復興,32,0,32,1,8.40
"20200320","1783","0035003300380044","5380",第一金-忠孝,0,30,30,-1,7.87
"20200320","1783","6380","6380",光和,20,0,20,1,5.25
"20200320","1783","5384","5380",第一金-台南,1,26,25,-1,6.56
"20200320","1783","1440","1440",美林,26,7,19,1,4.99
"20200320","1783","0039003100330055","9100",群益金鼎-崇德,8,31,23,-1,6.04
"20200320","1783","9672","9600",富邦-員林,15,0,15,1,3.94
"20200320","1783","9275","9200",凱基-三多,0,19,19,-1,4.99
"20200320","1783","9324","9300",華南永昌-岡山,11,0,11,1,2.89
"20200320","1783","9892","9800",元大-屏東,0,19,19,-1,4.99
"20200320","1783","0035003800350045","5850",統一-新營,10,0,10,1,2.62
"20200320","1783","0037003700390047","7790",國票-新莊,2,13,11,-1,2.89
"20200320","1783","9238","9200",凱基-士林,10,0,10,1,2.62
"20200320","1783","9134","9100",群益金鼎-開元,0,10,10,-1,2.62
"20200320","1783","9323","9300",華南永昌-小港,10,0,10,1,2.62
"20200320","1783","003500390032007a","5920",元富-文心,0,8,8,-1,2.10
"20200320","1783","0039003800390050","9800",元大-敦南,10,0,10,1,2.62
"20200320","1783","0039003800380042","9800",元大-桃園,0,8,8,-1,2.10
"20200320","1783","8560","8560",新光,14,7,7,1,1.84
"20200320","1783","1110","1110",台灣企銀,0,7,7,-1,1.84
"20200320","1783","1480","1480",美商高盛,5,0,5,1,1.31
"20200320","1783","9288","9200",凱基-埔墘,0,7,7,-1,1.84
"20200320","1783","5856","5850",統一-台中,5,0,5,1,1.31
"20200320","1783","6115","6110",台中銀-台北,0,6,6,-1,1.57
"20200320","1783","0039003200300046","9200",凱基-站前,5,0,5,1,1.31
"20200320","1783","003900380039005a","9800",元大-小港,0,6,6,-1,1.57
"20200320","1783","9339","9300",華南永昌-竹北,5,0,5,1,1.31
"20200320","1783","0037003700390065","7790",國票-南科,0,5,5,-1,1.31
"20200323","1783","0039003200320048","9200",凱基-復興,27,0,27,1,17.42
"20200323","1783","0035003800350046","5850",統一-彰化,0,12,12,-1,7.74
"20200323","1783","9324","9300",華南永昌-岡山,20,1,19,1,12.26
"20200323","1783","003500390032007a","5920",元富-文心,0,10,10,-1,6.45
"20200323","1783","0035003300380057","5380",第一金-華江,9,0,9,1,5.81
"20200323","1783","0039004100390064","9A00",永豐金-古亭,0,10,10,-1,6.45
"20200323","1783","0037003000300071","7000",兆豐-內湖,5,0,5,1,3.23
"20200323","1783","8560","8560",新光,3,12,9,-1,5.81
"20200323","1783","9349","9300",華南永昌-板橋,5,0,5,1,3.23
"20200323","1783","0039003800310046","9800",元大-福營,0,8,8,-1,5.16
"20200323","1783","5263","5260",美好-泰山,4,0,4,1,2.58
"20200323","1783","003900310033004e","9100",群益金鼎-土城,0,6,6,-1,3.87
"20200323","1783","1021","1020",合庫-台中,3,0,3,1,1.94
"20200323","1783","0039003100380067","9100",群益金鼎-大甲,0,6,6,-1,3.87
"20200323","1783","0037003700390045","7790",國票-南崁,3,0,3,1,1.94
"20200323","1783","0035003900320062","5920",元富-板橋,0,5,5,-1,3.23
"20200323","1783","9331","9300",華南永昌-鳳山,3,0,3,1,1.94
"20200323","1783","0039003800310044","9800",元大-南投,0,5,5,-1,3.23
"20200323","1783","0036003000310064","6010",(牛牛牛)亞-鑫豐,2,0,2,1,1.29
"20200323","1783","0039004100390061","9A00",永豐金-苓雅,0,5,5,-1,3.23
"20200323","1783","6167","6160",中國信託-松江,2,0,2,1,1.29
"20200323","1783","0039004100390073","9A00",永豐金-彰化,0,5,5,-1,3.23
"20200323","1783","9217","9200",凱基-松山,3,1,2,1,1.29
"20200323","1783","0039003800390059","9800",元大-基隆,0,4,4,-1,2.58
"20200323","1783","0035003900320076","5920",元富-桃園,1,0,1,1,0.65
"20200323","1783","5260","5260",美好,0,3,3,-1,1.94
"20200323","1783","003500390032006e","5920",元富-西松,1,0,1,1,0.65
"20200323","1783","0031003000330046","1030",土銀-南港,0,3,3,-1,1.94
"20200324","1783","0039003200320048","9200",凱基-復興,27,0,27,1,16.07
"20200324","1783","9186","9100",群益金鼎-新竹,0,20,20,-1,11.90
"20200324","1783","0037003000300049","7000",兆豐-北高雄,10,0,10,1,5.95
"20200324","1783","1440","1440",美林,0,13,13,-1,7.74
"20200324","1783","8849","8840",玉山-景美,10,0,10,1,5.95
"20200324","1783","0039003100330055","9100",群益金鼎-崇德,0,12,12,-1,7.14
"20200324","1783","9323","9300",華南永昌-小港,10,0,10,1,5.95
"20200324","1783","9315","9300",華南永昌-苑裡,0,10,10,-1,5.95
"20200324","1783","8563","8560",新光-新竹,8,0,8,1,4.76
"20200324","1783","0039004100390037","9A00",永豐金-新竹,0,9,9,-1,5.36
"20200324","1783","0038003400350055","8450",康和-台北,6,0,6,1,3.57
"20200324","1783","9324","9300",華南永昌-岡山,0,6,6,-1,3.57
"20200324","1783","0031003100310042","1110",台灣企銀-建成,5,0,5,1,2.98
"20200324","1783","8560","8560",新光,0,5,5,-1,2.98
"20200324","1783","0039003800310058","9800",元大-新生,5,0,5,1,2.98
"20200324","1783","9801","9800",元大-城東,0,5,5,-1,2.98
"20200324","1783","9697","9600",富邦-虎尾,4,0,4,1,2.38
"20200324","1783","0035003800350044","5850",統一-新台中,2,5,3,-1,1.79
"20200324","1783","0039003800330056","9800",元大-竹南,3,0,3,1,1.79
"20200324","1783","0037003700390045","7790",國票-南崁,0,3,3,-1,1.79
"20200324","1783","0037003700390058","7790",國票-中和,3,1,2,1,1.19
"20200324","1783","9679","9600",富邦-延吉(停),0,3,3,-1,1.79
"20200324","1783","9377","9300",華南永昌-虎尾,2,0,2,1,1.19
"20200324","1783","0039003800390049","9800",元大-蘆洲,0,3,3,-1,1.79
"20200324","1783","9838","9800",元大-豐原,2,0,2,1,1.19
"20200324","1783","0035003800350048","5850",統一-桃園,0,2,2,-1,1.19
"20200324","1783","9892","9800",元大-屏東,2,0,2,1,1.19
"20200324","1783","0036003000310064","6010",(牛牛牛)亞-鑫豐,0,2,2,-1,1.19
"20200325","1783","1440","1440",美林,24,0,24,1,8.92
"20200325","1783","0039003100380067","9100",群益金鼎-大甲,0,18,18,-1,6.69
"20200325","1783","8382","8380",安泰-楠梓,21,0,21,1,7.81
"20200325","1783","8560","8560",新光,0,16,16,-1,5.95
"20200325","1783","9209","9200",凱基-岡山,21,0,21,1,7.81
"20200325","1783","9324","9300",華南永昌-岡山,0,14,14,-1,5.20
"20200325","1783","0039003200300057","9200",凱基-大里,31,12,19,1,7.06
"20200325","1783","9333","9300",華南永昌-長虹,0,10,10,-1,3.72
"20200325","1783","9366","9300",華南永昌-豐原,13,0,13,1,4.83
"20200325","1783","0039004100390037","9A00",永豐金-新竹,0,10,10,-1,3.72
"20200325","1783","9266","9200",凱基-新豐,12,1,11,1,4.09
"20200325","1783","003500390032007a","5920",元富-文心,0,9,9,-1,3.35
"20200325","1783","0035003300380057","5380",第一金-華江,10,0,10,1,3.72
"20200325","1783","8563","8560",新光-新竹,1,8,7,-1,2.60
"20200325","1783","9208","9200",凱基-桃園,10,0,10,1,3.72
"20200325","1783","1040","1040",臺銀,0,5,5,-1,1.86
"20200325","1783","9238","9200",凱基-士林,10,0,10,1,3.72
"20200325","1783","1035","1030",土銀-新竹,0,5,5,-1,1.86
"20200325","1783","0039003200320048","9200",凱基-復興,9,0,9,1,3.35
"20200325","1783","7001","7000",兆豐-嘉義,0,5,5,-1,1.86
"20200325","1783","1041","1040",臺銀-鳳山,5,1,4,1,1.49
"20200325","1783","5262","5260",美好-楊梅,0,4,4,-1,1.49
"20200325","1783","0038003400350055","8450",康和-台北,4,0,4,1,1.49
"20200325","1783","0035003800350044","5850",統一-新台中,1,5,4,-1,1.49
"20200325","1783","0039003800390050","9800",元大-敦南,4,0,4,1,1.49
"20200325","1783","0037003700390050","7790",國票-九鼎,0,4,4,-1,1.49
"20200325","1783","0035003800350046","5850",統一-彰化,3,0,3,1,1.12
"20200325","1783","8520","8520",中農,0,4,4,-1,1.49
"20200326","1783","0039003800370041","9800",元大-楊梅,15,2,13,1,4.85
"20200326","1783","9209","9200",凱基-岡山,1,20,19,-1,7.09
"20200326","1783","003500390032007a","5920",元富-文心,10,0,10,1,3.73
"20200326","1783","0035003300380057","5380",第一金-華江,0,10,10,-1,3.73
"20200326","1783","6463","6460",大昌-新竹,10,0,10,1,3.73
"20200326","1783","9186","9100",群益金鼎-新竹,0,10,10,-1,3.73
"20200326","1783","8710","8710",陽信,10,0,10,1,3.73
"20200326","1783","7003","7000",兆豐-台中,0,7,7,-1,2.61
"20200326","1783","0039004100390036","9A00",永豐金-博愛,9,0,9,1,3.36
"20200326","1783","0035003800350059","5850",統一-土城,0,6,6,-1,2.24
"20200326","1783","0031003100310042","1110",台灣企銀-建成,8,0,8,1,2.99
"20200326","1783","1520","1520",瑞士信貸,2,8,6,-1,2.24
"20200326","1783","0037003000300052","7000",兆豐-小港,8,0,8,1,2.99
"20200326","1783","9205","9200",凱基-三重,0,6,6,-1,2.24
"20200326","1783","9252","9200",凱基-嘉義,8,0,8,1,2.99
"20200326","1783","9206","9200",凱基-高雄,0,6,6,-1,2.24
"20200326","1783","9266","9200",凱基-新豐,6,0,6,1,2.24
"20200326","1783","9636","9600",富邦-中壢,0,6,6,-1,2.24
"20200326","1783","003700370039004a","7790",國票-北高雄,5,0,5,1,1.87
"20200326","1783","1021","1020",合庫-台中,5,10,5,-1,1.87
"20200326","1783","9333","9300",華南永昌-長虹,5,0,5,1,1.87
"20200326","1783","0039003200300046","9200",凱基-站前,0,5,5,-1,1.87
"20200326","1783","1560","1560",港商野村,5,1,4,1,1.49
"20200326","1783","9604","9600",富邦-陽明,0,5,5,-1,1.87
"20200326","1783","0038003400350055","8450",康和-台北,5,1,4,1,1.49
"20200326","1783","0039003800390059","9800",元大-基隆,0,5,5,-1,1.87
"20200326","1783","0039003100380043","9100",群益金鼎-古亭,5,1,4,1,1.49
"20200326","1783","8156","8150",台新-三民,1,5,4,-1,1.49
"20200327","1783","0039003200320048","9200",凱基-復興,27,0,27,1,8.36
"20200327","1783","0039003800300065","9800",元大-清水,0,40,40,-1,12.38
"20200327","1783","9138","9100",群益金鼎-中港,20,0,20,1,6.19
"20200327","1783","9324","9300",華南永昌-岡山,0,20,20,-1,6.19
"20200327","1783","003900360031004a","9600",富邦-興業,20,0,20,1,6.19
"20200327","1783","5856","5850",統一-台中,0,13,13,-1,4.02
"20200327","1783","9217","9200",凱基-松山,13,0,13,1,4.02
"20200327","1783","9366","9300",華南永昌-豐原,0,13,13,-1,4.02
"20200327","1783","1020","1020",合庫證券,10,0,10,1,3.10
"20200327","1783","1520","1520",瑞士信貸,1,12,11,-1,3.41
"20200327","1783","9238","9200",凱基-士林,10,0,10,1,3.10
"20200327","1783","7001","7000",兆豐-嘉義,0,10,10,-1,3.10
"20200327","1783","9315","9300",華南永昌-苑裡,10,0,10,1,3.10
"20200327","1783","0039003100330067","9100",群益金鼎-三重,0,9,9,-1,2.79
"20200327","1783","9894","9800",元大-桃興,10,0,10,1,3.10
"20200327","1783","0037003000300052","7000",兆豐-小港,0,8,8,-1,2.48
"20200327","1783","0031003100310042","1110",台灣企銀-建成,7,0,7,1,2.17
"20200327","1783","9252","9200",凱基-嘉義,0,8,8,-1,2.48
"20200327","1783","1021","1020",合庫-台中,6,0,6,1,1.86
"20200327","1783","5850","5850",統一,0,7,7,-1,2.17
"20200327","1783","0035003900320075","5920",元富-世貿,6,1,5,1,1.55
"20200327","1783","003700370039004a","7790",國票-北高雄,0,5,5,-1,1.55
"20200327","1783","7005","7000",兆豐-台中港,5,0,5,1,1.55
"20200327","1783","0039003100380043","9100",群益金鼎-古亭,0,5,5,-1,1.55
"20200327","1783","0037003000300047","7000",兆豐-麻豆,5,0,5,1,1.55
"20200327","1783","9634","9600",富邦-羅東,0,5,5,-1,1.55
"20200327","1783","0037003700390065","7790",國票-南科,5,0,5,1,1.55
"20200327","1783","0039003800320046","9800",元大-忠孝鼎富,0,5,5,-1,1.55
"20200330","1783","0039003800300065","9800",元大-清水,11,0,11,1,6.43
"20200330","1783","9206","9200",凱基-高雄,0,13,13,-1,7.60
"20200330","1783","0039003800390064","9800",元大-北屯,10,0,10,1,5.85
"20200330","1783","0037003700390050","7790",國票-九鼎,5,16,11,-1,6.43
"20200330","1783","0035003900320047","5920",元富-新竹,9,0,9,1,5.26
"20200330","1783","0039003600310048","9600",富邦-新板,0,11,11,-1,6.43
"20200330","1783","9211","9200",凱基-台南,10,1,9,1,5.26
"20200330","1783","0039003600310053","9600",富邦-景美,0,8,8,-1,4.68
"20200330","1783","0039003800390059","9800",元大-基隆,20,12,8,1,4.68
"20200330","1783","8880","8880",國泰證券,0,7,7,-1,4.09
"20200330","1783","0039003200320048","9200",凱基-復興,9,3,6,1,3.51
"20200330","1783","0037003700390065","7790",國票-南科,0,5,5,-1,2.92
"20200330","1783","7005","7000",兆豐-台中港,5,0,5,1,2.92
"20200330","1783","9835","9800",元大-員林中山,0,5,5,-1,2.92
"20200330","1783","9238","9200",凱基-士林,5,0,5,1,2.92
"20200330","1783","0039003800370041","9800",元大-楊梅,0,5,5,-1,2.92
"20200330","1783","0039004100390078","9A00",永豐金-桃園,5,0,5,1,2.92
"20200330","1783","9207","9200",凱基-永和,0,4,4,-1,2.34
"20200330","1783","9239","9200",凱基-市政,3,0,3,1,1.75
"20200330","1783","1560","1560",港商野村,0,3,3,-1,1.75
"20200330","1783","0039004100360031","9A00",永豐金-鳳山,3,0,3,1,1.75
"20200330","1783","003900360035004b","9600",富邦-台中,0,3,3,-1,1.75
"20200330","1783","8157","8150",台新-左楠,2,0,2,1,1.17
"20200330","1783","0031003100310046","1110",台灣企銀-北高雄,0,2,2,-1,1.17
"20200330","1783","9326","9300",華南永昌-南京,2,0,2,1,1.17
"20200330","1783","5925","5920",元富-台中,0,2,2,-1,1.17
"20200330","1783","9363","9300",華南永昌-彰化,2,0,2,1,1.17
"20200330","1783","5323","5320",高橋-內壢,1,3,2,-1,1.17
"20200331","1783","9366","9300",華南永昌-豐原,13,0,13,1,7.74
"20200331","1783","1440","1440",美林,0,25,25,-1,14.88
"20200331","1783","0039003800390059","9800",元大-基隆,13,0,13,1,7.74
"20200331","1783","1021","1020",合庫-台中,0,10,10,-1,5.95
"20200331","1783","6464","6460",大昌-新店,12,1,11,1,6.55
"20200331","1783","8710","8710",陽信,0,10,10,-1,5.95
"20200331","1783","9814","9800",元大-大益,10,0,10,1,5.95
"20200331","1783","8560","8560",新光,0,9,9,-1,5.36
"20200331","1783","9217","9200",凱基-松山,10,1,9,1,5.36
"20200331","1783","9206","9200",凱基-高雄,0,7,7,-1,4.17
"20200331","1783","9349","9300",華南永昌-板橋,10,2,8,1,4.76
"20200331","1783","1043","1040",臺銀-民權,0,5,5,-1,2.98
"20200331","1783","5323","5320",高橋-內壢,5,0,5,1,2.98
"20200331","1783","0039003800390041","9800",元大-北投,1,6,5,-1,2.98
"20200331","1783","0037003000300055","7000",兆豐-桃鶯,5,0,5,1,2.98
"20200331","1783","9838","9800",元大-豐原,0,4,4,-1,2.38
"20200331","1783","003700370039004a","7790",國票-北高雄,5,0,5,1,2.98
"20200331","1783","003700300030004e","7000",兆豐-埔墘,0,3,3,-1,1.79
"20200331","1783","9369","9300",華南永昌-三重,4,0,4,1,2.38
"20200331","1783","0039003600330041","9600",富邦-八德,0,3,3,-1,1.79
"20200331","1783","0038003400350055","8450",康和-台北,3,0,3,1,1.79
"20200331","1783","9679","9600",富邦-延吉(停),0,3,3,-1,1.79
"20200331","1783","9327","9300",華南永昌-斗六,3,0,3,1,1.79
"20200331","1783","0039004100390037","9A00",永豐金-新竹,0,3,3,-1,1.79
"20200331","1783","9815","9800",元大-大灣,3,0,3,1,1.79
"20200331","1783","1560","1560",港商野村,1,3,2,-1,1.19
"20200331","1783","0039004100390053","9A00",永豐金-南京,3,0,3,1,1.79
"20200331","1783","0038003100350041","8150",台新-高雄,0,2,2,-1,1.19
"20200203","1783","9327","9300",華南永昌-斗六,13,0,13,1,10.92
"20200203","1783","2181","2180",亞東-板橋,0,16,16,-1,13.45
"20200203","1783","9300","9300",華南永昌,12,0,12,1,10.08
"20200203","1783","5460","5460",寶盛,0,10,10,-1,8.40
"20200203","1783","003900380039005a","9800",元大-小港,10,0,10,1,8.40
"20200203","1783","9852","9800",元大-永春,5,10,5,-1,4.20
"20200203","1783","0039004100390042","9A00",永豐金-中和,9,0,9,1,7.56
"20200203","1783","7033","7030",致和-府前,0,4,4,-1,3.36
"20200203","1783","003500390032006c","5920",元富-大裕,5,0,5,1,4.20
"20200203","1783","9239","9200",凱基-市政,0,4,4,-1,3.36
"20200203","1783","0039003800310053","9800",元大-崇德,5,0,5,1,4.20
"20200203","1783","0037003000300063","7000",兆豐-民生,0,3,3,-1,2.52
"20200203","1783","8886","8880",國泰-新莊,3,0,3,1,2.52
"20200203","1783","8883","8880",國泰-松江,0,3,3,-1,2.52
"20200203","1783","0031003000340044","1040",臺銀-金山,2,0,2,1,1.68
"20200203","1783","0035003900320053","5920",元富-基隆,0,2,2,-1,1.68
"20200203","1783","0035003300380057","5380",第一金-華江,2,0,2,1,1.68
"20200203","1783","1020","1020",合庫證券,0,2,2,-1,1.68
"20200203","1783","6160","6160",中國信託,2,0,2,1,1.68
"20200203","1783","0038003400350055","8450",康和-台北,0,2,2,-1,1.68
"20200203","1783","9834","9800",元大-中壢,2,0,2,1,1.68
"20200203","1783","9856","9800",元大-花蓮,0,2,2,-1,1.68
"20200203","1783","0039003800390050","9800",元大-敦南,2,0,2,1,1.68
"20200203","1783","1470","1470",台灣摩根士丹利,0,1,1,-1,0.84
"20200203","1783","5321","5320",高橋-龍潭,1,0,1,1,0.84
"20200203","1783","1440","1440",美林,0,1,1,-1,0.84
"20200203","1783","5261","5260",美好-蘆洲,1,0,1,1,0.84
"20200203","1783","1028","1020",合庫-彰化,0,1,1,-1,0.84
"20200204","1783","0038003800340045","8840",玉山-城中,8,0,8,1,9.88
"20200204","1783","0039003800310044","9800",元大-南投,3,10,7,-1,8.64
"20200204","1783","0039003800340043","9800",元大-新店中正,5,0,5,1,6.17
"20200204","1783","5925","5920",元富-台中,0,6,6,-1,7.41
"20200204","1783","6461","6460",大昌-樹林,4,0,4,1,4.94
"20200204","1783","0039004100390071","9A00",永豐金-潮州,0,5,5,-1,6.17
"20200204","1783","9300","9300",華南永昌,4,1,3,1,3.70
"20200204","1783","0031003000320041","1020",合庫-新竹,0,4,4,-1,4.94
"20200204","1783","9666","9600",富邦-南屯,3,0,3,1,3.70
"20200204","1783","0036003100310041","6110",台中銀-豐原,0,4,4,-1,4.94
"20200204","1783","003900380039004c","9800",元大-成功,3,0,3,1,3.70
"20200204","1783","0035003900320044","5920",元富-大昌,0,3,3,-1,3.70
"20200204","1783","1440","1440",美林,2,0,2,1,2.47
"20200204","1783","5262","5260",美好-楊梅,1,4,3,-1,3.70
"20200204","1783","6114","6110",台中銀-員林,2,0,2,1,2.47
"20200204","1783","0037003700390058","7790",國票-中和,0,3,3,-1,3.70
"20200204","1783","003800340035004a","8450",康和-高雄,2,0,2,1,2.47
"20200204","1783","5321","5320",高橋-龍潭,0,2,2,-1,2.47
"20200204","1783","1480","1480",美商高盛,1,0,1,1,1.23
"20200204","1783","0036003300380041","6380",光和-嘉義,0,2,2,-1,2.47
"20200204","1783","1029","1020",合庫-鳳山,1,0,1,1,1.23
"20200204","1783","5850","5850",統一,0,1,1,-1,1.23
"20200204","1783","0031003200360058","1260",宏遠-新化,1,0,1,1,1.23
"20200204","1783","0035003300380045","5380",第一金-自由,0,1,1,-1,1.23
"20200204","1783","0035003300380057","5380",第一金-華江,1,0,1,1,1.23
"20200204","1783","0037003700390072","7790",國票-桃園,0,1,1,-1,1.23
"20200204","1783","003500330038004d","5380",第一金-嘉義,1,0,1,1,1.23
"20200204","1783","8711","8710",陽信-石牌,0,1,1,-1,1.23
"20200205","1783","0037003000300070","7000",兆豐-復興,10,0,10,1,5.29
"20200205","1783","9327","9300",華南永昌-斗六,0,13,13,-1,6.88
"20200205","1783","9852","9800",元大-永春,10,0,10,1,5.29
"20200205","1783","0039003100330055","9100",群益金鼎-崇德,0,10,10,-1,5.29
"20200205","1783","0038003800340045","8840",玉山-城中,9,0,9,1,4.76
"20200205","1783","1650","1650",新加坡商瑞銀,0,7,7,-1,3.70
"20200205","1783","9239","9200",凱基-市政,10,2,8,1,4.23
"20200205","1783","1021","1020",合庫-台中,0,6,6,-1,3.17
"20200205","1783","5260","5260",美好,5,0,5,1,2.65
"20200205","1783","1041","1040",臺銀-鳳山,0,5,5,-1,2.65
"20200205","1783","0037003000300052","7000",兆豐-小港,5,0,5,1,2.65
"20200205","1783","0039003800340043","9800",元大-新店中正,0,5,5,-1,2.65
"20200205","1783","9328","9300",華南永昌-潮州,5,0,5,1,2.65
"20200205","1783","9869","9800",元大-新盛,0,5,5,-1,2.65
"20200205","1783","5850","5850",統一,4,0,4,1,2.12
"20200205","1783","6464","6460",大昌-新店,0,4,4,-1,2.12
"20200205","1783","9217","9200",凱基-松山,4,0,4,1,2.12
"20200205","1783","0038003400350046","8450",康和-仁愛,0,4,4,-1,2.12
"20200205","1783","003500390032007a","5920",元富-文心,3,0,3,1,1.59
"20200205","1783","1440","1440",美林,8,11,3,-1,1.59
"20200205","1783","9188","9100",群益金鼎-三民,3,0,3,1,1.59
"20200205","1783","5859","5850",統一-屏東,0,3,3,-1,1.59
"20200205","1783","0039003800370041","9800",元大-楊梅,3,0,3,1,1.59
"20200205","1783","6161","6160",中國信託-三重,0,3,3,-1,1.59
"20200205","1783","1480","1480",美商高盛,2,0,2,1,1.06
"20200205","1783","0037003000300042","7000",兆豐-板橋,0,3,3,-1,1.59
"20200205","1783","1034","1030",土銀-嘉義,2,0,2,1,1.06
"20200205","1783","0035003900320051","5920",元富-敦南,0,2,2,-1,1.06
"20200206","1783","0037003000300077","7000",兆豐-新莊,10,0,10,1,3.82
"20200206","1783","1261","1260",宏遠-民生,0,20,20,-1,7.63
"20200206","1783","9315","9300",華南永昌-苑裡,10,0,10,1,3.82
"20200206","1783","9239","9200",凱基-市政,0,10,10,-1,3.82
"20200206","1783","5386","5380",第一金-彰化,9,0,9,1,3.44
"20200206","1783","0039003100330055","9100",群益金鼎-崇德,0,8,8,-1,3.05
"20200206","1783","0038003800340045","8840",玉山-城中,8,0,8,1,3.05
"20200206","1783","003500390032006c","5920",元富-大裕,0,5,5,-1,1.91
"20200206","1783","0039003100380044","9100",群益金鼎-東門,6,0,6,1,2.29
"20200206","1783","9272","9200",凱基-竹科,0,5,5,-1,1.91
"20200206","1783","8888","8880",國泰-敦南,4,0,4,1,1.53
"20200206","1783","9647","9600",富邦-新竹,2,7,5,-1,1.91
"20200206","1783","0039003800370041","9800",元大-楊梅,4,0,4,1,1.53
"20200206","1783","8156","8150",台新-三民,0,4,4,-1,1.53
"20200206","1783","8560","8560",新光,3,0,3,1,1.15
"20200206","1783","9878","9800",元大-金華,0,3,3,-1,1.15
"20200206","1783","9324","9300",華南永昌-岡山,3,0,3,1,1.15
"20200206","1783","1034","1030",土銀-嘉義,0,2,2,-1,0.76
"20200206","1783","7795","7790",國票-南港,2,0,2,1,0.76
"20200206","1783","1440","1440",美林,0,2,2,-1,0.76
"20200206","1783","0039003100380047","9100",群益金鼎-新莊,2,0,2,1,0.76
"20200206","1783","6165","6160",中國信託-新竹,0,2,2,-1,0.76
"20200206","1783","9235","9200",凱基-永華,2,0,2,1,0.76
"20200206","1783","8847","8840",玉山-台南,0,2,2,-1,0.76
"20200206","1783","0035003900320061","5920",元富-松德,1,0,1,1,0.38
"20200206","1783","9306","9300",華南永昌-台南,0,2,2,-1,0.76
"20200206","1783","5927","5920",元富-林園,1,0,1,1,0.38
"20200206","1783","9837","9800",元大-北港,2,4,2,-1,0.76
"20200207","1783","9324","9300",華南永昌-岡山,17,0,17,1,19.54
"20200207","1783","8440","8440",摩根大通,0,10,10,-1,11.49
"20200207","1783","9308","9300",華南永昌-麻豆,10,0,10,1,11.49
"20200207","1783","8841","8840",玉山-雙和,0,10,10,-1,11.49
"20200207","1783","0039003800340043","9800",元大-新店中正,10,0,10,1,11.49
"20200207","1783","1440","1440",美林,0,7,7,-1,8.05
"20200207","1783","0031003100310042","1110",台灣企銀-建成,4,0,4,1,4.60
"20200207","1783","1043","1040",臺銀-民權,0,5,5,-1,5.75
"20200207","1783","0035003900320079","5920",元富-花蓮,2,0,2,1,2.30
"20200207","1783","0039003100330055","9100",群益金鼎-崇德,0,5,5,-1,5.75
"20200207","1783","003500390032007a","5920",元富-文心,2,0,2,1,2.30
"20200207","1783","9322","9300",華南永昌-公誠,0,5,5,-1,5.75
"20200207","1783","8584","8580",聯邦-雙和,2,0,2,1,2.30
"20200207","1783","1650","1650",新加坡商瑞銀,2,6,4,-1,4.60
"20200207","1783","9655","9600",富邦-板橋,2,0,2,1,2.30
"20200207","1783","8157","8150",台新-左楠,0,4,4,-1,4.60
"20200207","1783","003900360035004b","9600",富邦-台中,2,0,2,1,2.30
"20200207","1783","1260","1260",宏遠證券,0,3,3,-1,3.45
"20200207","1783","0039003800310046","9800",元大-福營,2,0,2,1,2.30
"20200207","1783","9136","9100",群益金鼎-西松,0,2,2,-1,2.30
"20200207","1783","5850","5850",統一,1,0,1,1,1.15
"20200207","1783","003900320031004d","9200",凱基-八德,0,2,2,-1,2.30
"20200207","1783","0031003000340044","1040",臺銀-金山,1,0,1,1,1.15
"20200207","1783","9608","9600",富邦-台東,0,2,2,-1,2.30
"20200207","1783","1033","1030",土銀-高雄,1,0,1,1,1.15
"20200207","1783","0035003900320041","5920",元富-緯城,0,1,1,-1,1.15
"20200207","1783","0037003000300050","7000",兆豐-南京,1,0,1,1,1.15
"20200207","1783","5927","5920",元富-林園,0,1,1,-1,1.15
"20200210","1783","0031003100310042","1110",台灣企銀-建成,5,0,5,1,3.70
"20200210","1783","0039003800310052","9800",元大-竹山,0,12,12,-1,8.89
"20200210","1783","6464","6460",大昌-新店,5,0,5,1,3.70
"20200210","1783","0039004100390052","9A00",永豐金-信義,0,11,11,-1,8.15
"20200210","1783","0037003700390050","7790",國票-九鼎,5,0,5,1,3.70
"20200210","1783","9852","9800",元大-永春,0,10,10,-1,7.41
"20200210","1783","0039003800390057","9800",元大-豐原站前,5,0,5,1,3.70
"20200210","1783","0039003800310053","9800",元大-崇德,0,8,8,-1,5.93
"20200210","1783","7798","7790",國票-內壢,4,0,4,1,2.96
"20200210","1783","0031003200360055","1260",宏遠-館前,0,7,7,-1,5.19
"20200210","1783","9667","9600",富邦-台南,4,0,4,1,2.96
"20200210","1783","9272","9200",凱基-竹科,0,5,5,-1,3.70
"20200210","1783","1233","1230",彰銀-台中,3,0,3,1,2.22
"20200210","1783","0039003800390045","9800",元大-草屯,0,5,5,-1,3.70
"20200210","1783","0039003100330055","9100",群益金鼎-崇德,9,6,3,1,2.22
"20200210","1783","9825","9800",元大-新營,0,4,4,-1,2.96
"20200210","1783","9233","9200",凱基-長庚,3,0,3,1,2.22
"20200210","1783","8560","8560",新光,2,5,3,-1,2.22
"20200210","1783","0039003800390049","9800",元大-蘆洲,3,0,3,1,2.22
"20200210","1783","9884","9800",元大-斗信,0,3,3,-1,2.22
"20200210","1783","5321","5320",高橋-龍潭,2,0,2,1,1.48
"20200210","1783","1650","1650",新加坡商瑞銀,0,2,2,-1,1.48
"20200210","1783","5320","5320",高橋,2,0,2,1,1.48
"20200210","1783","0035003800350048","5850",統一-桃園,0,2,2,-1,1.48
"20200210","1783","1480","1480",美商高盛,2,0,2,1,1.48
"20200210","1783","0039003100330067","9100",群益金鼎-三重,0,2,2,-1,1.48
"20200210","1783","003500390032007a","5920",元富-文心,2,0,2,1,1.48
"20200210","1783","0039003100380065","9100",群益金鼎-大安,0,2,2,-1,1.48
"20200211","1783","0039003800340043","9800",元大-新店中正,10,0,10,1,20.83
"20200211","1783","0039003800310046","9800",元大-福營,0,6,6,-1,12.50
"20200211","1783","7791","7790",國票-台東,5,0,5,1,10.42
"20200211","1783","6385","6380",光和-花壇,0,5,5,-1,10.42
"20200211","1783","003700370039004a","7790",國票-北高雄,5,0,5,1,10.42
"20200211","1783","0035003900320050","5920",元富-同大,0,4,4,-1,8.33
"20200211","1783","0035003800350041","5850",統一-基隆,2,0,2,1,4.17
"20200211","1783","6450","6450",永全證券,0,2,2,-1,4.17
"20200211","1783","0035003900320061","5920",元富-松德,1,0,1,1,2.08
"20200211","1783","8846","8840",玉山-板橋,0,2,2,-1,4.17
"20200211","1783","6464","6460",大昌-新店,1,0,1,1,2.08
"20200211","1783","9889","9800",元大-員林,0,2,2,-1,4.17
"20200211","1783","7007","7000",兆豐-竹北,1,0,1,1,2.08
"20200211","1783","6163","6160",中國信託-永康,0,1,1,-1,2.08
"20200211","1783","8150","8150",台新證券,1,0,1,1,2.08
"20200211","1783","5858","5850",統一-嘉義,0,1,1,-1,2.08
"20200211","1783","0038003100350059","8150",台新-新營,1,0,1,1,2.08
"20200211","1783","1480","1480",美商高盛,0,1,1,-1,2.08
"20200211","1783","0039003100380067","9100",群益金鼎-大甲,1,0,1,1,2.08
"20200211","1783","1440","1440",美林,0,1,1,-1,2.08
"20200211","1783","003900310038004a","9100",群益金鼎-永和,1,0,1,1,2.08
"20200211","1783","1260","1260",宏遠證券,0,1,1,-1,2.08
"20200211","1783","9285","9200",凱基-中壢,1,0,1,1,2.08
"20200211","1783","1041","1040",臺銀-鳳山,0,1,1,-1,2.08
"20200211","1783","9302","9300",華南永昌-台中,1,0,1,1,2.08
"20200211","1783","003700370039006d","7790",國票-中港,0,1,1,-1,2.08
"20200211","1783","003900360031004a","9600",富邦-興業,1,0,1,1,2.08
"20200211","1783","0038003100350048","8150",台新-屏東,0,1,1,-1,2.08
"20200212","1783","0039003100380047","9100",群益金鼎-新莊,8,0,8,1,9.64
"20200212","1783","0039003800310053","9800",元大-崇德,0,10,10,-1,12.05
"20200212","1783","0039003800340043","9800",元大-新店中正,0,10,10,-1,12.05
"20200212","1783","9308","9300",華南永昌-麻豆,5,0,5,1,6.02
"20200212","1783","9695","9600",富邦-民雄(停),0,5,5,-1,6.02
"20200212","1783","0039003800390044","9800",元大-左營,5,0,5,1,6.02
"20200212","1783","9825","9800",元大-新營,0,5,5,-1,6.02
"20200212","1783","9300","9300",華南永昌,4,0,4,1,4.82
"20200212","1783","003900380039006d","9800",元大-信義,0,5,5,-1,6.02
"20200212","1783","1021","1020",合庫-台中,3,0,3,1,3.61
"20200212","1783","003900360031004c","9600",富邦-士林,0,4,4,-1,4.82
"20200212","1783","0039003100380067","9100",群益金鼎-大甲,3,0,3,1,3.61
"20200212","1783","0031003200360051","1260",宏遠-高雄,0,2,2,-1,2.41
"20200212","1783","9349","9300",華南永昌-板橋,3,0,3,1,3.61
"20200212","1783","9285","9200",凱基-中壢,0,2,2,-1,2.41
"20200212","1783","0036003000310064","6010",(牛牛牛)亞-鑫豐,2,0,2,1,2.41
"20200212","1783","0039004100390042","9A00",永豐金-中和,0,2,2,-1,2.41
"20200212","1783","5386","5380",第一金-彰化,2,0,2,1,2.41
"20200212","1783","0037003000300042","7000",兆豐-板橋,0,1,1,-1,1.20
"20200212","1783","0037003700390045","7790",國票-南崁,2,0,2,1,2.41
"20200212","1783","7007","7000",兆豐-竹北,0,1,1,-1,1.20
"20200212","1783","0037003700390058","7790",國票-中和,2,0,2,1,2.41
"20200212","1783","0037003000300073","7000",兆豐-岡山,0,1,1,-1,1.20
"20200212","1783","0039003800320042","9800",元大-博愛,2,0,2,1,2.41
"20200212","1783","1440","1440",美林,0,1,1,-1,1.20
"20200212","1783","9838","9800",元大-豐原,2,0,2,1,2.41
"20200212","1783","0039003100380075","9100",群益金鼎-瑞豐,0,1,1,-1,1.20
"20200213","1783","0039003100330055","9100",群益金鼎-崇德,15,0,15,1,7.46
"20200213","1783","0037003000300044","7000",兆豐-西螺,0,20,20,-1,9.95
"20200213","1783","8584","8580",聯邦-雙和,14,0,14,1,6.97
"20200213","1783","0039003100380050","9100",群益金鼎-天母,0,15,15,-1,7.46
"20200213","1783","0039003100380067","9100",群益金鼎-大甲,14,0,14,1,6.97
"20200213","1783","8887","8880",國泰-忠孝,0,11,11,-1,5.47
"20200213","1783","0038003100350042","8150",台新-台中,10,0,10,1,4.98
"20200213","1783","5856","5850",統一-台中,0,7,7,-1,3.48
"20200213","1783","9349","9300",華南永昌-板橋,10,0,10,1,4.98
"20200213","1783","1650","1650",新加坡商瑞銀,0,6,6,-1,2.99
"20200213","1783","003900410039004e","9A00",永豐金-桃盛,10,0,10,1,4.98
"20200213","1783","0039003100380044","9100",群益金鼎-東門,0,6,6,-1,2.99
"20200213","1783","003900320030004e","9200",凱基-湖口,9,0,9,1,4.48
"20200213","1783","0039004100300030","9A00",永豐金證券,0,5,5,-1,2.49
"20200213","1783","0039004100390064","9A00",永豐金-古亭,6,0,6,1,2.99
"20200213","1783","0036003300380041","6380",光和-嘉義,0,3,3,-1,1.49
"20200213","1783","0039003800340043","9800",元大-新店中正,5,0,5,1,2.49
"20200213","1783","003500390032004c","5920",元富-中壢,0,2,2,-1,1.00
"20200213","1783","6464","6460",大昌-新店,4,0,4,1,1.99
"20200213","1783","8382","8380",安泰-楠梓,0,2,2,-1,1.00
"20200213","1783","8150","8150",台新證券,4,0,4,1,1.99
"20200213","1783","1480","1480",美商高盛,1,2,1,-1,0.50
"20200213","1783","9334","9300",華南永昌-世貿,4,0,4,1,1.99
"20200213","1783","1440","1440",美林,0,1,1,-1,0.50
"20200213","1783","0039003600320041","9600",富邦-信義,4,0,4,1,1.99
"20200213","1783","1041","1040",臺銀-鳳山,0,1,1,-1,0.50
"20200213","1783","5855","5850",統一-台南,3,0,3,1,1.49
"20200213","1783","0035003800350041","5850",統一-基隆,0,1,1,-1,0.50
"20200214","1783","0035003800350048","5850",統一-桃園,16,0,16,1,16.67
"20200214","1783","003900360031004c","9600",富邦-士林,0,16,16,-1,16.67
"20200214","1783","9343","9300",華南永昌-頭份,10,0,10,1,10.42
"20200214","1783","8584","8580",聯邦-雙和,0,14,14,-1,14.58
"20200214","1783","0035003800350067","5850",統一-平鎮,5,0,5,1,5.21
"20200214","1783","6165","6160",中國信託-新竹,0,5,5,-1,5.21
"20200214","1783","9339","9300",華南永昌-竹北,5,0,5,1,5.21
"20200214","1783","0039003100330044","9100",群益金鼎-潭子,0,5,5,-1,5.21
"20200214","1783","5859","5850",統一-屏東,3,0,3,1,3.13
"20200214","1783","9852","9800",元大-永春,0,5,5,-1,5.21
"20200214","1783","1021","1020",合庫-台中,3,0,3,1,3.13
"20200214","1783","0037003000300042","7000",兆豐-板橋,0,4,4,-1,4.17
"20200214","1783","1520","1520",瑞士信貸,2,0,2,1,2.08
"20200214","1783","5856","5850",統一-台中,0,3,3,-1,3.13
"20200214","1783","9801","9800",元大-城東,2,0,2,1,2.08
"20200214","1783","9189","9100",群益金鼎-桃園,0,2,2,-1,2.08
"20200214","1783","0039003800390049","9800",元大-蘆洲,2,0,2,1,2.08
"20200214","1783","0039003600320055","9600",富邦-縣政,0,2,2,-1,2.08
"20200214","1783","003500330038004d","5380",第一金-嘉義,1,0,1,1,1.04
"20200214","1783","0039003800300065","9800",元大-清水,0,2,2,-1,2.08
"20200214","1783","5384","5380",第一金-台南,1,0,1,1,1.04
"20200214","1783","0039003800340048","9800",元大-景美,0,2,2,-1,2.08
"20200214","1783","0031003000340043","1040",臺銀-高雄,1,0,1,1,1.04
"20200214","1783","0039003800390046","9800",元大-高雄,0,2,2,-1,2.08
"20200214","1783","1480","1480",美商高盛,1,0,1,1,1.04
"20200214","1783","0035003800350044","5850",統一-新台中,0,1,1,-1,1.04
"20200214","1783","0035003900320049","5920",元富-嘉義,1,0,1,1,1.04
"20200214","1783","003500320036004c","5260",美好-長榮(停),0,1,1,-1,1.04
"20200217","1783","8849","8840",玉山-景美,12,0,12,1,2.38
"20200217","1783","003900380039004c","9800",元大-成功,1,24,23,-1,4.56
"20200217","1783","2186","2180",亞東-高雄,10,0,10,1,1.98
"20200217","1783","8887","8880",國泰-忠孝,0,16,16,-1,3.17
"20200217","1783","003700370039007a","7790",國票-博愛,10,0,10,1,1.98
"20200217","1783","9852","9800",元大-永春,0,15,15,-1,2.98
"20200217","1783","0039003100330055","9100",群益金鼎-崇德,10,0,10,1,1.98
"20200217","1783","0035003800350067","5850",統一-平鎮,0,10,10,-1,1.98
"20200217","1783","9186","9100",群益金鼎-新竹,10,0,10,1,1.98
"20200217","1783","003900380031006e","9800",元大-旗山,0,10,10,-1,1.98
"20200217","1783","0039003800310055","9800",元大-華山,10,0,10,1,1.98
"20200217","1783","0035003800350059","5850",統一-土城,0,7,7,-1,1.39
"20200217","1783","9858","9800",元大-龍潭,6,0,6,1,1.19
"20200217","1783","0038003100350042","8150",台新-台中,0,5,5,-1,0.99
"20200217","1783","6950","6950",福勝,5,0,5,1,0.99
"20200217","1783","0037003000300052","7000",兆豐-小港,5,0,5,1,0.99
"20200217","1783","0039004100390064","9A00",永豐金-古亭,0,5,5,-1,0.99
"20200217","1783","0038003100350041","8150",台新-高雄,5,0,5,1,0.99
"20200217","1783","6464","6460",大昌-新店,0,4,4,-1,0.79
"20200217","1783","003800340035004a","8450",康和-高雄,5,0,5,1,0.99
"20200217","1783","5859","5850",統一-屏東,0,3,3,-1,0.60
"20200217","1783","003500390032007a","5920",元富-文心,4,0,4,1,0.79
"20200217","1783","8157","8150",台新-左楠,4,7,3,-1,0.60
"20200217","1783","8880","8880",國泰證券,3,0,3,1,0.60
"20200217","1783","003900380036004b","9800",元大-基隆孝二,0,3,3,-1,0.60
"20200217","1783","9362","9300",華南永昌-苗栗,3,0,3,1,0.60
"20200217","1783","0039003800390056","9800",元大-北三重,0,3,3,-1,0.60
"20200218","1783","8880","8880",國泰證券,22,0,22,1,22.45
"20200218","1783","9852","9800",元大-永春,0,10,10,-1,10.20
"20200218","1783","0035003800350049","5850",統一-員林,6,0,6,1,6.12
"20200218","1783","9894","9800",元大-桃興,0,10,10,-1,10.20
"20200218","1783","0039004100390078","9A00",永豐金-桃園,5,0,5,1,5.10
"20200218","1783","9223","9200",凱基-豐中,0,7,7,-1,7.14
"20200218","1783","9665","9600",富邦-桃園,3,0,3,1,3.06
"20200218","1783","1043","1040",臺銀-民權,0,6,6,-1,6.12
"20200218","1783","003900410039004a","9A00",永豐金-板新,3,0,3,1,3.06
"20200218","1783","1041","1040",臺銀-鳳山,0,5,5,-1,5.10
"20200218","1783","0035003300380044","5380",第一金-忠孝,2,0,2,1,2.04
"20200218","1783","1440","1440",美林,0,4,4,-1,4.08
"20200218","1783","9189","9100",群益金鼎-桃園,2,0,2,1,2.04
"20200218","1783","0039003800310046","9800",元大-福營,0,4,4,-1,4.08
"20200218","1783","9359","9300",華南永昌-中正,2,0,2,1,2.04
"20200218","1783","0039003800310052","9800",元大-竹山,0,4,4,-1,4.08
"20200218","1783","9697","9600",富邦-虎尾,2,0,2,1,2.04
"20200218","1783","5320","5320",高橋,0,3,3,-1,3.06
"20200218","1783","9837","9800",元大-北港,2,0,2,1,2.04
"20200218","1783","0039003600310056","9600",富邦-板橋中山,0,3,3,-1,3.06
"20200218","1783","0035003300380057","5380",第一金-華江,1,0,1,1,1.02
"20200218","1783","6950","6950",福勝,0,2,2,-1,2.04
"20200218","1783","7032","7030",致和-佳里,1,0,1,1,1.02
"20200218","1783","1020","1020",合庫證券,0,1,1,-1,1.02
"20200218","1783","7007","7000",兆豐-竹北,1,0,1,1,1.02
"20200218","1783","0035003900320061","5920",元富-松德,0,1,1,-1,1.02
"20200218","1783","003500390032007a","5920",元富-文心,1,0,1,1,1.02
"20200218","1783","0035003800350041","5850",統一-基隆,0,1,1,-1,1.02
"20200219","1783","1440","1440",美林,7,0,7,1,12.96
"20200219","1783","0039004100390061","9A00",永豐金-苓雅,0,5,5,-1,9.26
"20200219","1783","0039003100380047","9100",群益金鼎-新莊,4,0,4,1,7.41
"20200219","1783","003900360031004c","9600",富邦-士林,0,4,4,-1,7.41
"20200219","1783","1470","1470",台灣摩根士丹利,2,0,2,1,3.70
"20200219","1783","0039004100390052","9A00",永豐金-信義,0,3,3,-1,5.56
"20200219","1783","8849","8840",玉山-景美,2,0,2,1,3.70
"20200219","1783","003600310036004b","6160",中國信託-高雄,0,2,2,-1,3.70
"20200219","1783","0038003800340048","8840",玉山-新竹,2,0,2,1,3.70
"20200219","1783","0038003100350042","8150",台新-台中,0,2,2,-1,3.70
"20200219","1783","0039003100380067","9100",群益金鼎-大甲,2,0,2,1,3.70
"20200219","1783","0039003800350043","9800",元大-鳳中,0,2,2,-1,3.70
"20200219","1783","9317","9300",華南永昌-林口,2,0,2,1,3.70
"20200219","1783","1520","1520",瑞士信貸,0,1,1,-1,1.85
"20200219","1783","9659","9600",富邦-高雄,2,0,2,1,3.70
"20200219","1783","003500390032006e","5920",元富-西松,0,1,1,-1,1.85
"20200219","1783","9837","9800",元大-北港,2,0,2,1,3.70
"20200219","1783","0035003900320063","5920",元富-烏日,0,1,1,-1,1.85
"20200219","1783","1480","1480",美商高盛,1,0,1,1,1.85
"20200219","1783","6382","6380",光和-田中,0,1,1,-1,1.85
"20200219","1783","0038003400350053","8450",康和-南崁,1,0,1,1,1.85
"20200219","1783","0035003800350044","5850",統一-新台中,0,1,1,-1,1.85
"20200219","1783","8847","8840",玉山-台南,1,0,1,1,1.85
"20200219","1783","5260","5260",美好,0,1,1,-1,1.85
"20200219","1783","9300","9300",華南永昌,1,0,1,1,1.85
"20200219","1783","7007","7000",兆豐-竹北,0,1,1,-1,1.85
"20200219","1783","0039004100390039","9A00",永豐金-中壢,1,0,1,1,1.85
"20200219","1783","8520","8520",中農,0,1,1,-1,1.85
"20200220","1783","0039003100330055","9100",群益金鼎-崇德,25,0,25,1,18.66
"20200220","1783","6461","6460",大昌-樹林,0,10,10,-1,7.46
"20200220","1783","0035003300380041","5380",第一金-新興,10,0,10,1,7.46
"20200220","1783","0039003800310061","9800",元大-歸仁,0,10,10,-1,7.46
"20200220","1783","0035003900320055","5920",元富-宜蘭,10,0,10,1,7.46
"20200220","1783","1021","1020",合庫-台中,0,6,6,-1,4.48
"20200220","1783","0039003800300077","9800",元大-西屯,10,0,10,1,7.46
"20200220","1783","1041","1040",臺銀-鳳山,0,5,5,-1,3.73
"20200220","1783","8380","8380",安泰,5,0,5,1,3.73
"20200220","1783","9339","9300",華南永昌-竹北,0,5,5,-1,3.73
"20200220","1783","0039003100380047","9100",群益金鼎-新莊,5,0,5,1,3.73
"20200220","1783","9868","9800",元大-文心,0,5,5,-1,3.73
"20200220","1783","003500390032007a","5920",元富-文心,4,0,4,1,2.99
"20200220","1783","003900320030004e","9200",凱基-湖口,0,4,4,-1,2.99
"20200220","1783","8847","8840",玉山-台南,4,0,4,1,2.99
"20200220","1783","9334","9300",華南永昌-世貿,0,4,4,-1,2.99
"20200220","1783","0039003100380067","9100",群益金鼎-大甲,4,0,4,1,2.99
"20200220","1783","0038003100350042","8150",台新-台中,0,3,3,-1,2.24
"20200220","1783","9837","9800",元大-北港,4,0,4,1,2.99
"20200220","1783","9233","9200",凱基-長庚,0,3,3,-1,2.24
"20200220","1783","1470","1470",台灣摩根士丹利,3,0,3,1,2.24
"20200220","1783","9362","9300",華南永昌-苗栗,0,3,3,-1,2.24
"20200220","1783","9254","9200",凱基-科園,3,0,3,1,2.24
"20200220","1783","0039003600310048","9600",富邦-新板,0,3,3,-1,2.24
"20200220","1783","9686","9600",富邦-宜蘭,3,0,3,1,2.24
"20200220","1783","0037003000300063","7000",兆豐-民生,0,2,2,-1,1.49
"20200220","1783","1480","1480",美商高盛,1,0,1,1,0.75
"20200220","1783","8560","8560",新光,0,2,2,-1,1.49
"20200221","1783","1650","1650",新加坡商瑞銀,8,0,8,1,10.26
"20200221","1783","1041","1040",臺銀-鳳山,0,6,6,-1,7.69
"20200221","1783","0037003700390050","7790",國票-九鼎,10,4,6,1,7.69
"20200221","1783","0038003100350041","8150",台新-高雄,0,5,5,-1,6.41
"20200221","1783","1440","1440",美林,5,1,4,1,5.13
"20200221","1783","9266","9200",凱基-新豐,0,5,5,-1,6.41
"20200221","1783","0031003200360044","1260",宏遠-台南,3,0,3,1,3.85
"20200221","1783","8520","8520",中農,0,4,4,-1,5.13
"20200221","1783","1470","1470",台灣摩根士丹利,3,0,3,1,3.85
"20200221","1783","003900360031004c","9600",富邦-士林,0,4,4,-1,5.13
"20200221","1783","0035003300380044","5380",第一金-忠孝,3,0,3,1,3.85
"20200221","1783","0039003800390042","9800",元大-台中中港,0,4,4,-1,5.13
"20200221","1783","0038003800340042","8840",玉山-台中,4,1,3,1,3.85
"20200221","1783","1480","1480",美商高盛,0,2,2,-1,2.56
"20200221","1783","5321","5320",高橋-龍潭,2,0,2,1,2.56
"20200221","1783","6385","6380",光和-花壇,0,2,2,-1,2.56
"20200221","1783","0039003100380067","9100",群益金鼎-大甲,2,0,2,1,2.56
"20200221","1783","9206","9200",凱基-高雄,0,2,2,-1,2.56
"20200221","1783","003900360035004b","9600",富邦-台中,2,0,2,1,2.56
"20200221","1783","0039003600310044","9600",富邦-忠孝,0,2,2,-1,2.56
"20200221","1783","0031003200360069","1260",宏遠-光隆,1,0,1,1,1.28
"20200221","1783","9898","9800",元大-新莊,0,2,2,-1,2.56
"20200221","1783","0031003000330041","1030",土銀-建國,1,0,1,1,1.28
"20200221","1783","0031003100310046","1110",台灣企銀-北高雄,0,1,1,-1,1.28
"20200221","1783","0037003000300073","7000",兆豐-岡山,1,0,1,1,1.28
"20200221","1783","0031003000340043","1040",臺銀-高雄,0,1,1,-1,1.28
"20200221","1783","9184","9100",群益金鼎-台中,1,0,1,1,1.28
"20200221","1783","5660","5660",日進,0,1,1,-1,1.28
"20200224","1783","1440","1440",美林,18,2,16,1,8.42
"20200224","1783","0039004100390078","9A00",永豐金-桃園,0,12,12,-1,6.32
"20200224","1783","0039003600320044","9600",富邦-新莊,10,0,10,1,5.26
"20200224","1783","2186","2180",亞東-高雄,0,10,10,-1,5.26
"20200224","1783","003800380034004a","8840",玉山-大里,7,0,7,1,3.68
"20200224","1783","1041","1040",臺銀-鳳山,0,10,10,-1,5.26
"20200224","1783","0037003000300073","7000",兆豐-岡山,6,0,6,1,3.16
"20200224","1783","003700370039007a","7790",國票-博愛,0,10,10,-1,5.26
"20200224","1783","0039004100390061","9A00",永豐金-苓雅,6,0,6,1,3.16
"20200224","1783","0035003800350059","5850",統一-土城,0,8,8,-1,4.21
"20200224","1783","0035003300380044","5380",第一金-忠孝,5,0,5,1,2.63
"20200224","1783","6451","6450",永全-南崁,0,6,6,-1,3.16
"20200224","1783","8849","8840",玉山-景美,5,0,5,1,2.63
"20200224","1783","0035003300380042","5380",第一金-新竹,0,5,5,-1,2.63
"20200224","1783","1470","1470",台灣摩根士丹利,4,0,4,1,2.11
"20200224","1783","0037003000300052","7000",兆豐-小港,0,5,5,-1,2.63
"20200224","1783","9349","9300",華南永昌-板橋,4,0,4,1,2.11
"20200224","1783","003900320030004e","9200",凱基-湖口,0,5,5,-1,2.63
"20200224","1783","0039003800310043","9800",元大-路竹,4,0,4,1,2.11
"20200224","1783","9339","9300",華南永昌-竹北,0,5,5,-1,2.63
"20200224","1783","5859","5850",統一-屏東,3,0,3,1,1.58
"20200224","1783","9636","9600",富邦-中壢,0,3,3,-1,1.58
"20200224","1783","0039003800310046","9800",元大-福營,3,0,3,1,1.58
"20200224","1783","003900360035004b","9600",富邦-台中,0,3,3,-1,1.58
"20200224","1783","9872","9800",元大-復北,3,0,3,1,1.58
"20200224","1783","003500390032006e","5920",元富-西松,0,2,2,-1,1.05
"20200224","1783","0035003300380059","5380",第一金-中壢,2,0,2,1,1.05
"20200224","1783","6160","6160",中國信託,0,2,2,-1,1.05
"20200225","1783","0035003300380057","5380",第一金-華江,3,0,3,1,8.33
"20200225","1783","8560","8560",新光,0,3,3,-1,8.33
"20200225","1783","1260","1260",宏遠證券,3,0,3,1,8.33
"20200225","1783","0038003800340044","8840",玉山-左營,0,3,3,-1,8.33
"20200225","1783","0039003200300046","9200",凱基-站前,3,0,3,1,8.33
"20200225","1783","1440","1440",美林,0,2,2,-1,5.56
"20200225","1783","6161","6160",中國信託-三重,2,0,2,1,5.56
"20200225","1783","1480","1480",美商高盛,0,2,2,-1,5.56
"20200225","1783","1470","1470",台灣摩根士丹利,2,0,2,1,5.56
"20200225","1783","9134","9100",群益金鼎-開元,0,2,2,-1,5.56
"20200225","1783","0035003800350044","5850",統一-新台中,1,0,1,1,2.78
"20200225","1783","9302","9300",華南永昌-台中,0,2,2,-1,5.56
"20200225","1783","0031003000340041","1040",臺銀-臺中,1,0,1,1,2.78
"20200225","1783","0039004100390038","9A00",永豐金-大園,0,2,2,-1,5.56
"20200225","1783","003500390032004d","5920",元富-彰化,1,0,1,1,2.78
"20200225","1783","5854","5850",統一-城中,0,1,1,-1,2.78
"20200225","1783","6460","6460",大昌,1,0,1,1,2.78
"20200225","1783","1020","1020",合庫證券,0,1,1,-1,2.78
"20200225","1783","9136","9100",群益金鼎-西松,1,0,1,1,2.78
"20200225","1783","0035003800350051","5850",統一-三多,0,1,1,-1,2.78
"20200225","1783","0039003100330044","9100",群益金鼎-潭子,1,0,1,1,2.78
"20200225","1783","8563","8560",新光-新竹,0,1,1,-1,2.78
"20200225","1783","0039003100380067","9100",群益金鼎-大甲,1,0,1,1,2.78
"20200225","1783","0039003100380069","9100",群益金鼎-竹南,0,1,1,-1,2.78
"20200225","1783","9211","9200",凱基-台南,1,0,1,1,2.78
"20200225","1783","003900310038004d","9100",群益金鼎-嘉義,0,1,1,-1,2.78
"20200225","1783","0039003600320041","9600",富邦-信義,1,0,1,1,2.78
"20200225","1783","9257","9200",凱基-林口,0,1,1,-1,2.78
"20200226","1783","8560","8560",新光,5,0,5,1,6.17
"20200226","1783","0039003600320044","9600",富邦-新莊,0,10,10,-1,12.35
"20200226","1783","0039004100390064","9A00",永豐金-古亭,6,1,5,1,6.17
"20200226","1783","0038003800340044","8840",玉山-左營,0,7,7,-1,8.64
"20200226","1783","9317","9300",華南永昌-林口,4,0,4,1,4.94
"20200226","1783","1440","1440",美林,0,5,5,-1,6.17
"20200226","1783","0039004100390078","9A00",永豐金-桃園,4,0,4,1,4.94
"20200226","1783","003900360031004e","9600",富邦-西壢,0,5,5,-1,6.17
"20200226","1783","0037003700390050","7790",國票-九鼎,3,0,3,1,3.70
"20200226","1783","0039003800390041","9800",元大-北投,0,5,5,-1,6.17
"20200226","1783","003900320030004e","9200",凱基-湖口,3,0,3,1,3.70
"20200226","1783","0037003000300073","7000",兆豐-岡山,0,4,4,-1,4.94
"20200226","1783","0039004100390065","9A00",永豐金-高雄,3,0,3,1,3.70
"20200226","1783","0035003900320051","5920",元富-敦南,0,3,3,-1,3.70
"20200226","1783","8159","8150",台新-台南,2,0,2,1,2.47
"20200226","1783","0039003100380064","9100",群益金鼎-內湖,0,3,3,-1,3.70
"20200226","1783","0039003100330052","9100",群益金鼎-北高雄,2,0,2,1,2.47
"20200226","1783","0039003800390067","9800",元大-嘉義,0,3,3,-1,3.70
"20200226","1783","9349","9300",華南永昌-板橋,2,0,2,1,2.47
"20200226","1783","0036003300380041","6380",光和-嘉義,0,2,2,-1,2.47
"20200226","1783","0039003600320041","9600",富邦-信義,2,0,2,1,2.47
"20200226","1783","0035003800350053","5850",統一-宜蘭,0,2,2,-1,2.47
"20200226","1783","0036003000310064","6010",(牛牛牛)亞-鑫豐,1,0,1,1,1.23
"20200226","1783","003900360031004c","9600",富邦-士林,0,2,2,-1,2.47
"20200226","1783","0035003800350044","5850",統一-新台中,1,0,1,1,1.23
"20200226","1783","9814","9800",元大-大益,0,2,2,-1,2.47
"20200226","1783","5856","5850",統一-台中,1,0,1,1,1.23
"20200226","1783","7795","7790",國票-南港,0,1,1,-1,1.23
"20200227","1783","0039003800310055","9800",元大-華山,10,0,10,1,7.30
"20200227","1783","1440","1440",美林,2,19,17,-1,12.41
"20200227","1783","0039004100390064","9A00",永豐金-古亭,10,0,10,1,7.30
"20200227","1783","1041","1040",臺銀-鳳山,0,15,15,-1,10.95
"20200227","1783","0037003000300052","7000",兆豐-小港,5,0,5,1,3.65
"20200227","1783","0039003800320043","9800",元大-六合,0,10,10,-1,7.30
"20200227","1783","0037003700390050","7790",國票-九鼎,5,0,5,1,3.65
"20200227","1783","003800380034004a","8840",玉山-大里,0,7,7,-1,5.11
"20200227","1783","9324","9300",華南永昌-岡山,5,0,5,1,3.65
"20200227","1783","9323","9300",華南永昌-小港,0,7,7,-1,5.11
"20200227","1783","003900380039004e","9800",元大-內湖,5,0,5,1,3.65
"20200227","1783","0039003800310044","9800",元大-南投,0,5,5,-1,3.65
"20200227","1783","0031003000340043","1040",臺銀-高雄,4,0,4,1,2.92
"20200227","1783","0039003800310067","9800",元大-大里,0,5,5,-1,3.65
"20200227","1783","0037003700390045","7790",國票-南崁,4,0,4,1,2.92
"20200227","1783","1470","1470",台灣摩根士丹利,1,5,4,-1,2.92
"20200227","1783","9134","9100",群益金鼎-開元,4,0,4,1,2.92
"20200227","1783","0039004100390069","9A00",永豐金-新店,0,4,4,-1,2.92
"20200227","1783","9307","9300",華南永昌-大安,4,0,4,1,2.92
"20200227","1783","1650","1650",新加坡商瑞銀,0,2,2,-1,1.46
"20200227","1783","9317","9300",華南永昌-林口,4,0,4,1,2.92
"20200227","1783","6161","6160",中國信託-三重,0,2,2,-1,1.46
"20200227","1783","0039004100390078","9A00",永豐金-桃園,3,0,3,1,2.19
"20200227","1783","003900310038007a","9100",群益金鼎-宜蘭,0,2,2,-1,1.46
"20200227","1783","0035003800350044","5850",統一-新台中,2,0,2,1,1.46
"20200227","1783","0039003600320056","9600",富邦-復興,0,2,2,-1,1.46
"20200227","1783","5858","5850",統一-嘉義,3,1,2,1,1.46
"20200227","1783","9634","9600",富邦-羅東,0,2,2,-1,1.46
"20200102","1783","9874","9800",元大-雙和,10,1,9,1,7.14
"20200102","1783","2181","2180",亞東-板橋,0,11,11,-1,8.73
"20200102","1783","003800380034004a","8840",玉山-大里,7,0,7,1,5.56
"20200102","1783","003700300030004e","7000",兆豐-埔墘,0,10,10,-1,7.94
"20200102","1783","9666","9600",富邦-南屯,7,0,7,1,5.56
"20200102","1783","8560","8560",新光,0,8,8,-1,6.35
"20200102","1783","0039003600320058","9600",富邦-文化,5,0,5,1,3.97
"20200102","1783","003900310038007a","9100",群益金鼎-宜蘭,0,4,4,-1,3.17
"20200102","1783","9189","9100",群益金鼎-桃園,4,0,4,1,3.17
"20200102","1783","0039003600390043","9600",富邦-北港,0,4,4,-1,3.17
"20200102","1783","0039003100380067","9100",群益金鼎-大甲,4,0,4,1,3.17
"20200102","1783","9852","9800",元大-永春,0,4,4,-1,3.17
"20200102","1783","9623","9600",富邦-台北,4,0,4,1,3.17
"20200102","1783","1440","1440",美林,0,3,3,-1,2.38
"20200102","1783","9838","9800",元大-豐原,4,0,4,1,3.17
"20200102","1783","8882","8880",國泰-台中,0,3,3,-1,2.38
"20200102","1783","0039003800370041","9800",元大-楊梅,4,0,4,1,3.17
"20200102","1783","0039003100380046","9100",群益金鼎-新店,0,3,3,-1,2.38
"20200102","1783","003900380039004c","9800",元大-成功,4,0,4,1,3.17
"20200102","1783","9317","9300",華南永昌-林口,0,3,3,-1,2.38
"20200102","1783","1650","1650",新加坡商瑞銀,8,5,3,1,2.38
"20200102","1783","0039003600310043","9600",富邦-南京,1,4,3,-1,2.38
"20200102","1783","8520","8520",中農,3,0,3,1,2.38
"20200102","1783","9800","9800",元大證券,0,3,3,-1,2.38
"20200102","1783","1520","1520",瑞士信貸,9,7,2,1,1.59
"20200102","1783","0039003200300046","9200",凱基-站前,0,2,2,-1,1.59
"20200102","1783","1042","1040",臺銀-臺南,2,0,2,1,1.59
"20200102","1783","0039003200310053","9200",凱基-幸福,0,2,2,-1,1.59
"20200103","1783","0037003700390050","7790",國票-九鼎,20,0,20,1,12.66
"20200103","1783","1440","1440",美林,2,17,15,-1,9.49
"20200103","1783","9329","9300",華南永昌-朴子,20,0,20,1,12.66
"20200103","1783","9211","9200",凱基-台南,1,13,12,-1,7.59
"20200103","1783","9852","9800",元大-永春,10,0,10,1,6.33
"20200103","1783","0039003800370041","9800",元大-楊梅,9,0,9,1,5.70
"20200103","1783","9268","9200",凱基-台北,0,9,9,-1,5.70
"20200103","1783","1650","1650",新加坡商瑞銀,7,0,7,1,4.43
"20200103","1783","9874","9800",元大-雙和,0,9,9,-1,5.70
"20200103","1783","0037003000300050","7000",兆豐-南京,6,0,6,1,3.80
"20200103","1783","0037003700390058","7790",國票-中和,0,6,6,-1,3.80
"20200103","1783","9216","9200",凱基-信義,6,0,6,1,3.80
"20200103","1783","1470","1470",台灣摩根士丹利,2,7,5,-1,3.16
"20200103","1783","003900360035004b","9600",富邦-台中,4,0,4,1,2.53
"20200103","1783","1043","1040",臺銀-民權,0,5,5,-1,3.16
"20200103","1783","003900380039004e","9800",元大-內湖,4,0,4,1,2.53
"20200103","1783","0036003300380044","6380",光和-高雄,0,5,5,-1,3.16
"20200103","1783","5920","5920",元富,3,0,3,1,1.90
"20200103","1783","9859","9800",元大-新竹經國,0,5,5,-1,3.16
"20200103","1783","0039003100330055","9100",群益金鼎-崇德,3,0,3,1,1.90
"20200103","1783","5260","5260",美好,0,3,3,-1,1.90
"20200103","1783","0039003600310043","9600",富邦-南京,3,0,3,1,1.90
"20200103","1783","9875","9800",元大-土城永寧,0,3,3,-1,1.90
"20200103","1783","003500390032007a","5920",元富-文心,2,0,2,1,1.27
"20200103","1783","0036003300380041","6380",光和-嘉義,0,2,2,-1,1.27
"20200103","1783","0039003100380047","9100",群益金鼎-新莊,2,0,2,1,1.27
"20200103","1783","003700300030005a","7000",兆豐-高雄,0,2,2,-1,1.27
"20200106","1783","2181","2180",亞東-板橋,20,0,20,1,6.10
"20200106","1783","1470","1470",台灣摩根士丹利,0,30,30,-1,9.15
"20200106","1783","1480","1480",美商高盛,17,1,16,1,4.88
"20200106","1783","9814","9800",元大-大益,0,26,26,-1,7.93
"20200106","1783","9208","9200",凱基-桃園,15,0,15,1,4.57
"20200106","1783","0037003000300042","7000",兆豐-板橋,14,0,14,1,4.27
"20200106","1783","1520","1520",瑞士信貸,0,21,21,-1,6.40
"20200106","1783","9137","9100",群益金鼎-士林,13,0,13,1,3.96
"20200106","1783","9358","9300",華南永昌-東勢,0,21,21,-1,6.40
"20200106","1783","0037003000300066","7000",兆豐-鹿港,10,0,10,1,3.05
"20200106","1783","1440","1440",美林,3,19,16,-1,4.88
"20200106","1783","8157","8150",台新-左楠,10,0,10,1,3.05
"20200106","1783","9651","9600",富邦-民生(停),0,15,15,-1,4.57
"20200106","1783","8520","8520",中農,10,0,10,1,3.05
"20200106","1783","6012","6010",(牛牛牛)亞-網路,0,14,14,-1,4.27
"20200106","1783","9317","9300",華南永昌-林口,10,0,10,1,3.05
"20200106","1783","1650","1650",新加坡商瑞銀,1,12,11,-1,3.35
"20200106","1783","9852","9800",元大-永春,10,0,10,1,3.05
"20200106","1783","9366","9300",華南永昌-豐原,0,10,10,-1,3.05
"20200106","1783","0039003600310043","9600",富邦-南京,7,0,7,1,2.13
"20200106","1783","003900380039006a","9800",元大-樹林,0,10,10,-1,3.05
"20200106","1783","0035003900320045","5920",元富-城中,5,0,5,1,1.52
"20200106","1783","9216","9200",凱基-信義,0,6,6,-1,1.83
"20200106","1783","0037003700390050","7790",國票-九鼎,5,0,5,1,1.52
"20200106","1783","9268","9200",凱基-台北,0,5,5,-1,1.52
"20200106","1783","0039003100330055","9100",群益金鼎-崇德,5,0,5,1,1.52
"20200106","1783","9309","9300",華南永昌-古亭,0,5,5,-1,1.52
"20200107","1783","0037003000300048","7000",兆豐-東門,20,0,20,1,11.83
"20200107","1783","9651","9600",富邦-民生(停),0,15,15,-1,8.88
"20200107","1783","0037003700390050","7790",國票-九鼎,6,0,6,1,3.55
"20200107","1783","0039003100380067","9100",群益金鼎-大甲,0,14,14,-1,8.28
"20200107","1783","003700300030004e","7000",兆豐-埔墘,5,0,5,1,2.96
"20200107","1783","1440","1440",美林,2,14,12,-1,7.10
"20200107","1783","9223","9200",凱基-豐中,4,0,4,1,2.37
"20200107","1783","0035003200360041","5260",美好-中和,0,10,10,-1,5.92
"20200107","1783","003900410039004d","9A00",永豐金-南投,4,0,4,1,2.37
"20200107","1783","6164","6160",中國信託-文心,0,10,10,-1,5.92
"20200107","1783","0031003100310042","1110",台灣企銀-建成,3,0,3,1,1.78
"20200107","1783","8883","8880",國泰-松江,0,9,9,-1,5.33
"20200107","1783","1021","1020",合庫-台中,3,0,3,1,1.78
"20200107","1783","8840","8840",玉山證券,0,6,6,-1,3.55
"20200107","1783","6012","6010",(牛牛牛)亞-網路,3,0,3,1,1.78
"20200107","1783","0039004100390066","9A00",永豐金-中盛,0,6,6,-1,3.55
"20200107","1783","0035003800350048","5850",統一-桃園,2,0,2,1,1.18
"20200107","1783","1590","1590",花旗環球,0,5,5,-1,2.96
"20200107","1783","003500390032005a","5920",元富-安南,2,0,2,1,1.18
"20200107","1783","0038003400350045","8450",康和-澎湖,0,5,5,-1,2.96
"20200107","1783","6160","6160",中國信託,2,0,2,1,1.18
"20200107","1783","003900360032004a","9600",富邦-三峽,0,5,5,-1,2.96
"20200107","1783","003800340035004a","8450",康和-高雄,2,0,2,1,1.18
"20200107","1783","0038003100350059","8150",台新-新營,0,4,4,-1,2.37
"20200107","1783","8842","8840",玉山-新莊,2,0,2,1,1.18
"20200107","1783","0039003800350043","9800",元大-鳳中,0,4,4,-1,2.37
"20200107","1783","9208","9200",凱基-桃園,2,0,2,1,1.18
"20200107","1783","1650","1650",新加坡商瑞銀,4,7,3,-1,1.78
"20200108","1783","0039003100330055","9100",群益金鼎-崇德,10,0,10,1,7.94
"20200108","1783","003500390032007a","5920",元富-文心,0,13,13,-1,10.32
"20200108","1783","003900320030005a","9200",凱基-台東,10,0,10,1,7.94
"20200108","1783","1590","1590",花旗環球,0,8,8,-1,6.35
"20200108","1783","9315","9300",華南永昌-苑裡,10,0,10,1,7.94
"20200108","1783","0039004100390059","9A00",永豐金-板盛,0,8,8,-1,6.35
"20200108","1783","1470","1470",台灣摩根士丹利,10,3,7,1,5.56
"20200108","1783","003900360035004b","9600",富邦-台中,5,10,5,-1,3.97
"20200108","1783","1021","1020",合庫-台中,4,0,4,1,3.17
"20200108","1783","1440","1440",美林,0,4,4,-1,3.17
"20200108","1783","5855","5850",統一-台南,3,0,3,1,2.38
"20200108","1783","0036003300380041","6380",光和-嘉義,0,4,4,-1,3.17
"20200108","1783","003900320031004d","9200",凱基-八德,3,0,3,1,2.38
"20200108","1783","9135","9100",群益金鼎-東大,0,4,4,-1,3.17
"20200108","1783","0039003800350043","9800",元大-鳳中,3,0,3,1,2.38
"20200108","1783","8565","8560",新光-桃園,0,3,3,-1,2.38
"20200108","1783","0039004100390078","9A00",永豐金-桃園,3,0,3,1,2.38
"20200108","1783","9211","9200",凱基-台南,0,3,3,-1,2.38
"20200108","1783","5260","5260",美好,2,0,2,1,1.59
"20200108","1783","9235","9200",凱基-永華,0,3,3,-1,2.38
"20200108","1783","5320","5320",高橋,2,0,2,1,1.59
"20200108","1783","9322","9300",華南永昌-公誠,0,3,3,-1,2.38
"20200108","1783","6380","6380",光和,2,0,2,1,1.59
"20200108","1783","003900380031006e","9800",元大-旗山,0,3,3,-1,2.38
"20200108","1783","0037003700390045","7790",國票-南崁,2,0,2,1,1.59
"20200108","1783","0039004100390031","9A00",永豐金-松山,0,3,3,-1,2.38
"20200108","1783","8842","8840",玉山-新莊,2,0,2,1,1.59
"20200108","1783","0035003800350049","5850",統一-員林,2,4,2,-1,1.59
"20200109","1783","9898","9800",元大-新莊,12,0,12,1,14.29
"20200109","1783","2186","2180",亞東-高雄,0,10,10,-1,11.90
"20200109","1783","0031003100310042","1110",台灣企銀-建成,6,0,6,1,7.14
"20200109","1783","7795","7790",國票-南港,0,10,10,-1,11.90
"20200109","1783","0039003800310053","9800",元大-崇德,6,0,6,1,7.14
"20200109","1783","9693","9600",富邦-新營,0,5,5,-1,5.95
"20200109","1783","8560","8560",新光,4,0,4,1,4.76
"20200109","1783","5384","5380",第一金-台南,0,3,3,-1,3.57
"20200109","1783","0039003800370041","9800",元大-楊梅,4,0,4,1,4.76
"20200109","1783","003100320036004c","1260",宏遠-台中,0,3,3,-1,3.57
"20200109","1783","1470","1470",台灣摩根士丹利,4,1,3,1,3.57
"20200109","1783","1260","1260",宏遠證券,0,3,3,-1,3.57
"20200109","1783","8150","8150",台新證券,3,0,3,1,3.57
"20200109","1783","6115","6110",台中銀-台北,0,2,2,-1,2.38
"20200109","1783","5263","5260",美好-泰山,2,0,2,1,2.38
"20200109","1783","1440","1440",美林,1,3,2,-1,2.38
"20200109","1783","2181","2180",亞東-板橋,2,0,2,1,2.38
"20200109","1783","003900310038004a","9100",群益金鼎-永和,0,2,2,-1,2.38
"20200109","1783","8156","8150",台新-三民,2,0,2,1,2.38
"20200109","1783","9302","9300",華南永昌-台中,0,2,2,-1,2.38
"20200109","1783","8584","8580",聯邦-雙和,2,0,2,1,2.38
"20200109","1783","1480","1480",美商高盛,0,1,1,-1,1.19
"20200109","1783","8842","8840",玉山-新莊,2,0,2,1,2.38
"20200109","1783","0035003800350046","5850",統一-彰化,0,1,1,-1,1.19
"20200109","1783","9308","9300",華南永昌-麻豆,2,0,2,1,2.38
"20200109","1783","003800380038004b","8880",國泰-板橋,0,1,1,-1,1.19
"20200109","1783","9672","9600",富邦-員林,2,0,2,1,2.38
"20200109","1783","9212","9200",凱基-東港,0,1,1,-1,1.19
"20200110","1783","003900410039004d","9A00",永豐金-南投,12,0,12,1,12.77
"20200110","1783","8840","8840",玉山證券,0,13,13,-1,13.83
"20200110","1783","8440","8440",摩根大通,7,0,7,1,7.45
"20200110","1783","6012","6010",(牛牛牛)亞-網路,0,11,11,-1,11.70
"20200110","1783","0031003100310042","1110",台灣企銀-建成,6,0,6,1,6.38
"20200110","1783","6162","6160",中國信託-忠孝,0,4,4,-1,4.26
"20200110","1783","9801","9800",元大-城東,5,0,5,1,5.32
"20200110","1783","9237","9200",凱基-敦北,0,4,4,-1,4.26
"20200110","1783","0039003800310053","9800",元大-崇德,5,0,5,1,5.32
"20200110","1783","5603","5600",永興-台中,0,3,3,-1,3.19
"20200110","1783","0039003800370041","9800",元大-楊梅,4,0,4,1,4.26
"20200110","1783","8150","8150",台新證券,0,3,3,-1,3.19
"20200110","1783","0039003100380067","9100",群益金鼎-大甲,3,0,3,1,3.19
"20200110","1783","9337","9300",華南永昌-內壢,0,3,3,-1,3.19
"20200110","1783","003900310038007a","9100",群益金鼎-宜蘭,3,0,3,1,3.19
"20200110","1783","003900360032004b","9600",富邦-中和,0,3,3,-1,3.19
"20200110","1783","5320","5320",高橋,2,0,2,1,2.13
"20200110","1783","003500390032007a","5920",元富-文心,0,2,2,-1,2.13
"20200110","1783","5262","5260",美好-楊梅,2,0,2,1,2.13
"20200110","1783","0035003900320041","5920",元富-緯城,0,2,2,-1,2.13
"20200110","1783","0039003200300041","9200",凱基-板橋,2,0,2,1,2.13
"20200110","1783","9667","9600",富邦-台南,0,2,2,-1,2.13
"20200110","1783","9677","9600",富邦-三重,2,0,2,1,2.13
"20200110","1783","0039003800310068","9800",元大-屏東民生,0,2,2,-1,2.13
"20200110","1783","9893","9800",元大-大天母,2,0,2,1,2.13
"20200110","1783","0039003800350043","9800",元大-鳳中,0,2,2,-1,2.13
"20200110","1783","1470","1470",台灣摩根士丹利,1,0,1,1,1.06
"20200110","1783","6115","6110",台中銀-台北,0,1,1,-1,1.06
"20200113","1783","9315","9300",華南永昌-苑裡,10,0,10,1,9.71
"20200113","1783","003500390032007a","5920",元富-文心,0,10,10,-1,9.71
"20200113","1783","0035003800350052","5850",統一-汐止,5,0,5,1,4.85
"20200113","1783","0039003800350043","9800",元大-鳳中,0,10,10,-1,9.71
"20200113","1783","9634","9600",富邦-羅東,5,0,5,1,4.85
"20200113","1783","0039003800390041","9800",元大-北投,0,10,10,-1,9.71
"20200113","1783","0039003800310053","9800",元大-崇德,5,0,5,1,4.85
"20200113","1783","1470","1470",台灣摩根士丹利,0,7,7,-1,6.80
"20200113","1783","0031003100310042","1110",台灣企銀-建成,4,0,4,1,3.88
"20200113","1783","9666","9600",富邦-南屯,0,5,5,-1,4.85
"20200113","1783","003500320036004b","5260",美好-富順,3,0,3,1,2.91
"20200113","1783","9676","9600",富邦-仁愛,0,5,5,-1,4.85
"20200113","1783","0035003900320069","5920",元富-中港,3,0,3,1,2.91
"20200113","1783","9838","9800",元大-豐原,0,5,5,-1,4.85
"20200113","1783","9233","9200",凱基-長庚,3,0,3,1,2.91
"20200113","1783","5852","5850",統一-敦南,0,3,3,-1,2.91
"20200113","1783","9817","9800",元大-東泰,3,0,3,1,2.91
"20200113","1783","8847","8840",玉山-台南,0,3,3,-1,2.91
"20200113","1783","0037003000300073","7000",兆豐-岡山,2,0,2,1,1.94
"20200113","1783","9285","9200",凱基-中壢,0,3,3,-1,2.91
"20200113","1783","8150","8150",台新證券,2,0,2,1,1.94
"20200113","1783","0037003700390050","7790",國票-九鼎,0,2,2,-1,1.94
"20200113","1783","8380","8380",安泰,2,0,2,1,1.94
"20200113","1783","0039003600310053","9600",富邦-景美,0,2,2,-1,1.94
"20200113","1783","8885","8880",國泰-桃園,2,0,2,1,1.94
"20200113","1783","9661","9600",富邦-新店,0,2,2,-1,1.94
"20200113","1783","0039003100380067","9100",群益金鼎-大甲,2,0,2,1,1.94
"20200113","1783","5321","5320",高橋-龍潭,0,1,1,-1,0.97
"20200114","1783","0037003700390050","7790",國票-九鼎,5,0,5,1,7.81
"20200114","1783","0039003800320042","9800",元大-博愛,0,8,8,-1,12.50
"20200114","1783","0039003100330055","9100",群益金鼎-崇德,5,0,5,1,7.81
"20200114","1783","9623","9600",富邦-台北,2,8,6,-1,9.38
"20200114","1783","1440","1440",美林,4,0,4,1,6.25
"20200114","1783","003800380034004a","8840",玉山-大里,0,5,5,-1,7.81
"20200114","1783","9134","9100",群益金鼎-開元,3,0,3,1,4.69
"20200114","1783","0035003900320069","5920",元富-中港,0,3,3,-1,4.69
"20200114","1783","0039003100380067","9100",群益金鼎-大甲,3,0,3,1,4.69
"20200114","1783","8451","8450",康和-延平,0,3,3,-1,4.69
"20200114","1783","9208","9200",凱基-桃園,3,0,3,1,4.69
"20200114","1783","003900310038007a","9100",群益金鼎-宜蘭,0,3,3,-1,4.69
"20200114","1783","9300","9300",華南永昌,3,0,3,1,4.69
"20200114","1783","003500330038004d","5380",第一金-嘉義,0,2,2,-1,3.13
"20200114","1783","003500390032007a","5920",元富-文心,2,0,2,1,3.13
"20200114","1783","1470","1470",台灣摩根士丹利,0,2,2,-1,3.13
"20200114","1783","0035003300380041","5380",第一金-新興,2,0,2,1,3.13
"20200114","1783","0031003000320045","1020",合庫-桃園,0,2,2,-1,3.13
"20200114","1783","0039003200300043","9200",凱基-雙和,2,0,2,1,3.13
"20200114","1783","1480","1480",美商高盛,0,1,1,-1,1.56
"20200114","1783","9216","9200",凱基-信義,2,0,2,1,3.13
"20200114","1783","0035003900320044","5920",元富-大昌,0,1,1,-1,1.56
"20200114","1783","9234","9200",凱基-竹北,2,0,2,1,3.13
"20200114","1783","003500380035004a","5850",統一-三重,0,1,1,-1,1.56
"20200114","1783","003900360035004b","9600",富邦-台中,2,0,2,1,3.13
"20200114","1783","6115","6110",台中銀-台北,0,1,1,-1,1.56
"20200114","1783","0039003800390045","9800",元大-草屯,2,0,2,1,3.13
"20200114","1783","0035003900320050","5920",元富-同大,0,1,1,-1,1.56
"20200115","1783","8150","8150",台新證券,10,0,10,1,11.24
"20200115","1783","9859","9800",元大-新竹經國,0,10,10,-1,11.24
"20200115","1783","0039003200300041","9200",凱基-板橋,10,0,10,1,11.24
"20200115","1783","9137","9100",群益金鼎-士林,0,7,7,-1,7.87
"20200115","1783","0039003800310041","9800",元大-鶯歌,7,0,7,1,7.87
"20200115","1783","0035003300380057","5380",第一金-華江,0,5,5,-1,5.62
"20200115","1783","0035003900320045","5920",元富-城中,5,0,5,1,5.62
"20200115","1783","9309","9300",華南永昌-古亭,0,5,5,-1,5.62
"20200115","1783","0035003800350059","5850",統一-土城,3,0,3,1,3.37
"20200115","1783","9268","9200",凱基-台北,0,4,4,-1,4.49
"20200115","1783","0039003100380067","9100",群益金鼎-大甲,3,0,3,1,3.37
"20200115","1783","0039003800390041","9800",元大-北投,0,4,4,-1,4.49
"20200115","1783","9216","9200",凱基-信義,3,0,3,1,3.37
"20200115","1783","0035003900320057","5920",元富-吉利,0,3,3,-1,3.37
"20200115","1783","9300","9300",華南永昌,3,0,3,1,3.37
"20200115","1783","0031003000340041","1040",臺銀-臺中,0,2,2,-1,2.25
"20200115","1783","1440","1440",美林,2,0,2,1,2.25
"20200115","1783","8710","8710",陽信,0,2,2,-1,2.25
"20200115","1783","1021","1020",合庫-台中,2,0,2,1,2.25
"20200115","1783","9296","9200",凱基-頭份,0,2,2,-1,2.25
"20200115","1783","5320","5320",高橋,2,0,2,1,2.25
"20200115","1783","9672","9600",富邦-員林,0,2,2,-1,2.25
"20200115","1783","9343","9300",華南永昌-頭份,2,0,2,1,2.25
"20200115","1783","0039003800390065","9800",元大-中和,0,2,2,-1,2.25
"20200115","1783","9800","9800",元大證券,2,0,2,1,2.25
"20200115","1783","0035003900320056","5920",元富-民權(停),0,1,1,-1,1.12
"20200115","1783","0037003000300050","7000",兆豐-南京,1,0,1,1,1.12
"20200115","1783","1480","1480",美商高盛,0,1,1,-1,1.12
"20200116","1783","1020","1020",合庫證券,10,0,10,1,7.58
"20200116","1783","0039003600310053","9600",富邦-景美,0,12,12,-1,9.09
"20200116","1783","0037003700390050","7790",國票-九鼎,10,0,10,1,7.58
"20200116","1783","8885","8880",國泰-桃園,0,10,10,-1,7.58
"20200116","1783","0039003100330055","9100",群益金鼎-崇德,9,0,9,1,6.82
"20200116","1783","9137","9100",群益金鼎-士林,0,7,7,-1,5.30
"20200116","1783","0031003200360044","1260",宏遠-台南,5,0,5,1,3.79
"20200116","1783","9268","9200",凱基-台北,0,6,6,-1,4.55
"20200116","1783","0031003100310042","1110",台灣企銀-建成,5,0,5,1,3.79
"20200116","1783","7791","7790",國票-台東,0,5,5,-1,3.79
"20200116","1783","0039003200300041","9200",凱基-板橋,5,0,5,1,3.79
"20200116","1783","0039003800340043","9800",元大-新店中正,15,20,5,-1,3.79
"20200116","1783","003800380038004b","8880",國泰-板橋,4,0,4,1,3.03
"20200116","1783","0035003300380057","5380",第一金-華江,0,4,4,-1,3.03
"20200116","1783","0039003100380067","9100",群益金鼎-大甲,4,0,4,1,3.03
"20200116","1783","003900380031007a","9800",元大-大統,0,4,4,-1,3.03
"20200116","1783","003500390032007a","5920",元富-文心,3,0,3,1,2.27
"20200116","1783","1480","1480",美商高盛,0,3,3,-1,2.27
"20200116","1783","0031003200360058","1260",宏遠-新化,2,0,2,1,1.52
"20200116","1783","5263","5260",美好-泰山,0,2,2,-1,1.52
"20200116","1783","6913","6910",德信-新營,2,0,2,1,1.52
"20200116","1783","5260","5260",美好,0,2,2,-1,1.52
"20200116","1783","7798","7790",國票-內壢,2,0,2,1,1.52
"20200116","1783","0037003000300073","7000",兆豐-岡山,0,2,2,-1,1.52
"20200116","1783","8440","8440",摩根大通,2,0,2,1,1.52
"20200116","1783","0039003100380063","9100",群益金鼎-鳳山,0,2,2,-1,1.52
"20200116","1783","9216","9200",凱基-信義,2,0,2,1,1.52
"20200116","1783","0039003600330041","9600",富邦-八德,0,2,2,-1,1.52
"20200117","1783","003500390032007a","5920",元富-文心,27,0,27,1,13.57
"20200117","1783","9369","9300",華南永昌-三重,0,20,20,-1,10.05
"20200117","1783","0031003100310042","1110",台灣企銀-建成,18,0,18,1,9.05
"20200117","1783","1113","1110",台灣企銀-九如,0,10,10,-1,5.03
"20200117","1783","8560","8560",新光,15,0,15,1,7.54
"20200117","1783","5851","5850",統一-高雄,0,9,9,-1,4.52
"20200117","1783","9852","9800",元大-永春,10,0,10,1,5.03
"20200117","1783","9268","9200",凱基-台北,0,8,8,-1,4.02
"20200117","1783","0036003300380041","6380",光和-嘉義,6,0,6,1,3.02
"20200117","1783","0037003000300043","7000",兆豐-來福,0,5,5,-1,2.51
"20200117","1783","003900380033006a","9800",元大-仁愛,6,0,6,1,3.02
"20200117","1783","9672","9600",富邦-員林,0,5,5,-1,2.51
"20200117","1783","9858","9800",元大-龍潭,6,0,6,1,3.02
"20200117","1783","8843","8840",玉山-高雄,0,3,3,-1,1.51
"20200117","1783","1440","1440",美林,5,0,5,1,2.51
"20200117","1783","9233","9200",凱基-長庚,0,3,3,-1,1.51
"20200117","1783","0037003700390050","7790",國票-九鼎,5,0,5,1,2.51
"20200117","1783","0039003800320043","9800",元大-六合,0,3,3,-1,1.51
"20200117","1783","9211","9200",凱基-台南,5,0,5,1,2.51
"20200117","1783","003900380033005a","9800",元大-鳳山,0,3,3,-1,1.51
"20200117","1783","9317","9300",華南永昌-林口,4,0,4,1,2.01
"20200117","1783","003900410039004a","9A00",永豐金-板新,0,3,3,-1,1.51
"20200117","1783","7798","7790",國票-內壢,3,0,3,1,1.51
"20200117","1783","0039003200300041","9200",凱基-板橋,0,2,2,-1,1.01
"20200117","1783","9229","9200",凱基-中山,3,0,3,1,1.51
"20200117","1783","003900360031004b","9600",富邦-七賢,0,2,2,-1,1.01
"20200117","1783","0035003900320063","5920",元富-烏日,2,0,2,1,1.01
"20200117","1783","9856","9800",元大-花蓮,0,2,2,-1,1.01
"20200120","1783","0031003000320043","1020",合庫-自強,15,0,15,1,8.77
"20200120","1783","6165","6160",中國信託-新竹,0,31,31,-1,18.13
"20200120","1783","9216","9200",凱基-信義,11,0,11,1,6.43
"20200120","1783","003500390032007a","5920",元富-文心,0,30,30,-1,17.54
"20200120","1783","0039003200300044","9200",凱基-市府,10,0,10,1,5.85
"20200120","1783","003900380031006d","9800",元大-前金,0,5,5,-1,2.92
"20200120","1783","003900380031006a","9800",元大-士林,10,0,10,1,5.85
"20200120","1783","5920","5920",元富,0,4,4,-1,2.34
"20200120","1783","9217","9200",凱基-松山,6,0,6,1,3.51
"20200120","1783","0039004100390053","9A00",永豐金-南京,0,4,4,-1,2.34
"20200120","1783","9322","9300",華南永昌-公誠,5,0,5,1,2.92
"20200120","1783","8560","8560",新光,3,7,4,-1,2.34
"20200120","1783","9339","9300",華南永昌-竹北,5,0,5,1,2.92
"20200120","1783","8883","8880",國泰-松江,0,3,3,-1,1.75
"20200120","1783","0039003800330042","9800",元大-林森,5,0,5,1,2.92
"20200120","1783","0035003800350050","5850",統一-板橋,0,2,2,-1,1.17
"20200120","1783","0039003600320041","9600",富邦-信義,4,0,4,1,2.34
"20200120","1783","003500380035004a","5850",統一-三重,0,2,2,-1,1.17
"20200120","1783","9800","9800",元大證券,4,0,4,1,2.34
"20200120","1783","0037003000300042","7000",兆豐-板橋,0,2,2,-1,1.17
"20200120","1783","0039003800350043","9800",元大-鳳中,5,1,4,1,2.34
"20200120","1783","003800380034004a","8840",玉山-大里,0,2,2,-1,1.17
"20200120","1783","1260","1260",宏遠證券,3,0,3,1,1.75
"20200120","1783","9239","9200",凱基-市政,0,2,2,-1,1.17
"20200120","1783","0039003100380067","9100",群益金鼎-大甲,3,0,3,1,1.75
"20200120","1783","9272","9200",凱基-竹科,0,2,2,-1,1.17
"20200120","1783","9208","9200",凱基-桃園,3,0,3,1,1.75
"20200120","1783","0039003800390065","9800",元大-中和,0,2,2,-1,1.17
"20200130","1783","0036003300380041","6380",光和-嘉義,17,2,15,1,4.21
"20200130","1783","003600310036004b","6160",中國信託-高雄,0,30,30,-1,8.43
"20200130","1783","0039003100330055","9100",群益金鼎-崇德,22,7,15,1,4.21
"20200130","1783","6165","6160",中國信託-新竹,0,26,26,-1,7.30
"20200130","1783","0039004100390038","9A00",永豐金-大園,15,0,15,1,4.21
"20200130","1783","2181","2180",亞東-板橋,0,25,25,-1,7.02
"20200130","1783","1440","1440",美林,20,9,11,1,3.09
"20200130","1783","9216","9200",凱基-信義,0,20,20,-1,5.62
"20200130","1783","9238","9200",凱基-士林,10,0,10,1,2.81
"20200130","1783","8881","8880",國泰-高雄,1,20,19,-1,5.34
"20200130","1783","0039003800310053","9800",元大-崇德,10,0,10,1,2.81
"20200130","1783","9666","9600",富邦-南屯,0,17,17,-1,4.78
"20200130","1783","0039003800310055","9800",元大-華山,10,0,10,1,2.81
"20200130","1783","6385","6380",光和-花壇,0,13,13,-1,3.65
"20200130","1783","8560","8560",新光,9,0,9,1,2.53
"20200130","1783","0039004100390072","9A00",永豐金-北高雄,0,13,13,-1,3.65
"20200130","1783","9825","9800",元大-新營,9,0,9,1,2.53
"20200130","1783","5385","5380",第一金-桃園,0,10,10,-1,2.81
"20200130","1783","9853","9800",元大-南屯,9,0,9,1,2.53
"20200130","1783","0037003000300044","7000",兆豐-西螺,0,10,10,-1,2.81
"20200130","1783","0039004100390042","9A00",永豐金-中和,8,0,8,1,2.25
"20200130","1783","9239","9200",凱基-市政,0,8,8,-1,2.25
"20200130","1783","9134","9100",群益金鼎-開元,7,0,7,1,1.97
"20200130","1783","0039003800350043","9800",元大-鳳中,0,7,7,-1,1.97
"20200130","1783","0039003800370041","9800",元大-楊梅,7,0,7,1,1.97
"20200130","1783","0039004100390067","9A00",永豐金-內湖,0,7,7,-1,1.97
"20200130","1783","6012","6010",(牛牛牛)亞-網路,5,0,5,1,1.40
"20200130","1783","1470","1470",台灣摩根士丹利,0,5,5,-1,1.40
"20200131","1783","8560","8560",新光,20,0,20,1,7.58
"20200131","1783","9329","9300",華南永昌-朴子,0,30,30,-1,11.36
"20200131","1783","9676","9600",富邦-仁愛,20,0,20,1,7.58
"20200131","1783","003900380034004b","9800",元大-館前,0,20,20,-1,7.58
"20200131","1783","9300","9300",華南永昌,11,0,11,1,4.17
"20200131","1783","9852","9800",元大-永春,10,30,20,-1,7.58
"20200131","1783","0035003300380057","5380",第一金-華江,10,0,10,1,3.79
"20200131","1783","0039003100330055","9100",群益金鼎-崇德,31,46,15,-1,5.68
"20200131","1783","0035003900320042","5920",元富-永和,5,0,5,1,1.89
"20200131","1783","0036003300380041","6380",光和-嘉義,4,9,5,-1,1.89
"20200131","1783","8156","8150",台新-三民,5,0,5,1,1.89
"20200131","1783","0037003000300042","7000",兆豐-板橋,0,5,5,-1,1.89
"20200131","1783","0039003100380047","9100",群益金鼎-新莊,5,0,5,1,1.89
"20200131","1783","9800","9800",元大證券,0,5,5,-1,1.89
"20200131","1783","9695","9600",富邦-民雄(停),5,0,5,1,1.89
"20200131","1783","9822","9800",元大-土城學府,0,5,5,-1,1.89
"20200131","1783","8842","8840",玉山-新莊,4,0,4,1,1.52
"20200131","1783","5858","5850",統一-嘉義,0,3,3,-1,1.14
"20200131","1783","5320","5320",高橋,3,0,3,1,1.14
"20200131","1783","0037003700390076","7790",國票-台中,0,3,3,-1,1.14
"20200131","1783","1260","1260",宏遠證券,3,0,3,1,1.14
"20200131","1783","1480","1480",美商高盛,0,2,2,-1,0.76
"20200131","1783","5262","5260",美好-楊梅,4,1,3,1,1.14
"20200131","1783","1440","1440",美林,16,18,2,-1,0.76
"20200131","1783","5859","5850",統一-屏東,3,0,3,1,1.14
"20200131","1783","0035003800350044","5850",統一-新台中,1,3,2,-1,0.76
"20200131","1783","6161","6160",中國信託-三重,3,0,3,1,1.14
"20200131","1783","0035003800350067","5850",統一-平鎮,0,2,2,-1,0.76
"20230601","1783","0035003300380044","5380",第一金-忠孝,29,0,29,1,1.78
"20230601","1783","1480","1480",美商高盛,9,113,104,-1,6.39
"20230601","1783","9302","9300",華南永昌-台中,20,0,20,1,1.23
"20230601","1783","0037003000300068","7000",兆豐-三民,20,100,80,-1,4.91
"20230601","1783","9800","9800",元大證券,19,4,15,1,0.92
"20230601","1783","9692","9600",富邦-嘉義,30,80,50,-1,3.07
"20230601","1783","7006","7000",兆豐-台南,16,1,15,1,0.92
"20230601","1783","1650","1650",新加坡商瑞銀,33,57,24,-1,1.47
"20230601","1783","8560","8560",新光,21,7,14,1,0.86
"20230601","1783","1440","1440",美林,9,28,19,-1,1.17
"20230601","1783","1560","1560",港商野村,18,5,13,1,0.80
"20230601","1783","8440","8440",摩根大通,0,14,14,-1,0.86
"20230601","1783","0035003900320050","5920",元富-同大,13,0,13,1,0.80
"20230601","1783","003700300030004e","7000",兆豐-埔墘,0,12,12,-1,0.74
"20230601","1783","0039003100380043","9100",群益金鼎-古亭,14,1,13,1,0.80
"20230601","1783","6110","6110",台中銀,2,12,10,-1,0.61
"20230601","1783","0039004100390038","9A00",永豐金-大園,15,2,13,1,0.80
"20230601","1783","0039003600310050","9600",富邦-和美,18,28,10,-1,0.61
"20230601","1783","003500330038004e","5380",第一金-豐原,11,0,11,1,0.68
"20230601","1783","003500390032005a","5920",元富-安南,3,10,7,-1,0.43
"20230601","1783","0035003300380057","5380",第一金-華江,13,2,11,1,0.68
"20230601","1783","8159","8150",台新-台南,4,11,7,-1,0.43
"20230601","1783","0037003000300061","7000",兆豐-忠孝,10,0,10,1,0.61
"20230601","1783","003900380031007a","9800",元大-大統,0,7,7,-1,0.43
"20230601","1783","9212","9200",凱基-東港,10,0,10,1,0.61
"20230601","1783","0039003600320059","9600",富邦-土城,0,6,6,-1,0.37
"20230601","1783","9268","9200",凱基-台北,112,103,9,1,0.55
"20230601","1783","0035003300380041","5380",第一金-新興,0,5,5,-1,0.31
"20230602","1783","0035003300380044","5380",第一金-忠孝,30,0,30,1,3.81
"20230602","1783","1470","1470",台灣摩根士丹利,2,76,74,-1,9.39
"20230602","1783","0039003100380075","9100",群益金鼎-瑞豐,21,0,21,1,2.66
"20230602","1783","1440","1440",美林,2,36,34,-1,4.31
"20230602","1783","003900410039004d","9A00",永豐金-南投,20,0,20,1,2.54
"20230602","1783","0039003600310053","9600",富邦-景美,0,25,25,-1,3.17
"20230602","1783","9206","9200",凱基-高雄,19,1,18,1,2.28
"20230602","1783","1480","1480",美商高盛,1,19,18,-1,2.28
"20230602","1783","6110","6110",台中銀,20,4,16,1,2.03
"20230602","1783","9205","9200",凱基-三重,0,15,15,-1,1.90
"20230602","1783","0039003100330059","9100",群益金鼎-館前,15,0,15,1,1.90
"20230602","1783","9268","9200",凱基-台北,92,103,11,-1,1.40
"20230602","1783","9800","9800",元大證券,14,1,13,1,1.65
"20230602","1783","8440","8440",摩根大通,3,10,7,-1,0.89
"20230602","1783","5320","5320",高橋,12,0,12,1,1.52
"20230602","1783","9324","9300",華南永昌-岡山,1,7,6,-1,0.76
"20230602","1783","5383","5380",第一金-高雄,11,0,11,1,1.40
"20230602","1783","8150","8150",台新證券,0,5,5,-1,0.63
"20230602","1783","7006","7000",兆豐-台南,10,0,10,1,1.27
"20230602","1783","1650","1650",新加坡商瑞銀,6,10,4,-1,0.51
"20230602","1783","0037003000300044","7000",兆豐-西螺,10,0,10,1,1.27
"20230602","1783","0039003600320045","9600",富邦-樹林,0,4,4,-1,0.51
"20230602","1783","9676","9600",富邦-仁愛,10,0,10,1,1.27
"20230602","1783","0039003800330055","9800",元大-頭份,0,4,4,-1,0.51
"20230602","1783","9867","9800",元大-北成功,10,0,10,1,1.27
"20230602","1783","1040","1040",臺銀,0,3,3,-1,0.38
"20230602","1783","0039003800310065","9800",元大-佳里,10,1,9,1,1.14
"20230602","1783","5851","5850",統一-高雄,0,3,3,-1,0.38
"20230605","1783","9867","9800",元大-北成功,18,0,18,1,3.09
"20230605","1783","1470","1470",台灣摩根士丹利,0,53,53,-1,9.09
"20230605","1783","003900380039005a","9800",元大-小港,17,0,17,1,2.92
"20230605","1783","6110","6110",台中銀,0,22,22,-1,3.77
"20230605","1783","0039003100330059","9100",群益金鼎-館前,15,0,15,1,2.57
"20230605","1783","1480","1480",美商高盛,19,36,17,-1,2.92
"20230605","1783","8560","8560",新光,16,1,15,1,2.57
"20230605","1783","9215","9200",凱基-高美館,0,14,14,-1,2.40
"20230605","1783","0039003100380043","9100",群益金鼎-古亭,14,0,14,1,2.40
"20230605","1783","1440","1440",美林,11,24,13,-1,2.23
"20230605","1783","003700370039007a","7790",國票-博愛,13,0,13,1,2.23
"20230605","1783","9315","9300",華南永昌-苑裡,0,13,13,-1,2.23
"20230605","1783","9800","9800",元大證券,14,1,13,1,2.23
"20230605","1783","9324","9300",華南永昌-岡山,0,11,11,-1,1.89
"20230605","1783","0039003600310044","9600",富邦-忠孝,12,0,12,1,2.06
"20230605","1783","0031003000330046","1030",土銀-南港,0,10,10,-1,1.72
"20230605","1783","8150","8150",台新證券,12,1,11,1,1.89
"20230605","1783","0039003800310065","9800",元大-佳里,0,10,10,-1,1.72
"20230605","1783","9255","9200",凱基-和平,14,4,10,1,1.72
"20230605","1783","8882","8880",國泰-台中,0,8,8,-1,1.37
"20230605","1783","9838","9800",元大-豐原,10,0,10,1,1.72
"20230605","1783","0035003300380044","5380",第一金-忠孝,0,6,6,-1,1.03
"20230605","1783","1650","1650",新加坡商瑞銀,16,7,9,1,1.54
"20230605","1783","5856","5850",統一-台中,0,5,5,-1,0.86
"20230605","1783","9871","9800",元大-忠孝,8,0,8,1,1.37
"20230605","1783","9831","9800",元大-四維,0,5,5,-1,0.86
"20230605","1783","9268","9200",凱基-台北,34,27,7,1,1.20
"20230605","1783","9874","9800",元大-雙和,0,5,5,-1,0.86
"20230606","1783","003900360032004c","9600",富邦-雙和,20,0,20,1,3.57
"20230606","1783","0031003000340041","1040",臺銀-臺中,0,60,60,-1,10.70
"20230606","1783","0039004100390067","9A00",永豐金-內湖,20,0,20,1,3.57
"20230606","1783","9692","9600",富邦-嘉義,2,30,28,-1,4.99
"20230606","1783","1480","1480",美商高盛,19,1,18,1,3.21
"20230606","1783","1650","1650",新加坡商瑞銀,8,32,24,-1,4.28
"20230606","1783","0039004100360039","9A00",永豐金-屏東,13,0,13,1,2.32
"20230606","1783","1440","1440",美林,0,22,22,-1,3.92
"20230606","1783","1040","1040",臺銀,11,0,11,1,1.96
"20230606","1783","0039003100380044","9100",群益金鼎-東門,0,20,20,-1,3.57
"20230606","1783","1022","1020",合庫-台南,11,0,11,1,1.96
"20230606","1783","1560","1560",港商野村,4,18,14,-1,2.50
"20230606","1783","1021","1020",合庫-台中,10,0,10,1,1.78
"20230606","1783","003700370039004a","7790",國票-北高雄,0,13,13,-1,2.32
"20230606","1783","8882","8880",國泰-台中,11,1,10,1,1.78
"20230606","1783","8440","8440",摩根大通,4,15,11,-1,1.96
"20230606","1783","003900310038004a","9100",群益金鼎-永和,10,0,10,1,1.78
"20230606","1783","1470","1470",台灣摩根士丹利,3,11,8,-1,1.43
"20230606","1783","0039003800300068","9800",元大-台北,10,0,10,1,1.78
"20230606","1783","8847","8840",玉山-台南,0,8,8,-1,1.43
"20230606","1783","9815","9800",元大-大灣,10,0,10,1,1.78
"20230606","1783","9663","9600",富邦-敦南,0,6,6,-1,1.07
"20230606","1783","0039003100380043","9100",群益金鼎-古亭,12,3,9,1,1.60
"20230606","1783","8492","8490",京城-嘉義,0,5,5,-1,0.89
"20230606","1783","9315","9300",華南永昌-苑裡,8,0,8,1,1.43
"20230606","1783","9297","9200",凱基-文心,0,5,5,-1,0.89
"20230606","1783","5320","5320",高橋,7,0,7,1,1.25
"20230606","1783","9658","9600",富邦-建國,0,5,5,-1,0.89
"20230607","1783","003700370039006d","7790",國票-中港,50,0,50,1,6.16
"20230607","1783","9257","9200",凱基-林口,0,25,25,-1,3.08
"20230607","1783","1470","1470",台灣摩根士丹利,37,0,37,1,4.56
"20230607","1783","0039003100380043","9100",群益金鼎-古亭,0,23,23,-1,2.83
"20230607","1783","1480","1480",美商高盛,42,8,34,1,4.19
"20230607","1783","7006","7000",兆豐-台南,5,27,22,-1,2.71
"20230607","1783","5920","5920",元富,22,0,22,1,2.71
"20230607","1783","9324","9300",華南永昌-岡山,1,22,21,-1,2.59
"20230607","1783","003900380039004c","9800",元大-成功,21,0,21,1,2.59
"20230607","1783","0039003100380075","9100",群益金鼎-瑞豐,0,20,20,-1,2.46
"20230607","1783","9898","9800",元大-新莊,15,0,15,1,1.85
"20230607","1783","0039004100390055","9A00",永豐金-中正,2,22,20,-1,2.46
"20230607","1783","0035003900320041","5920",元富-緯城,13,0,13,1,1.60
"20230607","1783","0039003800390044","9800",元大-左營,0,19,19,-1,2.34
"20230607","1783","6462","6460",大昌-安康,14,1,13,1,1.60
"20230607","1783","9831","9800",元大-四維,0,17,17,-1,2.09
"20230607","1783","9229","9200",凱基-中山,12,0,12,1,1.48
"20230607","1783","8840","8840",玉山證券,0,15,15,-1,1.85
"20230607","1783","9874","9800",元大-雙和,11,0,11,1,1.35
"20230607","1783","8888","8880",國泰-敦南,1,13,12,-1,1.48
"20230607","1783","9801","9800",元大-城東,10,1,9,1,1.11
"20230607","1783","1021","1020",合庫-台中,0,11,11,-1,1.35
"20230607","1783","0039004100390038","9A00",永豐金-大園,10,1,9,1,1.11
"20230607","1783","0039004100300030","9A00",永豐金證券,2,13,11,-1,1.35
"20230607","1783","1650","1650",新加坡商瑞銀,10,2,8,1,0.99
"20230607","1783","9315","9300",華南永昌-苑裡,0,10,10,-1,1.23
"20230607","1783","0039003600320048","9600",富邦-鳳山,7,0,7,1,0.86
"20230607","1783","003900310038004b","9100",群益金鼎-東湖,2,10,8,-1,0.99
"20230608","1783","8560","8560",新光,37,2,35,1,5.00
"20230608","1783","1440","1440",美林,0,59,59,-1,8.43
"20230608","1783","003900380030004b","9800",元大-竹科,19,0,19,1,2.71
"20230608","1783","1480","1480",美商高盛,0,44,44,-1,6.29
"20230608","1783","0039003200310059","9200",凱基-東勢,15,0,15,1,2.14
"20230608","1783","1650","1650",新加坡商瑞銀,3,37,34,-1,4.86
"20230608","1783","0039004100360039","9A00",永豐金-屏東,16,1,15,1,2.14
"20230608","1783","1470","1470",台灣摩根士丹利,3,31,28,-1,4.00
"20230608","1783","9278","9200",凱基-永康,14,1,13,1,1.86
"20230608","1783","003900380039004e","9800",元大-內湖,0,27,27,-1,3.86
"20230608","1783","0039004100300030","9A00",永豐金證券,13,0,13,1,1.86
"20230608","1783","0037003000300067","7000",兆豐-南門,0,23,23,-1,3.29
"20230608","1783","9208","9200",凱基-桃園,11,0,11,1,1.57
"20230608","1783","0035003300380044","5380",第一金-忠孝,0,20,20,-1,2.86
"20230608","1783","003900380031007a","9800",元大-大統,11,0,11,1,1.57
"20230608","1783","0039003800300065","9800",元大-清水,1,16,15,-1,2.14
"20230608","1783","0038003400350041","8450",康和-內湖,10,0,10,1,1.43
"20230608","1783","8440","8440",摩根大通,0,14,14,-1,2.00
"20230608","1783","0031003200360044","1260",宏遠-台南,10,0,10,1,1.43
"20230608","1783","9800","9800",元大證券,3,14,11,-1,1.57
"20230608","1783","1260","1260",宏遠證券,10,0,10,1,1.43
"20230608","1783","6950","6950",福勝,1,11,10,-1,1.43
"20230608","1783","003900310038004a","9100",群益金鼎-永和,10,0,10,1,1.43
"20230608","1783","003900310038004b","9100",群益金鼎-東湖,0,10,10,-1,1.43
"20230608","1783","9366","9300",華南永昌-豐原,10,0,10,1,1.43
"20230608","1783","9898","9800",元大-新莊,0,10,10,-1,1.43
"20230608","1783","9867","9800",元大-北成功,9,0,9,1,1.29
"20230608","1783","0039003200320048","9200",凱基-復興,0,8,8,-1,1.14
"20230609","1783","9108","9100",群益金鼎-海山,30,0,30,1,4.50
"20230609","1783","0039004100390055","9A00",永豐金-中正,2,33,31,-1,4.65
"20230609","1783","0037003700390063","7790",國票-敦北法人,17,2,15,1,2.25
"20230609","1783","0039004100300030","9A00",永豐金證券,0,18,18,-1,2.70
"20230609","1783","9268","9200",凱基-台北,63,49,14,1,2.10
"20230609","1783","0039003100380043","9100",群益金鼎-古亭,2,17,15,-1,2.25
"20230609","1783","1650","1650",新加坡商瑞銀,15,2,13,1,1.95
"20230609","1783","5383","5380",第一金-高雄,0,11,11,-1,1.65
"20230609","1783","003700370039004a","7790",國票-北高雄,11,0,11,1,1.65
"20230609","1783","1040","1040",臺銀,0,10,10,-1,1.50
"20230609","1783","0035003800350046","5850",統一-彰化,11,1,10,1,1.50
"20230609","1783","0035003900320045","5920",元富-城中,0,10,10,-1,1.50
"20230609","1783","0038003400350041","8450",康和-內湖,16,6,10,1,1.50
"20230609","1783","003700370039007a","7790",國票-博愛,0,10,10,-1,1.50
"20230609","1783","9317","9300",華南永昌-林口,10,0,10,1,1.50
"20230609","1783","9303","9300",華南永昌-高雄,0,10,10,-1,1.50
"20230609","1783","9835","9800",元大-員林中山,10,0,10,1,1.50
"20230609","1783","0039003600310043","9600",富邦-南京,4,14,10,-1,1.50
"20230609","1783","9898","9800",元大-新莊,10,0,10,1,1.50
"20230609","1783","5856","5850",統一-台中,1,10,9,-1,1.35
"20230609","1783","8150","8150",台新證券,18,10,8,1,1.20
"20230609","1783","9871","9800",元大-忠孝,4,13,9,-1,1.35
"20230609","1783","8882","8880",國泰-台中,8,0,8,1,1.20
"20230609","1783","0039004100390067","9A00",永豐金-內湖,1,10,9,-1,1.35
"20230609","1783","9202","9200",凱基-中港,7,0,7,1,1.05
"20230609","1783","8711","8710",陽信-石牌,0,7,7,-1,1.05
"20230609","1783","8561","8560",新光-台中,6,0,6,1,0.90
"20230609","1783","0039003800390043","9800",元大-板橋,0,7,7,-1,1.05
"20230612","1783","8560","8560",新光,33,4,29,1,3.40
"20230612","1783","1440","1440",美林,1,79,78,-1,9.14
"20230612","1783","5385","5380",第一金-桃園,20,0,20,1,2.34
"20230612","1783","8150","8150",台新證券,1,50,49,-1,5.74
"20230612","1783","9315","9300",華南永昌-苑裡,15,0,15,1,1.76
"20230612","1783","0038003100350042","8150",台新-台中,1,48,47,-1,5.51
"20230612","1783","9278","9200",凱基-永康,13,0,13,1,1.52
"20230612","1783","1480","1480",美商高盛,1,40,39,-1,4.57
"20230612","1783","0039004100300030","9A00",永豐金證券,12,0,12,1,1.41
"20230612","1783","1470","1470",台灣摩根士丹利,8,40,32,-1,3.75
"20230612","1783","0039004100390059","9A00",永豐金-板盛,12,0,12,1,1.41
"20230612","1783","0039004100390055","9A00",永豐金-中正,4,30,26,-1,3.05
"20230612","1783","0031003000340041","1040",臺銀-臺中,11,0,11,1,1.29
"20230612","1783","1650","1650",新加坡商瑞銀,8,27,19,-1,2.23
"20230612","1783","0035003900320076","5920",元富-桃園,11,0,11,1,1.29
"20230612","1783","6462","6460",大昌-安康,0,15,15,-1,1.76
"20230612","1783","0031003200360069","1260",宏遠-光隆,20,10,10,1,1.17
"20230612","1783","8440","8440",摩根大通,2,14,12,-1,1.41
"20230612","1783","0035003300380049","5380",第一金-頭份,10,0,10,1,1.17
"20230612","1783","0037003000300061","7000",兆豐-忠孝,0,10,10,-1,1.17
"20230612","1783","7006","7000",兆豐-台南,10,0,10,1,1.17
"20230612","1783","8492","8490",京城-嘉義,0,10,10,-1,1.17
"20230612","1783","0037003000300063","7000",兆豐-民生,10,0,10,1,1.17
"20230612","1783","0039003600310057","9600",富邦-東花蓮,0,10,10,-1,1.17
"20230612","1783","8840","8840",玉山證券,10,0,10,1,1.17
"20230612","1783","9898","9800",元大-新莊,0,10,10,-1,1.17
"20230612","1783","0039003800310067","9800",元大-大里,10,0,10,1,1.17
"20230612","1783","0039004100380039","9A00",永豐金-敦北,0,8,8,-1,0.94
"20230613","1783","1480","1480",美商高盛,37,13,24,1,5.83
"20230613","1783","9833","9800",元大-敦化,0,20,20,-1,4.85
"20230613","1783","8150","8150",台新證券,16,0,16,1,3.88
"20230613","1783","0035003800350041","5850",統一-基隆,0,14,14,-1,3.40
"20230613","1783","0039003800390044","9800",元大-左營,12,0,12,1,2.91
"20230613","1783","0039003800310079","9800",元大-善化,3,17,14,-1,3.40
"20230613","1783","8560","8560",新光,12,4,8,1,1.94
"20230613","1783","0039004100390031","9A00",永豐金-松山,0,11,11,-1,2.67
"20230613","1783","9226","9200",凱基-汐止,6,0,6,1,1.46
"20230613","1783","1650","1650",新加坡商瑞銀,19,29,10,-1,2.43
"20230613","1783","9831","9800",元大-四維,6,0,6,1,1.46
"20230613","1783","6168","6160",中國信託-嘉義,0,10,10,-1,2.43
"20230613","1783","0035003300380042","5380",第一金-新竹,5,0,5,1,1.21
"20230613","1783","9863","9800",元大-和平,0,10,10,-1,2.43
"20230613","1783","6380","6380",光和,6,1,5,1,1.21
"20230613","1783","0035003900320076","5920",元富-桃園,0,8,8,-1,1.94
"20230613","1783","9278","9200",凱基-永康,5,0,5,1,1.21
"20230613","1783","8440","8440",摩根大通,0,7,7,-1,1.70
"20230613","1783","9319","9300",華南永昌-鶯歌,5,0,5,1,1.21
"20230613","1783","0039003600320048","9600",富邦-鳳山,0,7,7,-1,1.70
"20230613","1783","003900360031004d","9600",富邦-木柵,5,0,5,1,1.21
"20230613","1783","1260","1260",宏遠證券,0,5,5,-1,1.21
"20230613","1783","0039004100390038","9A00",永豐金-大園,6,1,5,1,1.21
"20230613","1783","6012","6010",(牛牛牛)亞-網路,0,5,5,-1,1.21
"20230613","1783","003900380034004b","9800",元大-館前,4,0,4,1,0.97
"20230613","1783","0037003000300077","7000",兆豐-新莊,0,5,5,-1,1.21
"20230613","1783","8888","8880",國泰-敦南,6,3,3,1,0.73
"20230613","1783","8152","8150",台新-新莊,0,5,5,-1,1.21
"20230614","1783","003900380031005a","9800",元大-潮州,15,2,13,1,3.59
"20230614","1783","1440","1440",美林,1,23,22,-1,6.08
"20230614","1783","003500390032006e","5920",元富-西松,12,0,12,1,3.31
"20230614","1783","003900380039004e","9800",元大-內湖,4,18,14,-1,3.87
"20230614","1783","1650","1650",新加坡商瑞銀,17,7,10,1,2.76
"20230614","1783","9833","9800",元大-敦化,0,11,11,-1,3.04
"20230614","1783","7006","7000",兆豐-台南,10,0,10,1,2.76
"20230614","1783","6168","6160",中國信託-嘉義,0,10,10,-1,2.76
"20230614","1783","0039003100380057","9100",群益金鼎-忠孝,10,0,10,1,2.76
"20230614","1783","9366","9300",華南永昌-豐原,0,10,10,-1,2.76
"20230614","1783","9317","9300",華南永昌-林口,10,0,10,1,2.76
"20230614","1783","0039003800300068","9800",元大-台北,0,10,10,-1,2.76
"20230614","1783","8885","8880",國泰-桃園,7,0,7,1,1.93
"20230614","1783","0039003100330045","9100",群益金鼎-基隆,0,9,9,-1,2.49
"20230614","1783","0039003800390047","9800",元大-大同,6,0,6,1,1.66
"20230614","1783","9800","9800",元大證券,3,9,6,-1,1.66
"20230614","1783","9815","9800",元大-大灣,5,0,5,1,1.38
"20230614","1783","9278","9200",凱基-永康,0,6,6,-1,1.66
"20230614","1783","9853","9800",元大-南屯,5,0,5,1,1.38
"20230614","1783","0039003800390044","9800",元大-左營,0,5,5,-1,1.38
"20230614","1783","0039004100390038","9A00",永豐金-大園,5,0,5,1,1.38
"20230614","1783","003500390032004c","5920",元富-中壢,2,7,5,-1,1.38
"20230614","1783","8382","8380",安泰-楠梓,4,0,4,1,1.10
"20230614","1783","0039003200310059","9200",凱基-東勢,0,5,5,-1,1.38
"20230614","1783","8841","8840",玉山-雙和,5,1,4,1,1.10
"20230614","1783","9331","9300",華南永昌-鳳山,0,5,5,-1,1.38
"20230614","1783","0039003800310051","9800",元大-太平,4,0,4,1,1.10
"20230614","1783","003900380031004e","9800",元大-金門,0,5,5,-1,1.38
"20230615","1783","1480","1480",美商高盛,32,3,29,1,7.32
"20230615","1783","0039003100380067","9100",群益金鼎-大甲,0,22,22,-1,5.56
"20230615","1783","1440","1440",美林,29,3,26,1,6.57
"20230615","1783","9857","9800",元大-東蘆,1,20,19,-1,4.80
"20230615","1783","9315","9300",華南永昌-苑裡,20,0,20,1,5.05
"20230615","1783","9800","9800",元大證券,3,20,17,-1,4.29
"20230615","1783","0039003600310053","9600",富邦-景美,11,0,11,1,2.78
"20230615","1783","8150","8150",台新證券,1,15,14,-1,3.54
"20230615","1783","003500380035004d","5850",統一-士林,10,0,10,1,2.53
"20230615","1783","1116","1110",台灣企銀-屏東,0,10,10,-1,2.53
"20230615","1783","5962","5960",日茂-南投,10,0,10,1,2.53
"20230615","1783","0039003200310059","9200",凱基-東勢,0,10,10,-1,2.53
"20230615","1783","9899","9800",元大-淡水,10,0,10,1,2.53
"20230615","1783","9884","9800",元大-斗信,0,10,10,-1,2.53
"20230615","1783","1650","1650",新加坡商瑞銀,17,8,9,1,2.27
"20230615","1783","0039004100390041","9A00",永豐金-羅東,1,10,9,-1,2.27
"20230615","1783","003500390032006e","5920",元富-西松,9,2,7,1,1.77
"20230615","1783","0037003700390045","7790",國票-南崁,0,8,8,-1,2.02
"20230615","1783","0039003100380043","9100",群益金鼎-古亭,6,0,6,1,1.52
"20230615","1783","003900310033004e","9100",群益金鼎-土城,0,8,8,-1,2.02
"20230615","1783","8459","8450",康和-嘉義,5,0,5,1,1.26
"20230615","1783","0039003800310061","9800",元大-歸仁,0,8,8,-1,2.02
"20230615","1783","003900380039004a","9800",元大-彰化民生,5,0,5,1,1.26
"20230615","1783","8440","8440",摩根大通,2,9,7,-1,1.77
"20230615","1783","0039004100390066","9A00",永豐金-中盛,5,0,5,1,1.26
"20230615","1783","0039003200300046","9200",凱基-站前,0,7,7,-1,1.77
"20230615","1783","9871","9800",元大-忠孝,4,0,4,1,1.01
"20230615","1783","0039003800390046","9800",元大-高雄,0,6,6,-1,1.52
"20230616","1783","0039003600310053","9600",富邦-景美,240,97,143,1,7.73
"20230616","1783","0039003800310067","9800",元大-大里,7,41,34,-1,1.84
"20230616","1783","8440","8440",摩根大通,45,3,42,1,2.27
"20230616","1783","003900380031005a","9800",元大-潮州,0,30,30,-1,1.62
"20230616","1783","1650","1650",新加坡商瑞銀,45,5,40,1,2.16
"20230616","1783","0039004100300030","9A00",永豐金證券,7,30,23,-1,1.24
"20230616","1783","0035003800350052","5850",統一-汐止,30,0,30,1,1.62
"20230616","1783","003700370039007a","7790",國票-博愛,0,20,20,-1,1.08
"20230616","1783","0039004100390037","9A00",永豐金-新竹,30,0,30,1,1.62
"20230616","1783","003900380039005a","9800",元大-小港,0,20,20,-1,1.08
"20230616","1783","0035003900320050","5920",元富-同大,20,2,18,1,0.97
"20230616","1783","1470","1470",台灣摩根士丹利,1,17,16,-1,0.87
"20230616","1783","9209","9200",凱基-岡山,21,3,18,1,0.97
"20230616","1783","6110","6110",台中銀,0,16,16,-1,0.87
"20230616","1783","0039003800300077","9800",元大-西屯,16,0,16,1,0.87
"20230616","1783","8840","8840",玉山證券,2,18,16,-1,0.87
"20230616","1783","0035003300380042","5380",第一金-新竹,15,0,15,1,0.81
"20230616","1783","9831","9800",元大-四維,1,16,15,-1,0.81
"20230616","1783","0038003800340041","8840",玉山-士林,15,0,15,1,0.81
"20230616","1783","0035003900320047","5920",元富-新竹,0,14,14,-1,0.76
"20230616","1783","0039003600310045","9600",富邦-府城,20,5,15,1,0.81
"20230616","1783","8150","8150",台新證券,3,17,14,-1,0.76
"20230616","1783","9898","9800",元大-新莊,15,1,14,1,0.76
"20230616","1783","1116","1110",台灣企銀-屏東,0,13,13,-1,0.70
"20230616","1783","1560","1560",港商野村,16,3,13,1,0.70
"20230616","1783","0038003400350041","8450",康和-內湖,1,13,12,-1,0.65
"20230616","1783","0039003800310072","9800",元大-屏南,13,0,13,1,0.70
"20230616","1783","9302","9300",華南永昌-台中,0,11,11,-1,0.59
"20230619","1783","5384","5380",第一金-台南,25,1,24,1,1.85
"20230619","1783","1650","1650",新加坡商瑞銀,5,61,56,-1,4.32
"20230619","1783","0039003100380044","9100",群益金鼎-東門,24,0,24,1,1.85
"20230619","1783","8150","8150",台新證券,2,45,43,-1,3.32
"20230619","1783","0039004100390066","9A00",永豐金-中盛,20,0,20,1,1.54
"20230619","1783","9268","9200",凱基-台北,27,60,33,-1,2.54
"20230619","1783","003900380031006a","9800",元大-士林,17,0,17,1,1.31
"20230619","1783","0039004100390037","9A00",永豐金-新竹,0,30,30,-1,2.31
"20230619","1783","8888","8880",國泰-敦南,19,3,16,1,1.23
"20230619","1783","1440","1440",美林,2,27,25,-1,1.93
"20230619","1783","0038003800380041","8880",國泰-館前,17,1,16,1,1.23
"20230619","1783","003900360032004c","9600",富邦-雙和,0,20,20,-1,1.54
"20230619","1783","003900310033004e","9100",群益金鼎-土城,16,0,16,1,1.23
"20230619","1783","1480","1480",美商高盛,2,21,19,-1,1.46
"20230619","1783","0039004100390062","9A00",永豐金-虎尾,16,0,16,1,1.23
"20230619","1783","0037003700390063","7790",國票-敦北法人,0,16,16,-1,1.23
"20230619","1783","9317","9300",華南永昌-林口,15,0,15,1,1.16
"20230619","1783","0039004100390038","9A00",永豐金-大園,2,14,12,-1,0.93
"20230619","1783","9666","9600",富邦-南屯,13,0,13,1,1.00
"20230619","1783","0038003400350041","8450",康和-內湖,0,11,11,-1,0.85
"20230619","1783","6160","6160",中國信託,21,8,13,1,1.00
"20230619","1783","1470","1470",台灣摩根士丹利,1,12,11,-1,0.85
"20230619","1783","9315","9300",華南永昌-苑裡,18,5,13,1,1.00
"20230619","1783","003700370039007a","7790",國票-博愛,0,11,11,-1,0.85
"20230619","1783","8843","8840",玉山-高雄,23,11,12,1,0.93
"20230619","1783","0039004100390041","9A00",永豐金-羅東,1,12,11,-1,0.85
"20230619","1783","0035003300380050","5380",第一金-路竹,13,2,11,1,0.85
"20230619","1783","0035003800350052","5850",統一-汐止,0,10,10,-1,0.77
"20230620","1783","1480","1480",美商高盛,73,12,61,1,3.94
"20230620","1783","9268","9200",凱基-台北,95,135,40,-1,2.59
"20230620","1783","9624","9600",富邦-竹北,33,2,31,1,2.00
"20230620","1783","9215","9200",凱基-高美館,4,28,24,-1,1.55
"20230620","1783","5058","5050",大展-台南,30,0,30,1,1.94
"20230620","1783","9315","9300",華南永昌-苑裡,0,23,23,-1,1.49
"20230620","1783","0035003900320047","5920",元富-新竹,22,2,20,1,1.29
"20230620","1783","1040","1040",臺銀,0,21,21,-1,1.36
"20230620","1783","0039003800390041","9800",元大-北投,23,3,20,1,1.29
"20230620","1783","0039004100370039","9A00",永豐金-埔里,0,20,20,-1,1.29
"20230620","1783","003800380034004a","8840",玉山-大里,21,1,20,1,1.29
"20230620","1783","8440","8440",摩根大通,13,31,18,-1,1.16
"20230620","1783","1470","1470",台灣摩根士丹利,19,0,19,1,1.23
"20230620","1783","8560","8560",新光,11,29,18,-1,1.16
"20230620","1783","0035003900320063","5920",元富-烏日,20,1,19,1,1.23
"20230620","1783","5603","5600",永興-台中,1,16,15,-1,0.97
"20230620","1783","9665","9600",富邦-桃園,20,1,19,1,1.23
"20230620","1783","6910","6910",德信,0,15,15,-1,0.97
"20230620","1783","9862","9800",元大-南京,14,1,13,1,0.84
"20230620","1783","0039004100390066","9A00",永豐金-中盛,10,25,15,-1,0.97
"20230620","1783","6160","6160",中國信託,13,1,12,1,0.78
"20230620","1783","003900410039006a","9A00",永豐金-嘉義,0,15,15,-1,0.97
"20230620","1783","0039003800390064","9800",元大-北屯,12,1,11,1,0.71
"20230620","1783","0039004100300030","9A00",永豐金證券,0,14,14,-1,0.90
"20230620","1783","1042","1040",臺銀-臺南,11,1,10,1,0.65
"20230620","1783","003900380031007a","9800",元大-大統,0,13,13,-1,0.84
"20230620","1783","0038003800340048","8840",玉山-新竹,10,0,10,1,0.65
"20230620","1783","0039003100380067","9100",群益金鼎-大甲,0,10,10,-1,0.65
"20230621","1783","9315","9300",華南永昌-苑裡,22,0,22,1,2.54
"20230621","1783","1440","1440",美林,0,41,41,-1,4.73
"20230621","1783","5323","5320",高橋-內壢,20,0,20,1,2.31
"20230621","1783","5058","5050",大展-台南,0,30,30,-1,3.46
"20230621","1783","9831","9800",元大-四維,18,0,18,1,2.08
"20230621","1783","0039003100330059","9100",群益金鼎-館前,1,30,29,-1,3.34
"20230621","1783","0039003100380044","9100",群益金鼎-東門,17,0,17,1,1.96
"20230621","1783","003900410039005a","9A00",永豐金-復興,0,25,25,-1,2.88
"20230621","1783","0031003000340041","1040",臺銀-臺中,15,0,15,1,1.73
"20230621","1783","8440","8440",摩根大通,0,21,21,-1,2.42
"20230621","1783","8560","8560",新光,19,5,14,1,1.61
"20230621","1783","003900360031004b","9600",富邦-七賢,0,21,21,-1,2.42
"20230621","1783","0035003900320062","5920",元富-板橋,13,0,13,1,1.50
"20230621","1783","003900380033004e","9800",元大-大安,0,21,21,-1,2.42
"20230621","1783","9853","9800",元大-南屯,13,1,12,1,1.38
"20230621","1783","0039003600320056","9600",富邦-復興,0,16,16,-1,1.85
"20230621","1783","0031003000320043","1020",合庫-自強,11,0,11,1,1.27
"20230621","1783","003900360035004b","9600",富邦-台中,0,15,15,-1,1.73
"20230621","1783","0039003800310067","9800",元大-大里,14,4,10,1,1.15
"20230621","1783","003900380031005a","9800",元大-潮州,4,19,15,-1,1.73
"20230621","1783","6912","6910",德信-中正,10,0,10,1,1.15
"20230621","1783","003900410039004d","9A00",永豐金-南投,10,25,15,-1,1.73
"20230621","1783","9604","9600",富邦-陽明,10,0,10,1,1.15
"20230621","1783","1042","1040",臺銀-臺南,0,11,11,-1,1.27
"20230621","1783","0039003600310048","9600",富邦-新板,10,0,10,1,1.15
"20230621","1783","0035003800350048","5850",統一-桃園,0,10,10,-1,1.15
"20230621","1783","9667","9600",富邦-台南,10,0,10,1,1.15
"20230621","1783","9275","9200",凱基-三多,0,10,10,-1,1.15
"20230626","1783","0031003000340041","1040",臺銀-臺中,40,1,39,1,6.94
"20230626","1783","0039003100380075","9100",群益金鼎-瑞豐,0,20,20,-1,3.56
"20230626","1783","1650","1650",新加坡商瑞銀,46,11,35,1,6.23
"20230626","1783","8843","8840",玉山-高雄,1,20,19,-1,3.38
"20230626","1783","8440","8440",摩根大通,18,1,17,1,3.02
"20230626","1783","0035003300380044","5380",第一金-忠孝,1,18,17,-1,3.02
"20230626","1783","9268","9200",凱基-台北,40,28,12,1,2.14
"20230626","1783","0038003800340044","8840",玉山-左營,0,15,15,-1,2.67
"20230626","1783","0039004100390045","9A00",永豐金-板橋,12,0,12,1,2.14
"20230626","1783","0039003100380067","9100",群益金鼎-大甲,0,11,11,-1,1.96
"20230626","1783","8492","8490",京城-嘉義,10,0,10,1,1.78
"20230626","1783","9898","9800",元大-新莊,0,10,10,-1,1.78
"20230626","1783","9831","9800",元大-四維,11,1,10,1,1.78
"20230626","1783","003900380039006d","9800",元大-信義,1,11,10,-1,1.78
"20230626","1783","1440","1440",美林,17,8,9,1,1.60
"20230626","1783","0035003900320045","5920",元富-城中,0,9,9,-1,1.60
"20230626","1783","0037003700390044","7790",國票-台南,8,0,8,1,1.42
"20230626","1783","0031003200360055","1260",宏遠-館前,0,8,8,-1,1.42
"20230626","1783","8846","8840",玉山-板橋,8,0,8,1,1.42
"20230626","1783","0039003800390049","9800",元大-蘆洲,0,8,8,-1,1.42
"20230626","1783","6380","6380",光和,6,0,6,1,1.07
"20230626","1783","0039003800320041","9800",元大-羅東,0,7,7,-1,1.25
"20230626","1783","9859","9800",元大-新竹經國,6,0,6,1,1.07
"20230626","1783","9871","9800",元大-忠孝,0,7,7,-1,1.25
"20230626","1783","0039004100300030","9A00",永豐金證券,8,2,6,1,1.07
"20230626","1783","9623","9600",富邦-台北,0,6,6,-1,1.07
"20230626","1783","0039004100390078","9A00",永豐金-桃園,6,0,6,1,1.07
"20230626","1783","0039004100390057","9A00",永豐金-市政,0,6,6,-1,1.07
"20230627","1783","9239","9200",凱基-市政,110,1,109,1,2.30
"20230627","1783","0031003200360069","1260",宏遠-光隆,0,107,107,-1,2.26
"20230627","1783","8440","8440",摩根大通,103,14,89,1,1.88
"20230627","1783","0039004100390055","9A00",永豐金-中正,4,50,46,-1,0.97
"20230627","1783","1650","1650",新加坡商瑞銀,149,86,63,1,1.33
"20230627","1783","6380","6380",光和,1,46,45,-1,0.95
"20230627","1783","9268","9200",凱基-台北,290,231,59,1,1.25
"20230627","1783","9278","9200",凱基-永康,0,39,39,-1,0.82
"20230627","1783","9303","9300",華南永昌-高雄,50,4,46,1,0.97
"20230627","1783","9315","9300",華南永昌-苑裡,0,36,36,-1,0.76
"20230627","1783","9892","9800",元大-屏東,44,3,41,1,0.87
"20230627","1783","0035003300380044","5380",第一金-忠孝,0,35,35,-1,0.74
"20230627","1783","0035003900320047","5920",元富-新竹,40,0,40,1,0.85
"20230627","1783","9872","9800",元大-復北,1,34,33,-1,0.70
"20230627","1783","9624","9600",富邦-竹北,33,0,33,1,0.70
"20230627","1783","8560","8560",新光,18,50,32,-1,0.68
"20230627","1783","0036003000310064","6010",(牛牛牛)亞-鑫豐,38,5,33,1,0.70
"20230627","1783","9831","9800",元大-四維,6,37,31,-1,0.65
"20230627","1783","9226","9200",凱基-汐止,20,0,20,1,0.42
"20230627","1783","9616","9600",富邦-岡山,1,28,27,-1,0.57
"20230627","1783","003900410039004b","9A00",永豐金-三重,21,1,20,1,0.42
"20230627","1783","9309","9300",華南永昌-古亭,0,26,26,-1,0.55
"20230627","1783","9208","9200",凱基-桃園,24,6,18,1,0.38
"20230627","1783","9853","9800",元大-南屯,8,33,25,-1,0.53
"20230627","1783","9858","9800",元大-龍潭,22,5,17,1,0.36
"20230627","1783","0031003000320043","1020",合庫-自強,3,26,23,-1,0.49
"20230627","1783","9328","9300",華南永昌-潮州,20,5,15,1,0.32
"20230627","1783","0039004100300030","9A00",永豐金證券,10,33,23,-1,0.49
"20230628","1783","0031003200360069","1260",宏遠-光隆,100,0,100,1,1.87
"20230628","1783","8440","8440",摩根大通,0,185,185,-1,3.45
"20230628","1783","7003","7000",兆豐-台中,78,1,77,1,1.44
"20230628","1783","1480","1480",美商高盛,7,133,126,-1,2.35
"20230628","1783","9833","9800",元大-敦化,52,0,52,1,0.97
"20230628","1783","9268","9200",凱基-台北,160,268,108,-1,2.02
"20230628","1783","8151","8150",台新-建北,54,3,51,1,0.95
"20230628","1783","9239","9200",凱基-市政,5,112,107,-1,2.00
"20230628","1783","8560","8560",新光,74,26,48,1,0.90
"20230628","1783","1650","1650",新加坡商瑞銀,146,215,69,-1,1.29
"20230628","1783","0031003200360044","1260",宏遠-台南,43,0,43,1,0.80
"20230628","1783","1440","1440",美林,14,61,47,-1,0.88
"20230628","1783","0039004100390059","9A00",永豐金-板盛,47,6,41,1,0.77
"20230628","1783","9303","9300",華南永昌-高雄,2,49,47,-1,0.88
"20230628","1783","9831","9800",元大-四維,42,7,35,1,0.65
"20230628","1783","8888","8880",國泰-敦南,44,77,33,-1,0.62
"20230628","1783","5923","5920",元富-三重,33,1,32,1,0.60
"20230628","1783","003900380039004a","9800",元大-彰化民生,9,35,26,-1,0.49
"20230628","1783","0038003800380041","8880",國泰-館前,47,17,30,1,0.56
"20230628","1783","0036003000310064","6010",(牛牛牛)亞-鑫豐,8,30,22,-1,0.41
"20230628","1783","0039004100390050","9A00",永豐金-竹北,30,0,30,1,0.56
"20230628","1783","9226","9200",凱基-汐止,0,20,20,-1,0.37
"20230628","1783","0035003300380044","5380",第一金-忠孝,28,0,28,1,0.52
"20230628","1783","0039003800390041","9800",元大-北投,1,21,20,-1,0.37
"20230628","1783","9300","9300",華南永昌,33,5,28,1,0.52
"20230628","1783","0039003100380046","9100",群益金鼎-新店,24,42,18,-1,0.34
"20230628","1783","9208","9200",凱基-桃園,31,5,26,1,0.49
"20230628","1783","9209","9200",凱基-岡山,3,21,18,-1,0.34
"20230629","1783","8440","8440",摩根大通,39,4,35,1,1.35
"20230629","1783","9268","9200",凱基-台北,278,316,38,-1,1.46
"20230629","1783","003900380039004e","9800",元大-內湖,36,2,34,1,1.31
"20230629","1783","9871","9800",元大-忠孝,0,21,21,-1,0.81
"20230629","1783","0039003100330059","9100",群益金鼎-館前,31,0,31,1,1.19
"20230629","1783","1038","1030",土銀-和平,0,20,20,-1,0.77
"20230629","1783","003900380033006a","9800",元大-仁愛,31,0,31,1,1.19
"20230629","1783","9604","9600",富邦-陽明,17,37,20,-1,0.77
"20230629","1783","1440","1440",美林,51,22,29,1,1.12
"20230629","1783","0038003800380041","8880",國泰-館前,17,36,19,-1,0.73
"20230629","1783","0039003100380046","9100",群益金鼎-新店,21,1,20,1,0.77
"20230629","1783","9858","9800",元大-龍潭,7,25,18,-1,0.69
"20230629","1783","9817","9800",元大-東泰,20,1,19,1,0.73
"20230629","1783","003900380030004b","9800",元大-竹科,6,23,17,-1,0.65
"20230629","1783","0039003800320046","9800",元大-忠孝鼎富,20,1,19,1,0.73
"20230629","1783","0039003800310070","9800",元大-松山,3,19,16,-1,0.62
"20230629","1783","1480","1480",美商高盛,33,15,18,1,0.69
"20230629","1783","0035003900320041","5920",元富-緯城,0,15,15,-1,0.58
"20230629","1783","9892","9800",元大-屏東,23,5,18,1,0.69
"20230629","1783","0035003900320053","5920",元富-基隆,6,19,13,-1,0.50
"20230629","1783","7007","7000",兆豐-竹北,17,0,17,1,0.65
"20230629","1783","0039003100380043","9100",群益金鼎-古亭,0,13,13,-1,0.50
"20230629","1783","0039003100380065","9100",群益金鼎-大安,15,0,15,1,0.58
"20230629","1783","0039003800310044","9800",元大-南投,4,16,12,-1,0.46
"20230629","1783","9692","9600",富邦-嘉義,29,15,14,1,0.54
"20230629","1783","003900380031006d","9800",元大-前金,2,13,11,-1,0.42
"20230629","1783","0039004100390043","9A00",永豐金-員林,13,0,13,1,0.50
"20230629","1783","0036003000310064","6010",(牛牛牛)亞-鑫豐,1,12,11,-1,0.42
"20230630","1783","8440","8440",摩根大通,92,13,79,1,3.44
"20230630","1783","0031003000320046","1020",合庫-西台中,1,40,39,-1,1.70
"20230630","1783","1440","1440",美林,67,23,44,1,1.92
"20230630","1783","9268","9200",凱基-台北,159,197,38,-1,1.66
"20230630","1783","1480","1480",美商高盛,89,51,38,1,1.66
"20230630","1783","5852","5850",統一-敦南,0,34,34,-1,1.48
"20230630","1783","7000","7000",兆豐證券,36,6,30,1,1.31
"20230630","1783","0035003800350041","5850",統一-基隆,0,31,31,-1,1.35
"20230630","1783","1470","1470",台灣摩根士丹利,33,10,23,1,1.00
"20230630","1783","8560","8560",新光,12,33,21,-1,0.92
"20230630","1783","9337","9300",華南永昌-內壢,21,0,21,1,0.92
"20230630","1783","0035003900320063","5920",元富-烏日,3,20,17,-1,0.74
"20230630","1783","0039003600320055","9600",富邦-縣政,20,0,20,1,0.87
"20230630","1783","9627","9600",富邦-內湖,0,16,16,-1,0.70
"20230630","1783","0039004100390041","9A00",永豐金-羅東,21,1,20,1,0.87
"20230630","1783","0039003100380065","9100",群益金鼎-大安,0,15,15,-1,0.65
"20230630","1783","1560","1560",港商野村,52,33,19,1,0.83
"20230630","1783","0039003600330041","9600",富邦-八德,2,17,15,-1,0.65
"20230630","1783","0035003900320045","5920",元富-城中,20,2,18,1,0.78
"20230630","1783","0035003800350046","5850",統一-彰化,14,28,14,-1,0.61
"20230630","1783","9188","9100",群益金鼎-三民,20,2,18,1,0.78
"20230630","1783","9831","9800",元大-四維,3,16,13,-1,0.57
"20230630","1783","0035003300380045","5380",第一金-自由,17,0,17,1,0.74
"20230630","1783","5382","5380",第一金-台中,0,12,12,-1,0.52
"20230630","1783","0039003800340043","9800",元大-新店中正,17,0,17,1,0.74
"20230630","1783","003900410039004c","9A00",永豐金-台中,0,12,12,-1,0.52
"20230630","1783","7007","7000",兆豐-竹北,20,4,16,1,0.70
"20230630","1783","1028","1020",合庫-彰化,1,12,11,-1,0.48
"20230703","1783","8440","8440",摩根大通,161,41,120,1,6.05
"20230703","1783","8710","8710",陽信,0,50,50,-1,2.52
"20230703","1783","1470","1470",台灣摩根士丹利,81,1,80,1,4.03
"20230703","1783","9692","9600",富邦-嘉義,3,40,37,-1,1.86
"20230703","1783","1480","1480",美商高盛,87,16,71,1,3.58
"20230703","1783","7000","7000",兆豐證券,0,36,36,-1,1.81
"20230703","1783","7007","7000",兆豐-竹北,53,0,53,1,2.67
"20230703","1783","9624","9600",富邦-竹北,32,64,32,-1,1.61
"20230703","1783","1650","1650",新加坡商瑞銀,118,69,49,1,2.47
"20230703","1783","1560","1560",港商野村,8,39,31,-1,1.56
"20230703","1783","003900380033006a","9800",元大-仁愛,47,0,47,1,2.37
"20230703","1783","0031003200360044","1260",宏遠-台南,0,30,30,-1,1.51
"20230703","1783","9867","9800",元大-北成功,35,1,34,1,1.71
"20230703","1783","0039003600310043","9600",富邦-南京,0,30,30,-1,1.51
"20230703","1783","9215","9200",凱基-高美館,29,9,20,1,1.01
"20230703","1783","0039003800320042","9800",元大-博愛,0,22,22,-1,1.11
"20230703","1783","1440","1440",美林,24,6,18,1,0.91
"20230703","1783","7790","7790",國票證券,2,20,18,-1,0.91
"20230703","1783","0035003900320063","5920",元富-烏日,20,3,17,1,0.86
"20230703","1783","0039003100380043","9100",群益金鼎-古亭,0,17,17,-1,0.86
"20230703","1783","003700370039005a","7790",國票-安和,19,3,16,1,0.81
"20230703","1783","9857","9800",元大-東蘆,4,19,15,-1,0.76
"20230703","1783","9285","9200",凱基-中壢,15,1,14,1,0.71
"20230703","1783","9658","9600",富邦-建國,13,27,14,-1,0.71
"20230703","1783","9834","9800",元大-中壢,21,8,13,1,0.65
"20230703","1783","9800","9800",元大證券,26,40,14,-1,0.71
"20230703","1783","9303","9300",華南永昌-高雄,13,0,13,1,0.65
"20230703","1783","0039003200300057","9200",凱基-大里,0,13,13,-1,0.65
"20230704","1783","8450","8450",康和,70,5,65,1,1.97
"20230704","1783","9268","9200",凱基-台北,184,277,93,-1,2.82
"20230704","1783","1470","1470",台灣摩根士丹利,72,16,56,1,1.70
"20230704","1783","9857","9800",元大-東蘆,0,84,84,-1,2.55
"20230704","1783","0035003800350067","5850",統一-平鎮,50,0,50,1,1.52
"20230704","1783","9208","9200",凱基-桃園,7,77,70,-1,2.13
"20230704","1783","0038003400350042","8450",康和-永和,33,0,33,1,1.00
"20230704","1783","9875","9800",元大-土城永寧,0,36,36,-1,1.09
"20230704","1783","9835","9800",元大-員林中山,31,2,29,1,0.88
"20230704","1783","0039004100390050","9A00",永豐金-竹北,1,36,35,-1,1.06
"20230704","1783","8888","8880",國泰-敦南,58,30,28,1,0.85
"20230704","1783","5923","5920",元富-三重,1,32,31,-1,0.94
"20230704","1783","0039003800320046","9800",元大-忠孝鼎富,20,0,20,1,0.61
"20230704","1783","9888","9800",元大-鑫永和,1,21,20,-1,0.61
"20230704","1783","6950","6950",福勝,25,6,19,1,0.58
"20230704","1783","9337","9300",華南永昌-內壢,2,21,19,-1,0.58
"20230704","1783","9256","9200",凱基-南崁,18,0,18,1,0.55
"20230704","1783","9278","9200",凱基-永康,3,20,17,-1,0.52
"20230704","1783","0035003300380045","5380",第一金-自由,17,0,17,1,0.52
"20230704","1783","0039003800310067","9800",元大-大里,6,23,17,-1,0.52
"20230704","1783","003900410039004d","9A00",永豐金-南投,18,1,17,1,0.52
"20230704","1783","8440","8440",摩根大通,77,93,16,-1,0.49
"20230704","1783","9812","9800",元大-台中,21,5,16,1,0.49
"20230704","1783","9874","9800",元大-雙和,3,19,16,-1,0.49
"20230704","1783","0039004100390043","9A00",永豐金-員林,25,9,16,1,0.49
"20230704","1783","7006","7000",兆豐-台南,1,16,15,-1,0.46
"20230704","1783","0036003000310064","6010",(牛牛牛)亞-鑫豐,21,6,15,1,0.46
"20230704","1783","9206","9200",凱基-高雄,3,18,15,-1,0.46
"20230705","1783","003900360032004b","9600",富邦-中和,65,0,65,1,3.86
"20230705","1783","8450","8450",康和,0,45,45,-1,2.67
"20230705","1783","0037003700390058","7790",國票-中和,40,0,40,1,2.38
"20230705","1783","0039003800320046","9800",元大-忠孝鼎富,1,45,44,-1,2.61
"20230705","1783","1650","1650",新加坡商瑞銀,92,57,35,1,2.08
"20230705","1783","6160","6160",中國信託,2,30,28,-1,1.66
"20230705","1783","7007","7000",兆豐-竹北,35,0,35,1,2.08
"20230705","1783","0031003000320046","1020",合庫-西台中,4,32,28,-1,1.66
"20230705","1783","003700370039005a","7790",國票-安和,33,0,33,1,1.96
"20230705","1783","0039003800330047","9800",元大-上新莊,1,26,25,-1,1.48
"20230705","1783","1470","1470",台灣摩根士丹利,31,0,31,1,1.84
"20230705","1783","0031003200360044","1260",宏遠-台南,0,20,20,-1,1.19
"20230705","1783","0035003900320047","5920",元富-新竹,20,0,20,1,1.19
"20230705","1783","6464","6460",大昌-新店,2,22,20,-1,1.19
"20230705","1783","0039004100390045","9A00",永豐金-板橋,14,0,14,1,0.83
"20230705","1783","9205","9200",凱基-三重,0,18,18,-1,1.07
"20230705","1783","0035003300380057","5380",第一金-華江,15,1,14,1,0.83
"20230705","1783","9300","9300",華南永昌,0,17,17,-1,1.01
"20230705","1783","9322","9300",華南永昌-公誠,13,2,11,1,0.65
"20230705","1783","0035003800350048","5850",統一-桃園,0,15,15,-1,0.89
"20230705","1783","9661","9600",富邦-新店,11,0,11,1,0.65
"20230705","1783","8882","8880",國泰-台中,14,29,15,-1,0.89
"20230705","1783","0031003000340041","1040",臺銀-臺中,16,6,10,1,0.59
"20230705","1783","9624","9600",富邦-竹北,1,16,15,-1,0.89
"20230705","1783","003900310038007a","9100",群益金鼎-宜蘭,10,0,10,1,0.59
"20230705","1783","0039004100390057","9A00",永豐金-市政,1,16,15,-1,0.89
"20230705","1783","9833","9800",元大-敦化,10,0,10,1,0.59
"20230705","1783","9208","9200",凱基-桃園,1,14,13,-1,0.77
"20230706","1783","003700370039006d","7790",國票-中港,20,0,20,1,1.38
"20230706","1783","9268","9200",凱基-台北,119,173,54,-1,3.73
"20230706","1783","8459","8450",康和-嘉義,20,1,19,1,1.31
"20230706","1783","1470","1470",台灣摩根士丹利,4,41,37,-1,2.56
"20230706","1783","0039003600310043","9600",富邦-南京,23,4,19,1,1.31
"20230706","1783","003700370039005a","7790",國票-安和,0,30,30,-1,2.07
"20230706","1783","9697","9600",富邦-虎尾,19,0,19,1,1.31
"20230706","1783","9358","9300",華南永昌-東勢,0,30,30,-1,2.07
"20230706","1783","0039003800310051","9800",元大-太平,19,0,19,1,1.31
"20230706","1783","1650","1650",新加坡商瑞銀,49,72,23,-1,1.59
"20230706","1783","5850","5850",統一,19,2,17,1,1.18
"20230706","1783","9332","9300",華南永昌-楠梓,0,21,21,-1,1.45
"20230706","1783","9322","9300",華南永昌-公誠,21,4,17,1,1.18
"20230706","1783","9874","9800",元大-雙和,2,19,17,-1,1.18
"20230706","1783","9272","9200",凱基-竹科,16,0,16,1,1.11
"20230706","1783","6165","6160",中國信託-新竹,4,20,16,-1,1.11
"20230706","1783","9623","9600",富邦-台北,19,5,14,1,0.97
"20230706","1783","9658","9600",富邦-建國,0,11,11,-1,0.76
"20230706","1783","003500390032006e","5920",元富-西松,13,2,11,1,0.76
"20230706","1783","0039003800390064","9800",元大-北屯,1,12,11,-1,0.76
"20230706","1783","8440","8440",摩根大通,58,47,11,1,0.76
"20230706","1783","5262","5260",美好-楊梅,0,10,10,-1,0.69
"20230706","1783","5320","5320",高橋,13,3,10,1,0.69
"20230706","1783","7001","7000",兆豐-嘉義,0,10,10,-1,0.69
"20230706","1783","6380","6380",光和,10,0,10,1,0.69
"20230706","1783","003900320031004d","9200",凱基-八德,0,10,10,-1,0.69
"20230706","1783","0039003200300046","9200",凱基-站前,10,0,10,1,0.69
"20230706","1783","0039003800330055","9800",元大-頭份,0,10,10,-1,0.69
"20230707","1783","1440","1440",美林,94,9,85,1,5.13
"20230707","1783","0035003300380044","5380",第一金-忠孝,0,25,25,-1,1.51
"20230707","1783","9268","9200",凱基-台北,166,92,74,1,4.46
"20230707","1783","9697","9600",富邦-虎尾,14,37,23,-1,1.39
"20230707","1783","1480","1480",美商高盛,58,2,56,1,3.38
"20230707","1783","8560","8560",新光,8,30,22,-1,1.33
"20230707","1783","2180","2180",亞東,45,0,45,1,2.71
"20230707","1783","7007","7000",兆豐-竹北,10,30,20,-1,1.21
"20230707","1783","1560","1560",港商野村,41,2,39,1,2.35
"20230707","1783","003700370039006d","7790",國票-中港,13,33,20,-1,1.21
"20230707","1783","8150","8150",台新證券,42,4,38,1,2.29
"20230707","1783","5850","5850",統一,31,50,19,-1,1.15
"20230707","1783","0037003000300068","7000",兆豐-三民,21,0,21,1,1.27
"20230707","1783","8459","8450",康和-嘉義,13,32,19,-1,1.15
"20230707","1783","0039003800330047","9800",元大-上新莊,21,1,20,1,1.21
"20230707","1783","0039003600310043","9600",富邦-南京,13,32,19,-1,1.15
"20230707","1783","9337","9300",華南永昌-內壢,20,1,19,1,1.15
"20230707","1783","8885","8880",國泰-桃園,1,19,18,-1,1.09
"20230707","1783","0039003100380045","9100",群益金鼎-南京,13,0,13,1,0.78
"20230707","1783","9801","9800",元大-城東,1,19,18,-1,1.09
"20230707","1783","0039003200300046","9200",凱基-站前,14,3,11,1,0.66
"20230707","1783","0039003800310051","9800",元大-太平,14,32,18,-1,1.09
"20230707","1783","8440","8440",摩根大通,53,43,10,1,0.60
"20230707","1783","0038003800340041","8840",玉山-士林,0,15,15,-1,0.90
"20230707","1783","8882","8880",國泰-台中,10,1,9,1,0.54
"20230707","1783","9322","9300",華南永昌-公誠,7,21,14,-1,0.84
"20230707","1783","003800380038004b","8880",國泰-板橋,10,1,9,1,0.54
"20230707","1783","9658","9600",富邦-建國,0,12,12,-1,0.72
"20230710","1783","9268","9200",凱基-台北,144,98,46,1,4.45
"20230710","1783","7007","7000",兆豐-竹北,0,40,40,-1,3.87
"20230710","1783","003900380031006d","9800",元大-前金,18,1,17,1,1.64
"20230710","1783","1480","1480",美商高盛,6,25,19,-1,1.84
"20230710","1783","5385","5380",第一金-桃園,12,0,12,1,1.16
"20230710","1783","0039004100390041","9A00",永豐金-羅東,0,12,12,-1,1.16
"20230710","1783","5925","5920",元富-台中,10,0,10,1,0.97
"20230710","1783","003900360032004b","9600",富邦-中和,0,12,12,-1,1.16
"20230710","1783","0039003800330047","9800",元大-上新莊,10,0,10,1,0.97
"20230710","1783","9103","9100",群益金鼎-松山,0,10,10,-1,0.97
"20230710","1783","7791","7790",國票-台東,10,1,9,1,0.87
"20230710","1783","0039003600330041","9600",富邦-八德,0,10,10,-1,0.97
"20230710","1783","9303","9300",華南永昌-高雄,10,1,9,1,0.87
"20230710","1783","9667","9600",富邦-台南,1,11,10,-1,0.97
"20230710","1783","9874","9800",元大-雙和,10,1,9,1,0.87
"20230710","1783","003900380039006d","9800",元大-信義,0,10,10,-1,0.97
"20230710","1783","0031003200360044","1260",宏遠-台南,8,0,8,1,0.77
"20230710","1783","003900380039004e","9800",元大-內湖,0,10,10,-1,0.97
"20230710","1783","5320","5320",高橋,8,0,8,1,0.77
"20230710","1783","003900410039006a","9A00",永豐金-嘉義,0,10,10,-1,0.97
"20230710","1783","003900310038007a","9100",群益金鼎-宜蘭,7,0,7,1,0.68
"20230710","1783","9189","9100",群益金鼎-桃園,5,14,9,-1,0.87
"20230710","1783","9657","9600",富邦-苗栗,7,0,7,1,0.68
"20230710","1783","0035003300380045","5380",第一金-自由,3,10,7,-1,0.68
"20230710","1783","0039003600320045","9600",富邦-樹林,6,0,6,1,0.58
"20230710","1783","0039003600310056","9600",富邦-板橋中山,3,9,6,-1,0.58
"20230710","1783","1440","1440",美林,10,4,6,1,0.58
"20230710","1783","8885","8880",國泰-桃園,0,6,6,-1,0.58
"20230711","1783","9834","9800",元大-中壢,30,1,29,1,3.00
"20230711","1783","003500390032006e","5920",元富-西松,0,42,42,-1,4.34
"20230711","1783","8560","8560",新光,28,4,24,1,2.48
"20230711","1783","1560","1560",港商野村,0,32,32,-1,3.31
"20230711","1783","9837","9800",元大-北港,26,3,23,1,2.38
"20230711","1783","1650","1650",新加坡商瑞銀,47,74,27,-1,2.79
"20230711","1783","0039003800390043","9800",元大-板橋,21,0,21,1,2.17
"20230711","1783","003500390032006d","5920",元富-成功,0,25,25,-1,2.59
"20230711","1783","9869","9800",元大-新盛,12,0,12,1,1.24
"20230711","1783","0039003100330059","9100",群益金鼎-館前,0,25,25,-1,2.59
"20230711","1783","0039003800380056","9800",元大-長庚,12,0,12,1,1.24
"20230711","1783","1480","1480",美商高盛,13,36,23,-1,2.38
"20230711","1783","9623","9600",富邦-台北,12,1,11,1,1.14
"20230711","1783","9317","9300",華南永昌-林口,1,23,22,-1,2.28
"20230711","1783","003900360032004b","9600",富邦-中和,11,0,11,1,1.14
"20230711","1783","003900310033004e","9100",群益金鼎-土城,0,21,21,-1,2.17
"20230711","1783","0038003100350041","8150",台新-高雄,10,0,10,1,1.03
"20230711","1783","9285","9200",凱基-中壢,1,21,20,-1,2.07
"20230711","1783","1020","1020",合庫證券,11,1,10,1,1.03
"20230711","1783","0039003600310043","9600",富邦-南京,4,24,20,-1,2.07
"20230711","1783","5323","5320",高橋-內壢,10,0,10,1,1.03
"20230711","1783","8440","8440",摩根大通,6,25,19,-1,1.96
"20230711","1783","0036003100310041","6110",台中銀-豐原,10,0,10,1,1.03
"20230711","1783","8883","8880",國泰-松江,5,23,18,-1,1.86
"20230711","1783","0037003700390058","7790",國票-中和,10,0,10,1,1.03
"20230711","1783","003900320030004e","9200",凱基-湖口,1,19,18,-1,1.86
"20230711","1783","9103","9100",群益金鼎-松山,10,0,10,1,1.03
"20230711","1783","9817","9800",元大-東泰,0,18,18,-1,1.86
"20230712","1783","9837","9800",元大-北港,41,7,34,1,2.70
"20230712","1783","8150","8150",台新證券,7,56,49,-1,3.90
"20230712","1783","9892","9800",元大-屏東,25,2,23,1,1.83
"20230712","1783","9268","9200",凱基-台北,67,112,45,-1,3.58
"20230712","1783","1440","1440",美林,48,27,21,1,1.67
"20230712","1783","0035003300380045","5380",第一金-自由,1,41,40,-1,3.18
"20230712","1783","8843","8840",玉山-高雄,21,0,21,1,1.67
"20230712","1783","8440","8440",摩根大通,0,38,38,-1,3.02
"20230712","1783","0039003200300046","9200",凱基-站前,23,2,21,1,1.67
"20230712","1783","0035003900320047","5920",元富-新竹,0,30,30,-1,2.39
"20230712","1783","9278","9200",凱基-永康,21,0,21,1,1.67
"20230712","1783","8849","8840",玉山-景美,0,22,22,-1,1.75
"20230712","1783","003900360032004b","9600",富邦-中和,16,0,16,1,1.27
"20230712","1783","0039004100390066","9A00",永豐金-中盛,0,22,22,-1,1.75
"20230712","1783","0039003600330041","9600",富邦-八德,19,3,16,1,1.27
"20230712","1783","5920","5920",元富,0,20,20,-1,1.59
"20230712","1783","8560","8560",新光,20,6,14,1,1.11
"20230712","1783","9289","9200",凱基-興隆,1,21,20,-1,1.59
"20230712","1783","9831","9800",元大-四維,14,0,14,1,1.11
"20230712","1783","9317","9300",華南永昌-林口,0,20,20,-1,1.59
"20230712","1783","0039004100300030","9A00",永豐金證券,19,5,14,1,1.11
"20230712","1783","0039003800380042","9800",元大-桃園,0,20,20,-1,1.59
"20230712","1783","0035003900320072","5920",元富-城東,12,0,12,1,0.95
"20230712","1783","9236","9200",凱基-虎尾,0,19,19,-1,1.51
"20230712","1783","0039003200300047","9200",凱基-彰化,14,2,12,1,0.95
"20230712","1783","9800","9800",元大證券,13,31,18,-1,1.43
"20230712","1783","6380","6380",光和,11,0,11,1,0.88
"20230712","1783","8882","8880",國泰-台中,12,28,16,-1,1.27
"20230713","1783","9608","9600",富邦-台東,20,0,20,1,2.31
"20230713","1783","1470","1470",台灣摩根士丹利,2,69,67,-1,7.74
"20230713","1783","9857","9800",元大-東蘆,20,0,20,1,2.31
"20230713","1783","8440","8440",摩根大通,6,28,22,-1,2.54
"20230713","1783","0035003900320072","5920",元富-城東,14,0,14,1,1.62
"20230713","1783","1650","1650",新加坡商瑞銀,52,67,15,-1,1.73
"20230713","1783","8560","8560",新光,27,15,12,1,1.39
"20230713","1783","8450","8450",康和,0,15,15,-1,1.73
"20230713","1783","9278","9200",凱基-永康,11,0,11,1,1.27
"20230713","1783","1560","1560",港商野村,0,14,14,-1,1.62
"20230713","1783","9892","9800",元大-屏東,10,0,10,1,1.15
"20230713","1783","003900360032004b","9600",富邦-中和,0,14,14,-1,1.62
"20230713","1783","0035003800350050","5850",統一-板橋,10,0,10,1,1.15
"20230713","1783","9215","9200",凱基-高美館,2,15,13,-1,1.50
"20230713","1783","0035003900320057","5920",元富-吉利,10,0,10,1,1.15
"20230713","1783","9800","9800",元大證券,11,23,12,-1,1.39
"20230713","1783","0035003300380050","5380",第一金-路竹,8,0,8,1,0.92
"20230713","1783","5322","5320",高橋-中壢,0,10,10,-1,1.15
"20230713","1783","9872","9800",元大-復北,7,0,7,1,0.81
"20230713","1783","9871","9800",元大-忠孝,0,10,10,-1,1.15
"20230713","1783","9188","9100",群益金鼎-三民,6,0,6,1,0.69
"20230713","1783","0035003900320053","5920",元富-基隆,0,8,8,-1,0.92
"20230713","1783","5859","5850",統一-屏東,5,0,5,1,0.58
"20230713","1783","7003","7000",兆豐-台中,1,9,8,-1,0.92
"20230713","1783","6462","6460",大昌-安康,6,1,5,1,0.58
"20230713","1783","0039003600310043","9600",富邦-南京,1,9,8,-1,0.92
"20230713","1783","0037003000300063","7000",兆豐-民生,6,1,5,1,0.58
"20230713","1783","8888","8880",國泰-敦南,2,10,8,-1,0.92
"20230714","1783","9268","9200",凱基-台北,67,38,29,1,4.31
"20230714","1783","0039004100300030","9A00",永豐金證券,0,56,56,-1,8.32
"20230714","1783","9874","9800",元大-雙和,24,0,24,1,3.57
"20230714","1783","0037003000300072","7000",兆豐-寶成,0,42,42,-1,6.24
"20230714","1783","9275","9200",凱基-三多,9,0,9,1,1.34
"20230714","1783","1480","1480",美商高盛,3,30,27,-1,4.01
"20230714","1783","9659","9600",富邦-高雄,11,3,8,1,1.19
"20230714","1783","5322","5320",高橋-中壢,0,11,11,-1,1.63
"20230714","1783","003900380030004b","9800",元大-竹科,8,0,8,1,1.19
"20230714","1783","9800","9800",元大證券,3,14,11,-1,1.63
"20230714","1783","8150","8150",台新證券,8,1,7,1,1.04
"20230714","1783","0031003200360044","1260",宏遠-台南,0,10,10,-1,1.49
"20230714","1783","9278","9200",凱基-永康,7,0,7,1,1.04
"20230714","1783","0039003800380056","9800",元大-長庚,2,10,8,-1,1.19
"20230714","1783","9815","9800",元大-大灣,8,1,7,1,1.04
"20230714","1783","9254","9200",凱基-科園,0,7,7,-1,1.04
"20230714","1783","8882","8880",國泰-台中,8,2,6,1,0.89
"20230714","1783","5920","5920",元富,4,10,6,-1,0.89
"20230714","1783","0036003300380041","6380",光和-嘉義,5,0,5,1,0.74
"20230714","1783","003800380034004d","8840",玉山-數位,0,6,6,-1,0.89
"20230714","1783","6460","6460",大昌,5,0,5,1,0.74
"20230714","1783","5320","5320",高橋,0,5,5,-1,0.74
"20230714","1783","8151","8150",台新-建北,5,0,5,1,0.74
"20230714","1783","6380","6380",光和,0,5,5,-1,0.74
"20230714","1783","8440","8440",摩根大通,5,0,5,1,0.74
"20230714","1783","9833","9800",元大-敦化,0,5,5,-1,0.74
"20230714","1783","8455","8450",康和-台中,6,1,5,1,0.74
"20230714","1783","0039003800390061","9800",元大-苑裡,1,6,5,-1,0.74
"20230717","1783","9268","9200",凱基-台北,66,41,25,1,3.60
"20230717","1783","9289","9200",凱基-興隆,0,20,20,-1,2.88
"20230717","1783","1440","1440",美林,24,0,24,1,3.46
"20230717","1783","0031003200360044","1260",宏遠-台南,0,12,12,-1,1.73
"20230717","1783","1470","1470",台灣摩根士丹利,30,6,24,1,3.46
"20230717","1783","9800","9800",元大證券,3,15,12,-1,1.73
"20230717","1783","1040","1040",臺銀,20,2,18,1,2.59
"20230717","1783","5384","5380",第一金-台南,0,11,11,-1,1.59
"20230717","1783","1560","1560",港商野村,18,2,16,1,2.31
"20230717","1783","8846","8840",玉山-板橋,0,10,10,-1,1.44
"20230717","1783","1480","1480",美商高盛,27,15,12,1,1.73
"20230717","1783","9275","9200",凱基-三多,0,9,9,-1,1.30
"20230717","1783","8888","8880",國泰-敦南,22,10,12,1,1.73
"20230717","1783","8848","8840",玉山-嘉義,0,8,8,-1,1.15
"20230717","1783","003700370039004a","7790",國票-北高雄,10,1,9,1,1.30
"20230717","1783","8562","8560",新光-高雄,0,8,8,-1,1.15
"20230717","1783","1028","1020",合庫-彰化,9,1,8,1,1.15
"20230717","1783","003900380030004b","9800",元大-竹科,0,8,8,-1,1.15
"20230717","1783","7003","7000",兆豐-台中,8,0,8,1,1.15
"20230717","1783","9813","9800",元大-八德,0,8,8,-1,1.15
"20230717","1783","0039003800330056","9800",元大-竹南,8,0,8,1,1.15
"20230717","1783","9647","9600",富邦-新竹,0,7,7,-1,1.01
"20230717","1783","9202","9200",凱基-中港,7,0,7,1,1.01
"20230717","1783","9659","9600",富邦-高雄,0,7,7,-1,1.01
"20230717","1783","0031003000320045","1020",合庫-桃園,6,0,6,1,0.86
"20230717","1783","9896","9800",元大-台南,0,7,7,-1,1.01
"20230717","1783","9205","9200",凱基-三重,5,0,5,1,0.72
"20230717","1783","0037003000300064","7000",兆豐-彰化,0,6,6,-1,0.86
"20230718","1783","0035003900320072","5920",元富-城東,30,0,30,1,2.59
"20230718","1783","1650","1650",新加坡商瑞銀,16,80,64,-1,5.52
"20230718","1783","9206","9200",凱基-高雄,25,0,25,1,2.16
"20230718","1783","1480","1480",美商高盛,0,62,62,-1,5.35
"20230718","1783","9315","9300",華南永昌-苑裡,24,0,24,1,2.07
"20230718","1783","8440","8440",摩根大通,0,41,41,-1,3.54
"20230718","1783","8151","8150",台新-建北,21,1,20,1,1.73
"20230718","1783","0039003800330047","9800",元大-上新莊,1,40,39,-1,3.36
"20230718","1783","0039004100390045","9A00",永豐金-板橋,16,0,16,1,1.38
"20230718","1783","8150","8150",台新證券,2,32,30,-1,2.59
"20230718","1783","9867","9800",元大-北成功,15,0,15,1,1.29
"20230718","1783","0039003600320055","9600",富邦-縣政,2,30,28,-1,2.42
"20230718","1783","6160","6160",中國信託,14,0,14,1,1.21
"20230718","1783","1440","1440",美林,1,27,26,-1,2.24
"20230718","1783","0039003800320042","9800",元大-博愛,14,0,14,1,1.21
"20230718","1783","003900310038004a","9100",群益金鼎-永和,51,75,24,-1,2.07
"20230718","1783","0039003800310044","9800",元大-南投,12,0,12,1,1.04
"20230718","1783","0031003200360044","1260",宏遠-台南,0,22,22,-1,1.90
"20230718","1783","0039003800390061","9800",元大-苑裡,12,0,12,1,1.04
"20230718","1783","1470","1470",台灣摩根士丹利,0,22,22,-1,1.90
"20230718","1783","0039003800390046","9800",元大-高雄,11,0,11,1,0.95
"20230718","1783","9308","9300",華南永昌-麻豆,2,24,22,-1,1.90
"20230718","1783","6464","6460",大昌-新店,11,0,11,1,0.95
"20230718","1783","003900410039004d","9A00",永豐金-南投,10,31,21,-1,1.81
"20230718","1783","0035003300380041","5380",第一金-新興,10,0,10,1,0.86
"20230718","1783","0037003000300068","7000",兆豐-三民,1,20,19,-1,1.64
"20230718","1783","0035003300380046","5380",第一金-大稻埕,10,0,10,1,0.86
"20230718","1783","0039004100390068","9A00",永豐金-台南,2,19,17,-1,1.47
"20230719","1783","1470","1470",台灣摩根士丹利,62,7,55,1,2.54
"20230719","1783","0031003000340041","1040",臺銀-臺中,1,36,35,-1,1.62
"20230719","1783","0039003800320043","9800",元大-六合,46,2,44,1,2.03
"20230719","1783","003900360032004b","9600",富邦-中和,3,31,28,-1,1.29
"20230719","1783","003900380031004c","9800",元大-莒光,38,0,38,1,1.76
"20230719","1783","9315","9300",華南永昌-苑裡,0,25,25,-1,1.15
"20230719","1783","0036003000310064","6010",(牛牛牛)亞-鑫豐,33,0,33,1,1.52
"20230719","1783","003900320031004a","9200",凱基-土城,0,20,20,-1,0.92
"20230719","1783","9308","9300",華南永昌-麻豆,26,0,26,1,1.20
"20230719","1783","8882","8880",國泰-台中,11,31,20,-1,0.92
"20230719","1783","9898","9800",元大-新莊,29,4,25,1,1.15
"20230719","1783","9665","9600",富邦-桃園,0,18,18,-1,0.83
"20230719","1783","1040","1040",臺銀,23,0,23,1,1.06
"20230719","1783","9831","9800",元大-四維,5,22,17,-1,0.79
"20230719","1783","0039003600320045","9600",富邦-樹林,18,0,18,1,0.83
"20230719","1783","1440","1440",美林,11,26,15,-1,0.69
"20230719","1783","8847","8840",玉山-台南,17,2,15,1,0.69
"20230719","1783","9272","9200",凱基-竹科,4,18,14,-1,0.65
"20230719","1783","7007","7000",兆豐-竹北,13,0,13,1,0.60
"20230719","1783","8150","8150",台新證券,23,36,13,-1,0.60
"20230719","1783","0031003200360058","1260",宏遠-新化,13,1,12,1,0.55
"20230719","1783","9254","9200",凱基-科園,0,12,12,-1,0.55
"20230719","1783","0038003100350042","8150",台新-台中,12,1,11,1,0.51
"20230719","1783","9800","9800",元大證券,26,38,12,-1,0.55
"20230719","1783","9212","9200",凱基-東港,11,0,11,1,0.51
"20230719","1783","0031003100310046","1110",台灣企銀-北高雄,0,11,11,-1,0.51
"20230719","1783","5860","5860",盈溢,10,0,10,1,0.46
"20230719","1783","0039003800310044","9800",元大-南投,1,12,11,-1,0.51
"20230720","1783","0039003600320045","9600",富邦-樹林,29,0,29,1,2.33
"20230720","1783","8440","8440",摩根大通,23,94,71,-1,5.70
"20230720","1783","003900380030004b","9800",元大-竹科,25,0,25,1,2.01
"20230720","1783","1440","1440",美林,0,57,57,-1,4.58
"20230720","1783","0039003800390043","9800",元大-板橋,21,2,19,1,1.53
"20230720","1783","1650","1650",新加坡商瑞銀,50,89,39,-1,3.13
"20230720","1783","8151","8150",台新-建北,15,0,15,1,1.20
"20230720","1783","1480","1480",美商高盛,2,38,36,-1,2.89
"20230720","1783","0035003300380057","5380",第一金-華江,15,0,15,1,1.20
"20230720","1783","0036003000310064","6010",(牛牛牛)亞-鑫豐,1,33,32,-1,2.57
"20230720","1783","0039004100390065","9A00",永豐金-高雄,15,0,15,1,1.20
"20230720","1783","0038003400350045","8450",康和-澎湖,4,24,20,-1,1.61
"20230720","1783","0039003800300065","9800",元大-清水,14,0,14,1,1.12
"20230720","1783","9857","9800",元大-東蘆,2,21,19,-1,1.53
"20230720","1783","1470","1470",台灣摩根士丹利,22,9,13,1,1.04
"20230720","1783","8150","8150",台新證券,9,25,16,-1,1.29
"20230720","1783","0039004100390032","9A00",永豐金-萬盛,13,0,13,1,1.04
"20230720","1783","1560","1560",港商野村,3,19,16,-1,1.29
"20230720","1783","0039003800340043","9800",元大-新店中正,12,0,12,1,0.96
"20230720","1783","0039003100380045","9100",群益金鼎-南京,0,13,13,-1,1.04
"20230720","1783","8560","8560",新光,17,7,10,1,0.80
"20230720","1783","0039003800300064","9800",元大-沙鹿,0,11,11,-1,0.88
"20230720","1783","8382","8380",安泰-楠梓,10,0,10,1,0.80
"20230720","1783","6165","6160",中國信託-新竹,0,10,10,-1,0.80
"20230720","1783","003800380038004b","8880",國泰-板橋,11,1,10,1,0.80
"20230720","1783","0037003000300067","7000",兆豐-南門,0,10,10,-1,0.80
"20230720","1783","9337","9300",華南永昌-內壢,25,15,10,1,0.80
"20230720","1783","0039003800310069","9800",元大-西螺,0,10,10,-1,0.80
"20230721","1783","0035003300380044","5380",第一金-忠孝,42,2,40,1,1.91
"20230721","1783","9268","9200",凱基-台北,143,247,104,-1,4.98
"20230721","1783","9867","9800",元大-北成功,41,1,40,1,1.91
"20230721","1783","8440","8440",摩根大通,46,103,57,-1,2.73
"20230721","1783","1560","1560",港商野村,36,9,27,1,1.29
"20230721","1783","003900310038004a","9100",群益金鼎-永和,1,50,49,-1,2.34
"20230721","1783","9871","9800",元大-忠孝,30,5,25,1,1.20
"20230721","1783","1440","1440",美林,27,66,39,-1,1.87
"20230721","1783","8560","8560",新光,40,17,23,1,1.10
"20230721","1783","0031003000320046","1020",合庫-西台中,0,37,37,-1,1.77
"20230721","1783","9831","9800",元大-四維,26,5,21,1,1.00
"20230721","1783","1470","1470",台灣摩根士丹利,16,47,31,-1,1.48
"20230721","1783","0038003400350045","8450",康和-澎湖,22,2,20,1,0.96
"20230721","1783","9898","9800",元大-新莊,2,32,30,-1,1.44
"20230721","1783","9315","9300",華南永昌-大甲,18,1,17,1,0.81
"20230721","1783","8846","8840",玉山-板橋,2,30,28,-1,1.34
"20230721","1783","0031003000340041","1040",臺銀-臺中,41,25,16,1,0.77
"20230721","1783","6464","6460",大昌-新店,10,27,17,-1,0.81
"20230721","1783","8563","8560",新光-新竹,19,4,15,1,0.72
"20230721","1783","7007","7000",兆豐-竹北,5,20,15,-1,0.72
"20230721","1783","0039004100390062","9A00",永豐金-虎尾,12,1,11,1,0.53
"20230721","1783","0039003800300065","9800",元大-清水,6,18,12,-1,0.57
"20230721","1783","9833","9800",元大-敦化,23,12,11,1,0.53
"20230721","1783","003700300030005a","7000",兆豐-高雄,5,16,11,-1,0.53
"20230721","1783","9349","9300",華南永昌-板橋,11,1,10,1,0.48
"20230721","1783","8450","8450",康和,0,10,10,-1,0.48
"20230721","1783","0039003600320045","9600",富邦-樹林,40,30,10,1,0.48
"20230721","1783","9337","9300",華南永昌-內壢,0,10,10,-1,0.48
"20230724","1783","0039003600310046","9600",富邦-中港,20,0,20,1,3.20
"20230724","1783","0031003000340044","1040",臺銀-金山,1,29,28,-1,4.48
"20230724","1783","0039003800300068","9800",元大-台北,17,0,17,1,2.72
"20230724","1783","003900380031004c","9800",元大-莒光,0,25,25,-1,4.00
"20230724","1783","8849","8840",玉山-景美,15,0,15,1,2.40
"20230724","1783","8846","8840",玉山-板橋,0,20,20,-1,3.20
"20230724","1783","9856","9800",元大-花蓮,15,1,14,1,2.24
"20230724","1783","003800380038004b","8880",國泰-板橋,2,22,20,-1,3.20
"20230724","1783","9801","9800",元大-城東,13,0,13,1,2.08
"20230724","1783","1470","1470",台灣摩根士丹利,0,16,16,-1,2.56
"20230724","1783","5261","5260",美好-蘆洲,10,0,10,1,1.60
"20230724","1783","7795","7790",國票-南港,2,17,15,-1,2.40
"20230724","1783","8710","8710",陽信,10,0,10,1,1.60
"20230724","1783","8440","8440",摩根大通,0,10,10,-1,1.60
"20230724","1783","9278","9200",凱基-永康,10,0,10,1,1.60
"20230724","1783","9204","9200",凱基-台中,0,10,10,-1,1.60
"20230724","1783","0031003000340043","1040",臺銀-高雄,9,0,9,1,1.44
"20230724","1783","003900320031004a","9200",凱基-土城,0,10,10,-1,1.60
"20230724","1783","1040","1040",臺銀,10,2,8,1,1.28
"20230724","1783","8885","8880",國泰-桃園,0,9,9,-1,1.44
"20230724","1783","0039003100330044","9100",群益金鼎-潭子,7,0,7,1,1.12
"20230724","1783","9815","9800",元大-大灣,0,8,8,-1,1.28
"20230724","1783","9814","9800",元大-大益,8,1,7,1,1.12
"20230724","1783","0039004100380039","9A00",永豐金-敦北,0,8,8,-1,1.28
"20230724","1783","0039003800390061","9800",元大-苑裡,7,0,7,1,1.12
"20230724","1783","9624","9600",富邦-竹北,1,8,7,-1,1.12
"20230724","1783","5859","5850",統一-屏東,5,0,5,1,0.80
"20230724","1783","5260","5260",美好,0,6,6,-1,0.96
"20230725","1783","9268","9200",凱基-台北,181,63,118,1,11.17
"20230725","1783","0031003000340044","1040",臺銀-金山,0,24,24,-1,2.27
"20230725","1783","8440","8440",摩根大通,43,0,43,1,4.07
"20230725","1783","0031003000340041","1040",臺銀-臺中,1,21,20,-1,1.89
"20230725","1783","8150","8150",台新證券,34,5,29,1,2.75
"20230725","1783","9833","9800",元大-敦化,0,20,20,-1,1.89
"20230725","1783","1650","1650",新加坡商瑞銀,30,8,22,1,2.08
"20230725","1783","9315","9300",華南永昌-大甲,2,21,19,-1,1.80
"20230725","1783","0039004100390039","9A00",永豐金-中壢,11,0,11,1,1.04
"20230725","1783","8560","8560",新光,4,20,16,-1,1.52
"20230725","1783","0037003000300077","7000",兆豐-新莊,10,0,10,1,0.95
"20230725","1783","1560","1560",港商野村,0,15,15,-1,1.42
"20230725","1783","8888","8880",國泰-敦南,14,5,9,1,0.85
"20230725","1783","6012","6010",(牛牛牛)亞-網路,0,15,15,-1,1.42
"20230725","1783","003900310038004b","9100",群益金鼎-東湖,8,0,8,1,0.76
"20230725","1783","1440","1440",美林,5,19,14,-1,1.33
"20230725","1783","003700300030005a","7000",兆豐-高雄,8,1,7,1,0.66
"20230725","1783","8846","8840",玉山-板橋,0,12,12,-1,1.14
"20230725","1783","0039003600320047","9600",富邦-斗六,7,0,7,1,0.66
"20230725","1783","0037003700390045","7790",國票-南崁,1,12,11,-1,1.04
"20230725","1783","9898","9800",元大-新莊,7,0,7,1,0.66
"20230725","1783","0038003100350048","8150",台新-屏東,0,11,11,-1,1.04
"20230725","1783","8455","8450",康和-台中,6,1,5,1,0.47
"20230725","1783","1028","1020",合庫-彰化,0,10,10,-1,0.95
"20230725","1783","003900380031006e","9800",元大-旗山,5,0,5,1,0.47
"20230725","1783","8151","8150",台新-建北,0,10,10,-1,0.95
"20230725","1783","9835","9800",元大-員林中山,5,0,5,1,0.47
"20230725","1783","9103","9100",群益金鼎-松山,0,10,10,-1,0.95
"20230726","1783","0031003000340041","1040",臺銀-臺中,20,1,19,1,2.45
"20230726","1783","1650","1650",新加坡商瑞銀,16,49,33,-1,4.25
"20230726","1783","0039003600310045","9600",富邦-府城,19,0,19,1,2.45
"20230726","1783","003700370039005a","7790",國票-安和,0,30,30,-1,3.86
"20230726","1783","9315","9300",華南永昌-大甲,16,0,16,1,2.06
"20230726","1783","9215","9200",凱基-高美館,3,27,24,-1,3.09
"20230726","1783","1029","1020",合庫-鳳山,15,0,15,1,1.93
"20230726","1783","1470","1470",台灣摩根士丹利,1,18,17,-1,2.19
"20230726","1783","8150","8150",台新證券,19,4,15,1,1.93
"20230726","1783","9268","9200",凱基-台北,51,68,17,-1,2.19
"20230726","1783","8849","8840",玉山-景美,14,0,14,1,1.80
"20230726","1783","1560","1560",港商野村,0,16,16,-1,2.06
"20230726","1783","8882","8880",國泰-台中,13,0,13,1,1.67
"20230726","1783","8847","8840",玉山-台南,2,17,15,-1,1.93
"20230726","1783","003900410039004a","9A00",永豐金-板新,13,0,13,1,1.67
"20230726","1783","0039004100390065","9A00",永豐金-高雄,0,15,15,-1,1.93
"20230726","1783","0037003700390050","7790",國票-九鼎,12,0,12,1,1.54
"20230726","1783","8560","8560",新光,9,23,14,-1,1.80
"20230726","1783","5320","5320",高橋,11,0,11,1,1.42
"20230726","1783","9856","9800",元大-花蓮,2,15,13,-1,1.67
"20230726","1783","0039004100360031","9A00",永豐金-鳳山,11,0,11,1,1.42
"20230726","1783","9801","9800",元大-城東,0,13,13,-1,1.67
"20230726","1783","8151","8150",台新-建北,10,0,10,1,1.29
"20230726","1783","8888","8880",國泰-敦南,3,14,11,-1,1.42
"20230726","1783","9238","9200",凱基-士林,10,0,10,1,1.29
"20230726","1783","1440","1440",美林,0,10,10,-1,1.29
"20230726","1783","003900320030004e","9200",凱基-湖口,9,0,9,1,1.16
"20230726","1783","0035003900320051","5920",元富-敦南,0,10,10,-1,1.29
"20230727","1783","9268","9200",凱基-台北,407,72,335,1,7.38
"20230727","1783","0039003600310053","9600",富邦-景美,0,133,133,-1,2.93
"20230727","1783","1470","1470",台灣摩根士丹利,150,9,141,1,3.11
"20230727","1783","1380","1380",台灣匯立證券,0,100,100,-1,2.20
"20230727","1783","1650","1650",新加坡商瑞銀,153,35,118,1,2.60
"20230727","1783","8150","8150",台新證券,25,96,71,-1,1.56
"20230727","1783","8440","8440",摩根大通,98,17,81,1,1.78
"20230727","1783","9874","9800",元大-雙和,1,64,63,-1,1.39
"20230727","1783","5854","5850",統一-城中,77,0,77,1,1.70
"20230727","1783","9831","9800",元大-四維,0,56,56,-1,1.23
"20230727","1783","1560","1560",港商野村,62,0,62,1,1.37
"20230727","1783","8560","8560",新光,9,52,43,-1,0.95
"20230727","1783","6012","6010",(牛牛牛)亞-網路,60,0,60,1,1.32
"20230727","1783","0039003600320045","9600",富邦-樹林,17,58,41,-1,0.90
"20230727","1783","9600","9600",富邦證券,45,0,45,1,0.99
"20230727","1783","0039003600330041","9600",富邦-八德,0,35,35,-1,0.77
"20230727","1783","9278","9200",凱基-永康,74,31,43,1,0.95
"20230727","1783","0035003300380057","5380",第一金-華江,1,34,33,-1,0.73
"20230727","1783","1480","1480",美商高盛,34,0,34,1,0.75
"20230727","1783","8888","8880",國泰-敦南,25,58,33,-1,0.73
"20230727","1783","1440","1440",美林,41,11,30,1,0.66
"20230727","1783","9817","9800",元大-東泰,0,33,33,-1,0.73
"20230727","1783","9692","9600",富邦-嘉義,27,1,26,1,0.57
"20230727","1783","6380","6380",光和,0,31,31,-1,0.68
"20230727","1783","0035003900320055","5920",元富-宜蘭,21,1,20,1,0.44
"20230727","1783","003900360031004a","9600",富邦-興業,0,31,31,-1,0.68
"20230727","1783","0037003700390063","7790",國票-敦北法人,11,1,10,1,0.22
"20230727","1783","8450","8450",康和,1,31,30,-1,0.66
"20230728","1783","9658","9600",富邦-建國,90,10,80,1,1.09
"20230728","1783","8440","8440",摩根大通,54,192,138,-1,1.88
"20230728","1783","0035003900320061","5920",元富-松德,73,6,67,1,0.91
"20230728","1783","0039003600310053","9600",富邦-景美,1,100,99,-1,1.35
"20230728","1783","0035003900320065","5920",元富-古亭,73,11,62,1,0.85
"20230728","1783","0039004100300030","9A00",永豐金證券,29,117,88,-1,1.20
"20230728","1783","0031003000340041","1040",臺銀-臺中,69,10,59,1,0.81
"20230728","1783","9600","9600",富邦證券,0,45,45,-1,0.61
"20230728","1783","1470","1470",台灣摩根士丹利,71,28,43,1,0.59
"20230728","1783","6160","6160",中國信託,6,45,39,-1,0.53
"20230728","1783","9676","9600",富邦-仁愛,44,3,41,1,0.56
"20230728","1783","1650","1650",新加坡商瑞銀,200,232,32,-1,0.44
"20230728","1783","5961","5960",日茂-埔里,41,0,41,1,0.56
"20230728","1783","003900360032004b","9600",富邦-中和,4,34,30,-1,0.41
"20230728","1783","0035003800350055","5850",統一-南京,40,3,37,1,0.50
"20230728","1783","1440","1440",美林,2,30,28,-1,0.38
"20230728","1783","9268","9200",凱基-台北,484,448,36,1,0.49
"20230728","1783","1560","1560",港商野村,47,73,26,-1,0.35
"20230728","1783","9898","9800",元大-新莊,37,5,32,1,0.44
"20230728","1783","5385","5380",第一金-桃園,0,20,20,-1,0.27
"20230728","1783","003500390032006e","5920",元富-西松,31,0,31,1,0.42
"20230728","1783","9337","9300",華南永昌-內壢,0,20,20,-1,0.27
"20230728","1783","0031003200360044","1260",宏遠-台南,30,0,30,1,0.41
"20230728","1783","0035003900320055","5920",元富-宜蘭,7,26,19,-1,0.26
"20230728","1783","5266","5260",美好-中壢,31,1,30,1,0.41
"20230728","1783","0039003100380046","9100",群益金鼎-新店,24,41,17,-1,0.23
"20230728","1783","0039003800330066","9800",元大-竹東,30,0,30,1,0.41
"20230728","1783","0035003300380046","5380",第一金-大稻埕,0,16,16,-1,0.22
"20230731","1783","0031003000340041","1040",臺銀-臺中,63,0,63,1,3.71
"20230731","1783","0035003900320061","5920",元富-松德,0,70,70,-1,4.13
"20230731","1783","9874","9800",元大-雙和,47,1,46,1,2.71
"20230731","1783","9268","9200",凱基-台北,149,211,62,-1,3.66
"20230731","1783","8560","8560",新光,60,18,42,1,2.48
"20230731","1783","6012","6010",(牛牛牛)亞-網路,0,40,40,-1,2.36
"20230731","1783","9852","9800",元大-永春,36,0,36,1,2.12
"20230731","1783","0039003800320042","9800",元大-博愛,4,30,26,-1,1.53
"20230731","1783","0035003800350055","5850",統一-南京,22,0,22,1,1.30
"20230731","1783","0039004100390041","9A00",永豐金-羅東,0,26,26,-1,1.53
"20230731","1783","0039003100380046","9100",群益金鼎-新店,42,21,21,1,1.24
"20230731","1783","0039003200300046","9200",凱基-站前,2,25,23,-1,1.36
"20230731","1783","6380","6380",光和,18,1,17,1,1.00
"20230731","1783","0035003300380044","5380",第一金-忠孝,0,21,21,-1,1.24
"20230731","1783","0039003800310046","9800",元大-福營,16,1,15,1,0.88
"20230731","1783","9833","9800",元大-敦化,2,23,21,-1,1.24
"20230731","1783","5853","5850",統一-中壢,14,0,14,1,0.83
"20230731","1783","1480","1480",美商高盛,3,23,20,-1,1.18
"20230731","1783","5381","5380",第一金-員林,12,0,12,1,0.71
"20230731","1783","9614","9600",富邦-基隆,0,20,20,-1,1.18
"20230731","1783","8846","8840",玉山-板橋,12,0,12,1,0.71
"20230731","1783","9692","9600",富邦-嘉義,1,21,20,-1,1.18
"20230731","1783","9137","9100",群益金鼎-士林,13,1,12,1,0.71
"20230731","1783","1650","1650",新加坡商瑞銀,49,68,19,-1,1.12
"20230731","1783","9255","9200",凱基-和平,14,2,12,1,0.71
"20230731","1783","0037003700390044","7790",國票-台南,0,16,16,-1,0.94
"20230731","1783","9658","9600",富邦-建國,12,0,12,1,0.71
"20230731","1783","003900310033004e","9100",群益金鼎-土城,0,14,14,-1,0.83
"20230801","1783","0039004100390043","9A00",永豐金-員林,150,10,140,1,6.45
"20230801","1783","5854","5850",統一-城中,0,35,35,-1,1.61
"20230801","1783","8440","8440",摩根大通,104,4,100,1,4.61
"20230801","1783","0039003800310051","9800",元大-太平,2,35,33,-1,1.52
"20230801","1783","1480","1480",美商高盛,92,7,85,1,3.92
"20230801","1783","0039003800320041","9800",元大-羅東,2,34,32,-1,1.48
"20230801","1783","9268","9200",凱基-台北,255,190,65,1,3.00
"20230801","1783","0031003000340041","1040",臺銀-臺中,5,29,24,-1,1.11
"20230801","1783","6012","6010",(牛牛牛)亞-網路,30,0,30,1,1.38
"20230801","1783","003900380033006a","9800",元大-仁愛,2,23,21,-1,0.97
"20230801","1783","6162","6160",中國信託-忠孝,30,1,29,1,1.34
"20230801","1783","0031003000340043","1040",臺銀-高雄,18,38,20,-1,0.92
"20230801","1783","0039003200300046","9200",凱基-站前,32,9,23,1,1.06
"20230801","1783","8560","8560",新光,15,35,20,-1,0.92
"20230801","1783","0039004100390041","9A00",永豐金-羅東,25,2,23,1,1.06
"20230801","1783","9349","9300",華南永昌-板橋,0,20,20,-1,0.92
"20230801","1783","9658","9600",富邦-建國,30,8,22,1,1.01
"20230801","1783","0039003600320050","9600",富邦-頭份,1,21,20,-1,0.92
"20230801","1783","9236","9200",凱基-虎尾,21,0,21,1,0.97
"20230801","1783","0039003800390044","9800",元大-左營,0,20,20,-1,0.92
"20230801","1783","8150","8150",台新證券,36,19,17,1,0.78
"20230801","1783","1260","1260",宏遠證券,0,18,18,-1,0.83
"20230801","1783","0039003800390055","9800",元大-大甲,16,0,16,1,0.74
"20230801","1783","0039003600320045","9600",富邦-樹林,1,18,17,-1,0.78
"20230801","1783","003700370039006a","7790",國票-和平,15,0,15,1,0.69
"20230801","1783","6380","6380",光和,0,15,15,-1,0.69
"20230801","1783","003800340035004a","8450",康和-高雄,12,0,12,1,0.55
"20230801","1783","8151","8150",台新-建北,10,25,15,-1,0.69
"20230802","1783","0031003000340041","1040",臺銀-臺中,52,0,52,1,3.95
"20230802","1783","8440","8440",摩根大通,12,84,72,-1,5.47
"20230802","1783","0039003800390041","9800",元大-北投,30,0,30,1,2.28
"20230802","1783","003900380033006a","9800",元大-仁愛,0,53,53,-1,4.03
"20230802","1783","9871","9800",元大-忠孝,28,0,28,1,2.13
"20230802","1783","1470","1470",台灣摩根士丹利,0,52,52,-1,3.95
"20230802","1783","0039004100390043","9A00",永豐金-員林,24,1,23,1,1.75
"20230802","1783","1480","1480",美商高盛,21,51,30,-1,2.28
"20230802","1783","9278","9200",凱基-永康,20,1,19,1,1.44
"20230802","1783","0039004100300030","9A00",永豐金證券,0,22,22,-1,1.67
"20230802","1783","0039003200300057","9200",凱基-大里,16,0,16,1,1.22
"20230802","1783","9236","9200",凱基-虎尾,0,20,20,-1,1.52
"20230802","1783","8560","8560",新光,20,7,13,1,0.99
"20230802","1783","0039003800310072","9800",元大-屏南,2,19,17,-1,1.29
"20230802","1783","0031003000330041","1030",土銀-建國,12,0,12,1,0.91
"20230802","1783","9869","9800",元大-新盛,4,21,17,-1,1.29
"20230802","1783","8151","8150",台新-建北,12,0,12,1,0.91
"20230802","1783","9268","9200",凱基-台北,137,153,16,-1,1.22
"20230802","1783","9852","9800",元大-永春,11,0,11,1,0.84
"20230802","1783","6380","6380",光和,0,15,15,-1,1.14
"20230802","1783","0039004100380039","9A00",永豐金-敦北,11,0,11,1,0.84
"20230802","1783","9329","9300",華南永昌-朴子,0,13,13,-1,0.99
"20230802","1783","7006","7000",兆豐-台南,10,0,10,1,0.76
"20230802","1783","5860","5860",盈溢,0,10,10,-1,0.76
"20230802","1783","9363","9300",華南永昌-彰化,10,0,10,1,0.76
"20230802","1783","0035003900320047","5920",元富-新竹,2,12,10,-1,0.76
"20230802","1783","0039003800390050","9800",元大-敦南,10,1,9,1,0.68
"20230802","1783","6012","6010",(牛牛牛)亞-網路,0,10,10,-1,0.76
"20230804","1783","9892","9800",元大-屏東,20,0,20,1,3.54
"20230804","1783","0037003000300067","7000",兆豐-南門,0,50,50,-1,8.85
"20230804","1783","9874","9800",元大-雙和,15,0,15,1,2.65
"20230804","1783","8847","8840",玉山-台南,0,12,12,-1,2.12
"20230804","1783","0039004100360039","9A00",永豐金-屏東,15,0,15,1,2.65
"20230804","1783","1480","1480",美商高盛,1,10,9,-1,1.59
"20230804","1783","9268","9200",凱基-台北,71,57,14,1,2.48
"20230804","1783","8455","8450",康和-台中,0,8,8,-1,1.42
"20230804","1783","9278","9200",凱基-永康,14,0,14,1,2.48
"20230804","1783","9800","9800",元大證券,13,21,8,-1,1.42
"20230804","1783","7006","7000",兆豐-台南,10,0,10,1,1.77
"20230804","1783","9833","9800",元大-敦化,0,7,7,-1,1.24
"20230804","1783","7032","7030",致和-佳里,10,0,10,1,1.77
"20230804","1783","003900380031004e","9800",元大-金門,0,6,6,-1,1.06
"20230804","1783","8382","8380",安泰-楠梓,10,0,10,1,1.77
"20230804","1783","6160","6160",中國信託,1,6,5,-1,0.88
"20230804","1783","8848","8840",玉山-嘉義,10,0,10,1,1.77
"20230804","1783","0038003100350059","8150",台新-新營,0,5,5,-1,0.88
"20230804","1783","9856","9800",元大-花蓮,8,0,8,1,1.42
"20230804","1783","9604","9600",富邦-陽明,1,6,5,-1,0.88
"20230804","1783","9898","9800",元大-新莊,7,0,7,1,1.24
"20230804","1783","6162","6160",中國信託-忠孝,0,5,5,-1,0.88
"20230804","1783","9215","9200",凱基-高美館,6,0,6,1,1.06
"20230804","1783","5854","5850",統一-城中,0,5,5,-1,0.88
"20230804","1783","1560","1560",港商野村,6,0,6,1,1.06
"20230804","1783","0031003000320045","1020",合庫-桃園,0,4,4,-1,0.71
"20230804","1783","6380","6380",光和,6,0,6,1,1.06
"20230804","1783","8440","8440",摩根大通,8,12,4,-1,0.71
"20230807","1783","1650","1650",新加坡商瑞銀,36,8,28,1,4.79
"20230807","1783","9676","9600",富邦-仁愛,0,30,30,-1,5.14
"20230807","1783","1480","1480",美商高盛,19,0,19,1,3.25
"20230807","1783","8150","8150",台新證券,15,44,29,-1,4.97
"20230807","1783","9278","9200",凱基-永康,18,0,18,1,3.08
"20230807","1783","9200","9200",凱基,0,19,19,-1,3.25
"20230807","1783","9834","9800",元大-中壢,10,0,10,1,1.71
"20230807","1783","0039003800320041","9800",元大-羅東,2,21,19,-1,3.25
"20230807","1783","0039003800330066","9800",元大-竹東,10,0,10,1,1.71
"20230807","1783","6165","6160",中國信託-新竹,0,11,11,-1,1.88
"20230807","1783","9869","9800",元大-新盛,10,0,10,1,1.71
"20230807","1783","9800","9800",元大證券,6,17,11,-1,1.88
"20230807","1783","8880","8880",國泰證券,8,0,8,1,1.37
"20230807","1783","1440","1440",美林,3,13,10,-1,1.71
"20230807","1783","0037003700390050","7790",國票-九鼎,7,0,7,1,1.20
"20230807","1783","0039004100390051","9A00",永豐金-豐原,0,10,10,-1,1.71
"20230807","1783","9205","9200",凱基-三重,7,0,7,1,1.20
"20230807","1783","0039003600320047","9600",富邦-斗六,1,10,9,-1,1.54
"20230807","1783","003900380039004c","9800",元大-成功,7,0,7,1,1.20
"20230807","1783","0039004100390044","9A00",永豐金-忠孝,0,9,9,-1,1.54
"20230807","1783","003900380034004b","9800",元大-館前,7,1,6,1,1.03
"20230807","1783","1029","1020",合庫-鳳山,0,8,8,-1,1.37
"20230807","1783","9871","9800",元大-忠孝,6,0,6,1,1.03
"20230807","1783","0039003800310058","9800",元大-新生,0,8,8,-1,1.37
"20230807","1783","0039004100360039","9A00",永豐金-屏東,6,0,6,1,1.03
"20230807","1783","0035003900320075","5920",元富-世貿,0,7,7,-1,1.20
"20230807","1783","5320","5320",高橋,6,1,5,1,0.86
"20230807","1783","0039004100390047","9A00",永豐金-天母,0,7,7,-1,1.20
"20230808","1783","5385","5380",第一金-桃園,20,0,20,1,3.79
"20230808","1783","1650","1650",新加坡商瑞銀,3,61,58,-1,10.98
"20230808","1783","9278","9200",凱基-永康,21,1,20,1,3.79
"20230808","1783","0039004100390047","9A00",永豐金-天母,2,45,43,-1,8.14
"20230808","1783","0031003000340041","1040",臺銀-臺中,16,0,16,1,3.03
"20230808","1783","8150","8150",台新證券,3,45,42,-1,7.95
"20230808","1783","1560","1560",港商野村,14,0,14,1,2.65
"20230808","1783","9268","9200",凱基-台北,6,45,39,-1,7.39
"20230808","1783","9874","9800",元大-雙和,13,0,13,1,2.46
"20230808","1783","0039004100380046","9A00",永豐金-敦南,0,30,30,-1,5.68
"20230808","1783","8151","8150",台新-建北,10,0,10,1,1.89
"20230808","1783","6162","6160",中國信託-忠孝,0,24,24,-1,4.55
"20230808","1783","0039003100380043","9100",群益金鼎-古亭,9,0,9,1,1.70
"20230808","1783","1480","1480",美商高盛,0,22,22,-1,4.17
"20230808","1783","8843","8840",玉山-高雄,7,0,7,1,1.33
"20230808","1783","0031003000340043","1040",臺銀-高雄,0,17,17,-1,3.22
"20230808","1783","9663","9600",富邦-敦南,7,0,7,1,1.33
"20230808","1783","8440","8440",摩根大通,2,13,11,-1,2.08
"20230808","1783","7034","7030",致和-金華,6,0,6,1,1.14
"20230808","1783","8884","8880",國泰-台南,0,11,11,-1,2.08
"20230808","1783","9131","9100",群益金鼎-民權,6,0,6,1,1.14
"20230808","1783","0039003600320050","9600",富邦-頭份,0,10,10,-1,1.89
"20230808","1783","5320","5320",高橋,6,0,6,1,1.14
"20230808","1783","6160","6160",中國信託,0,6,6,-1,1.14
"20230808","1783","1038","1030",土銀-和平,5,0,5,1,0.95
"20230808","1783","9319","9300",華南永昌-鶯歌,0,5,5,-1,0.95
"20230808","1783","0035003900320063","5920",元富-烏日,5,0,5,1,0.95
"20230808","1783","8882","8880",國泰-台中,1,6,5,-1,0.95
"20230809","1783","8563","8560",新光-新竹,20,1,19,1,3.64
"20230809","1783","9853","9800",元大-南屯,0,30,30,-1,5.75
"20230809","1783","003900380034004b","9800",元大-館前,15,0,15,1,2.87
"20230809","1783","9869","9800",元大-新盛,0,22,22,-1,4.21
"20230809","1783","1440","1440",美林,15,1,14,1,2.68
"20230809","1783","9272","9200",凱基-竹科,0,12,12,-1,2.30
"20230809","1783","0039004100390043","9A00",永豐金-員林,12,0,12,1,2.30
"20230809","1783","0039003800300077","9800",元大-西屯,0,12,12,-1,2.30
"20230809","1783","9268","9200",凱基-台北,34,23,11,1,2.11
"20230809","1783","9800","9800",元大證券,5,14,9,-1,1.72
"20230809","1783","0035003300380044","5380",第一金-忠孝,10,0,10,1,1.92
"20230809","1783","1480","1480",美商高盛,0,9,9,-1,1.72
"20230809","1783","0035003900320057","5920",元富-吉利,10,0,10,1,1.92
"20230809","1783","1470","1470",台灣摩根士丹利,0,8,8,-1,1.53
"20230809","1783","9856","9800",元大-花蓮,10,0,10,1,1.92
"20230809","1783","8888","8880",國泰-敦南,4,10,6,-1,1.15
"20230809","1783","8841","8840",玉山-雙和,6,0,6,1,1.15
"20230809","1783","1022","1020",合庫-台南,0,5,5,-1,0.96
"20230809","1783","9278","9200",凱基-永康,6,0,6,1,1.15
"20230809","1783","1260","1260",宏遠證券,0,5,5,-1,0.96
"20230809","1783","1560","1560",港商野村,8,4,4,1,0.77
"20230809","1783","003900360031004c","9600",富邦-士林,0,5,5,-1,0.96
"20230809","1783","0031003000320043","1020",合庫-自強,4,0,4,1,0.77
"20230809","1783","0039003800390051","9800",元大-汐止,1,6,5,-1,0.96
"20230809","1783","7030","7030",致和證券,4,0,4,1,0.77
"20230809","1783","0039004100390062","9A00",永豐金-虎尾,0,5,5,-1,0.96
"20230809","1783","0039003100330044","9100",群益金鼎-潭子,4,0,4,1,0.77
"20230809","1783","8561","8560",新光-台中,0,5,5,-1,0.96
"20230810","1783","5320","5320",高橋,11,0,11,1,1.50
"20230810","1783","1480","1480",美商高盛,2,32,30,-1,4.10
"20230810","1783","9677","9600",富邦-三重,10,1,9,1,1.23
"20230810","1783","8440","8440",摩根大通,0,30,30,-1,4.10
"20230810","1783","0039003800310072","9800",元大-屏南,8,0,8,1,1.09
"20230810","1783","1650","1650",新加坡商瑞銀,18,38,20,-1,2.74
"20230810","1783","0039004100390068","9A00",永豐金-台南,10,2,8,1,1.09
"20230810","1783","1440","1440",美林,5,20,15,-1,2.05
"20230810","1783","8563","8560",新光-新竹,8,1,7,1,0.96
"20230810","1783","9800","9800",元大證券,9,19,10,-1,1.37
"20230810","1783","0039003800310049","9800",元大-天母,7,0,7,1,0.96
"20230810","1783","6165","6160",中國信託-新竹,0,7,7,-1,0.96
"20230810","1783","8888","8880",國泰-敦南,11,4,7,1,0.96
"20230810","1783","8881","8880",國泰-高雄,0,7,7,-1,0.96
"20230810","1783","9208","9200",凱基-桃園,6,0,6,1,0.82
"20230810","1783","003800380038004b","8880",國泰-板橋,0,6,6,-1,0.82
"20230810","1783","003900380039004c","9800",元大-成功,6,0,6,1,0.82
"20230810","1783","1560","1560",港商野村,0,5,5,-1,0.68
"20230810","1783","0039004100380039","9A00",永豐金-敦北,6,0,6,1,0.82
"20230810","1783","0037003000300077","7000",兆豐-新莊,0,5,5,-1,0.68
"20230810","1783","9871","9800",元大-忠孝,5,0,5,1,0.68
"20230810","1783","9205","9200",凱基-三重,0,5,5,-1,0.68
"20230810","1783","1028","1020",合庫-彰化,5,0,5,1,0.68
"20230810","1783","003900320030004e","9200",凱基-湖口,0,5,5,-1,0.68
"20230810","1783","5857","5850",統一-新竹,5,0,5,1,0.68
"20230810","1783","9676","9600",富邦-仁愛,0,5,5,-1,0.68
"20230810","1783","8151","8150",台新-建北,5,0,5,1,0.68
"20230810","1783","9837","9800",元大-北港,0,5,5,-1,0.68
"20230811","1783","0039004100300030","9A00",永豐金證券,23,1,22,1,3.45
"20230811","1783","8150","8150",台新證券,5,43,38,-1,5.97
"20230811","1783","0037003000300072","7000",兆豐-寶成,20,1,19,1,2.98
"20230811","1783","0039004100390041","9A00",永豐金-羅東,10,32,22,-1,3.45
"20230811","1783","0039004100390042","9A00",永豐金-中和,15,0,15,1,2.35
"20230811","1783","9853","9800",元大-南屯,1,20,19,-1,2.98
"20230811","1783","0039003600330041","9600",富邦-八德,12,0,12,1,1.88
"20230811","1783","1650","1650",新加坡商瑞銀,19,35,16,-1,2.51
"20230811","1783","8560","8560",新光,14,2,12,1,1.88
"20230811","1783","9869","9800",元大-新盛,0,15,15,-1,2.35
"20230811","1783","5261","5260",美好-蘆洲,15,4,11,1,1.73
"20230811","1783","0039003800390055","9800",元大-大甲,0,14,14,-1,2.20
"20230811","1783","9315","9300",華南永昌-大甲,11,0,11,1,1.73
"20230811","1783","1440","1440",美林,0,12,12,-1,1.88
"20230811","1783","9814","9800",元大-大益,10,0,10,1,1.57
"20230811","1783","8440","8440",摩根大通,0,11,11,-1,1.73
"20230811","1783","0039003800310045","9800",元大-發財,10,0,10,1,1.57
"20230811","1783","1560","1560",港商野村,0,10,10,-1,1.57
"20230811","1783","6450","6450",永全證券,9,0,9,1,1.41
"20230811","1783","0037003000300077","7000",兆豐-新莊,0,10,10,-1,1.57
"20230811","1783","8563","8560",新光-新竹,9,0,9,1,1.41
"20230811","1783","9616","9600",富邦-岡山,0,10,10,-1,1.57
"20230811","1783","9834","9800",元大-中壢,9,0,9,1,1.41
"20230811","1783","1480","1480",美商高盛,0,9,9,-1,1.41
"20230811","1783","9874","9800",元大-雙和,8,0,8,1,1.26
"20230811","1783","6160","6160",中國信託,0,9,9,-1,1.41
"20230811","1783","0031003000340041","1040",臺銀-臺中,7,0,7,1,1.10
"20230811","1783","9324","9300",華南永昌-岡山,0,9,9,-1,1.41
"20230814","1783","0035003800350063","5850",統一-仁愛,65,0,65,1,6.29
"20230814","1783","1440","1440",美林,3,43,40,-1,3.87
"20230814","1783","8560","8560",新光,44,1,43,1,4.16
"20230814","1783","003500390032006e","5920",元富-西松,0,36,36,-1,3.48
"20230814","1783","9206","9200",凱基-高雄,26,0,26,1,2.51
"20230814","1783","1233","1230",彰銀-台中,0,30,30,-1,2.90
"20230814","1783","0031003000340041","1040",臺銀-臺中,30,8,22,1,2.13
"20230814","1783","003700370039007a","7790",國票-博愛,0,24,24,-1,2.32
"20230814","1783","8846","8840",玉山-板橋,18,0,18,1,1.74
"20230814","1783","9215","9200",凱基-高美館,2,26,24,-1,2.32
"20230814","1783","0035003300380044","5380",第一金-忠孝,20,4,16,1,1.55
"20230814","1783","0039003800310049","9800",元大-天母,0,22,22,-1,2.13
"20230814","1783","0038003100350041","8150",台新-高雄,13,0,13,1,1.26
"20230814","1783","8440","8440",摩根大通,0,21,21,-1,2.03
"20230814","1783","1650","1650",新加坡商瑞銀,20,9,11,1,1.06
"20230814","1783","0031003200360044","1260",宏遠-台南,0,20,20,-1,1.93
"20230814","1783","0039003800380043","9800",元大-三重,10,0,10,1,0.97
"20230814","1783","6012","6010",(牛牛牛)亞-網路,0,20,20,-1,1.93
"20230814","1783","0037003000300072","7000",兆豐-寶成,10,0,10,1,0.97
"20230814","1783","0039003200300046","9200",凱基-站前,5,20,15,-1,1.45
"20230814","1783","9898","9800",元大-新莊,10,0,10,1,0.97
"20230814","1783","003800340035004a","8450",康和-高雄,0,12,12,-1,1.16
"20230814","1783","9658","9600",富邦-建國,9,0,9,1,0.87
"20230814","1783","0039003800390055","9800",元大-大甲,0,12,12,-1,1.16
"20230814","1783","9813","9800",元大-八德,14,5,9,1,0.87
"20230814","1783","0039004100390041","9A00",永豐金-羅東,1,13,12,-1,1.16
"20230814","1783","8885","8880",國泰-桃園,10,1,9,1,0.87
"20230814","1783","0039003600360046","9600",富邦-左營,1,12,11,-1,1.06
"20230815","1783","1560","1560",港商野村,21,0,21,1,6.18
"20230815","1783","0039004100390072","9A00",永豐金-北高雄,0,30,30,-1,8.82
"20230815","1783","1470","1470",台灣摩根士丹利,17,0,17,1,5.00
"20230815","1783","0031003000340041","1040",臺銀-臺中,0,23,23,-1,6.76
"20230815","1783","8440","8440",摩根大通,19,2,17,1,5.00
"20230815","1783","9229","9200",凱基-中山,15,29,14,-1,4.12
"20230815","1783","0037003000300077","7000",兆豐-新莊,10,0,10,1,2.94
"20230815","1783","5854","5850",統一-城中,0,10,10,-1,2.94
"20230815","1783","9898","9800",元大-新莊,7,0,7,1,2.06
"20230815","1783","0031003200360044","1260",宏遠-台南,0,10,10,-1,2.94
"20230815","1783","8150","8150",台新證券,6,1,5,1,1.47
"20230815","1783","9800","9800",元大證券,1,10,9,-1,2.65
"20230815","1783","003800380034004d","8840",玉山-數位,5,0,5,1,1.47
"20230815","1783","9604","9600",富邦-陽明,1,10,9,-1,2.65
"20230815","1783","9268","9200",凱基-台北,41,36,5,1,1.47
"20230815","1783","8848","8840",玉山-嘉義,0,8,8,-1,2.35
"20230815","1783","003900380031005a","9800",元大-潮州,5,0,5,1,1.47
"20230815","1783","9236","9200",凱基-虎尾,0,5,5,-1,1.47
"20230815","1783","0039004100390078","9A00",永豐金-桃園,5,0,5,1,1.47
"20230815","1783","9238","9200",凱基-士林,0,5,5,-1,1.47
"20230815","1783","0039003800380056","9800",元大-長庚,8,4,4,1,1.18
"20230815","1783","8151","8150",台新-建北,0,3,3,-1,0.88
"20230815","1783","0037003700390044","7790",國票-台南,3,0,3,1,0.88
"20230815","1783","9319","9300",華南永昌-鶯歌,2,5,3,-1,0.88
"20230815","1783","9852","9800",元大-永春,3,0,3,1,0.88
"20230815","1783","0039004100390038","9A00",永豐金-大園,0,3,3,-1,0.88
"20230815","1783","9859","9800",元大-新竹經國,3,0,3,1,0.88
"20230815","1783","5603","5600",永興-台中,0,2,2,-1,0.59
"20230816","1783","1650","1650",新加坡商瑞銀,19,7,12,1,3.74
"20230816","1783","0039003600320047","9600",富邦-斗六,0,20,20,-1,6.23
"20230816","1783","7005","7000",兆豐-台中港,10,0,10,1,3.12
"20230816","1783","003900380030004b","9800",元大-竹科,0,18,18,-1,5.61
"20230816","1783","1029","1020",合庫-鳳山,6,0,6,1,1.87
"20230816","1783","0039004100390062","9A00",永豐金-虎尾,0,17,17,-1,5.30
"20230816","1783","0035003900320051","5920",元富-敦南,5,0,5,1,1.56
"20230816","1783","8440","8440",摩根大通,3,15,12,-1,3.74
"20230816","1783","0037003000300063","7000",兆豐-民生,5,0,5,1,1.56
"20230816","1783","9800","9800",元大證券,2,11,9,-1,2.80
"20230816","1783","0038003100350041","8150",台新-高雄,6,1,5,1,1.56
"20230816","1783","0039003600310050","9600",富邦-和美,0,7,7,-1,2.18
"20230816","1783","9229","9200",凱基-中山,25,20,5,1,1.56
"20230816","1783","0039003800390044","9800",元大-左營,0,7,7,-1,2.18
"20230816","1783","0039003800310045","9800",元大-發財,5,0,5,1,1.56
"20230816","1783","003900410039006a","9A00",永豐金-嘉義,0,6,6,-1,1.87
"20230816","1783","9869","9800",元大-新盛,5,0,5,1,1.56
"20230816","1783","9659","9600",富邦-高雄,0,4,4,-1,1.25
"20230816","1783","9899","9800",元大-淡水,5,0,5,1,1.56
"20230816","1783","9692","9600",富邦-嘉義,0,4,4,-1,1.25
"20230816","1783","0039004100390078","9A00",永豐金-桃園,5,0,5,1,1.56
"20230816","1783","003900380030006c","9800",元大-虎尾,1,5,4,-1,1.25
"20230816","1783","1036","1030",土銀-玉里,3,0,3,1,0.93
"20230816","1783","9884","9800",元大-斗信,0,4,4,-1,1.25
"20230816","1783","8881","8880",國泰-高雄,3,0,3,1,0.93
"20230816","1783","0031003000340041","1040",臺銀-臺中,0,3,3,-1,0.93
"20230816","1783","9315","9300",華南永昌-大甲,9,6,3,1,0.93
"20230816","1783","9859","9800",元大-新竹經國,0,3,3,-1,0.93
"20230817","1783","1650","1650",新加坡商瑞銀,21,4,17,1,5.26
"20230817","1783","9229","9200",凱基-中山,0,15,15,-1,4.64
"20230817","1783","8440","8440",摩根大通,21,8,13,1,4.02
"20230817","1783","0039004100300030","9A00",永豐金證券,2,15,13,-1,4.02
"20230817","1783","0039003800380056","9800",元大-長庚,11,0,11,1,3.41
"20230817","1783","6167","6160",中國信託-松江,0,11,11,-1,3.41
"20230817","1783","9268","9200",凱基-台北,32,23,9,1,2.79
"20230817","1783","6012","6010",(牛牛牛)亞-網路,0,10,10,-1,3.10
"20230817","1783","0039003800390049","9800",元大-蘆洲,7,0,7,1,2.17
"20230817","1783","1024","1020",合庫-嘉義,0,10,10,-1,3.10
"20230817","1783","0039003600330041","9600",富邦-八德,5,0,5,1,1.55
"20230817","1783","5854","5850",統一-城中,0,10,10,-1,3.10
"20230817","1783","9869","9800",元大-新盛,5,0,5,1,1.55
"20230817","1783","003500380035004a","5850",統一-三重,0,10,10,-1,3.10
"20230817","1783","9871","9800",元大-忠孝,5,0,5,1,1.55
"20230817","1783","9322","9300",華南永昌-公誠,0,10,10,-1,3.10
"20230817","1783","9872","9800",元大-復北,5,0,5,1,1.55
"20230817","1783","9800","9800",元大證券,4,14,10,-1,3.10
"20230817","1783","0036003000310064","6010",(牛牛牛)亞-鑫豐,4,0,4,1,1.24
"20230817","1783","9677","9600",富邦-三重,1,10,9,-1,2.79
"20230817","1783","8586","8580",聯邦-大業,4,0,4,1,1.24
"20230817","1783","8880","8880",國泰證券,0,8,8,-1,2.48
"20230817","1783","9255","9200",凱基-和平,6,2,4,1,1.24
"20230817","1783","9238","9200",凱基-士林,0,5,5,-1,1.55
"20230817","1783","0039003600310046","9600",富邦-中港,4,0,4,1,1.24
"20230817","1783","0039003600320047","9600",富邦-斗六,0,5,5,-1,1.55
"20230817","1783","1480","1480",美商高盛,5,2,3,1,0.93
"20230817","1783","8562","8560",新光-高雄,0,4,4,-1,1.24
"20230818","1783","8586","8580",聯邦-大業,16,0,16,1,5.18
"20230818","1783","9229","9200",凱基-中山,1,32,31,-1,10.03
"20230818","1783","1560","1560",港商野村,13,0,13,1,4.21
"20230818","1783","1650","1650",新加坡商瑞銀,4,29,25,-1,8.09
"20230818","1783","8846","8840",玉山-板橋,7,0,7,1,2.27
"20230818","1783","8440","8440",摩根大通,4,17,13,-1,4.21
"20230818","1783","8888","8880",國泰-敦南,6,0,6,1,1.94
"20230818","1783","1440","1440",美林,2,14,12,-1,3.88
"20230818","1783","6380","6380",光和,6,0,6,1,1.94
"20230818","1783","0031003200360044","1260",宏遠-台南,0,9,9,-1,2.91
"20230818","1783","9896","9800",元大-台南,6,0,6,1,1.94
"20230818","1783","8881","8880",國泰-高雄,0,8,8,-1,2.59
"20230818","1783","0039003800390061","9800",元大-苑裡,5,0,5,1,1.62
"20230818","1783","0039003800390049","9800",元大-蘆洲,1,8,7,-1,2.27
"20230818","1783","0038003100350042","8150",台新-台中,4,0,4,1,1.29
"20230818","1783","0035003300380045","5380",第一金-自由,0,5,5,-1,1.62
"20230818","1783","8492","8490",京城-嘉義,4,0,4,1,1.29
"20230818","1783","5854","5850",統一-城中,0,5,5,-1,1.62
"20230818","1783","0039003100380043","9100",群益金鼎-古亭,4,0,4,1,1.29
"20230818","1783","0035003800350053","5850",統一-宜蘭,0,5,5,-1,1.62
"20230818","1783","9347","9300",華南永昌-敦南,4,0,4,1,1.29
"20230818","1783","1470","1470",台灣摩根士丹利,0,4,4,-1,1.29
"20230818","1783","9692","9600",富邦-嘉義,5,1,4,1,1.29
"20230818","1783","0031003000340041","1040",臺銀-臺中,0,4,4,-1,1.29
"20230818","1783","9655","9600",富邦-板橋,3,0,3,1,0.97
"20230818","1783","003700300030006a","7000",兆豐-大安,0,4,4,-1,1.29
"20230818","1783","9217","9200",凱基-松山,3,0,3,1,0.97
"20230818","1783","9800","9800",元大證券,4,7,3,-1,0.97
"20230821","1783","8150","8150",台新證券,17,0,17,1,6.54
"20230821","1783","9229","9200",凱基-中山,0,33,33,-1,12.69
"20230821","1783","1560","1560",港商野村,14,0,14,1,5.38
"20230821","1783","0031003200360044","1260",宏遠-台南,0,13,13,-1,5.00
"20230821","1783","7007","7000",兆豐-竹北,10,0,10,1,3.85
"20230821","1783","0039003800380056","9800",元大-長庚,0,11,11,-1,4.23
"20230821","1783","0035003300380044","5380",第一金-忠孝,8,0,8,1,3.08
"20230821","1783","9285","9200",凱基-中壢,0,10,10,-1,3.85
"20230821","1783","1480","1480",美商高盛,7,1,6,1,2.31
"20230821","1783","0039004100390066","9A00",永豐金-中盛,0,10,10,-1,3.85
"20230821","1783","0037003000300052","7000",兆豐-小港,6,0,6,1,2.31
"20230821","1783","0039003800390044","9800",元大-左營,0,6,6,-1,2.31
"20230821","1783","9226","9200",凱基-汐止,6,0,6,1,2.31
"20230821","1783","5854","5850",統一-城中,0,5,5,-1,1.92
"20230821","1783","9676","9600",富邦-仁愛,5,0,5,1,1.92
"20230821","1783","8888","8880",國泰-敦南,0,4,4,-1,1.54
"20230821","1783","003900380031006a","9800",元大-士林,5,0,5,1,1.92
"20230821","1783","1038","1030",土銀-和平,0,3,3,-1,1.15
"20230821","1783","0039003800390049","9800",元大-蘆洲,5,0,5,1,1.92
"20230821","1783","8561","8560",新光-台中,0,3,3,-1,1.15
"20230821","1783","6167","6160",中國信託-松江,4,0,4,1,1.54
"20230821","1783","9224","9200",凱基-新莊,0,3,3,-1,1.15
"20230821","1783","0039003100330044","9100",群益金鼎-潭子,4,0,4,1,1.54
"20230821","1783","9137","9100",群益金鼎-士林,0,2,2,-1,0.77
"20230821","1783","0038003100350042","8150",台新-台中,3,0,3,1,1.15
"20230821","1783","9834","9800",元大-中壢,0,2,2,-1,0.77
"20230821","1783","9234","9200",凱基-竹北,3,0,3,1,1.15
"20230821","1783","003900380034004b","9800",元大-館前,0,2,2,-1,0.77
"20230822","1783","5961","5960",日茂-埔里,28,0,28,1,4.06
"20230822","1783","9268","9200",凱基-台北,13,111,98,-1,14.22
"20230822","1783","8560","8560",新光,18,3,15,1,2.18
"20230822","1783","9815","9800",元大-大灣,0,19,19,-1,2.76
"20230822","1783","9663","9600",富邦-敦南,12,0,12,1,1.74
"20230822","1783","9869","9800",元大-新盛,2,20,18,-1,2.61
"20230822","1783","8563","8560",新光-新竹,10,0,10,1,1.45
"20230822","1783","8440","8440",摩根大通,0,17,17,-1,2.47
"20230822","1783","0039004100360039","9A00",永豐金-屏東,10,0,10,1,1.45
"20230822","1783","9308","9300",華南永昌-麻豆,0,17,17,-1,2.47
"20230822","1783","0039004100390042","9A00",永豐金-中和,10,0,10,1,1.45
"20230822","1783","7034","7030",致和-金華,0,14,14,-1,2.03
"20230822","1783","0039004100390066","9A00",永豐金-中盛,10,0,10,1,1.45
"20230822","1783","9659","9600",富邦-高雄,2,15,13,-1,1.89
"20230822","1783","8150","8150",台新證券,11,1,10,1,1.45
"20230822","1783","1028","1020",合庫-彰化,2,14,12,-1,1.74
"20230822","1783","1440","1440",美林,12,3,9,1,1.31
"20230822","1783","9871","9800",元大-忠孝,0,11,11,-1,1.60
"20230822","1783","9852","9800",元大-永春,10,1,9,1,1.31
"20230822","1783","0037003000300077","7000",兆豐-新莊,0,10,10,-1,1.45
"20230822","1783","7007","7000",兆豐-竹北,8,0,8,1,1.16
"20230822","1783","9665","9600",富邦-桃園,0,9,9,-1,1.31
"20230822","1783","0036003300380044","6380",光和-高雄,7,0,7,1,1.02
"20230822","1783","0039003800380056","9800",元大-長庚,0,9,9,-1,1.31
"20230822","1783","9255","9200",凱基-和平,7,0,7,1,1.02
"20230822","1783","003800380038004b","8880",國泰-板橋,0,7,7,-1,1.02
"20230822","1783","9884","9800",元大-斗信,7,0,7,1,1.02
"20230822","1783","6381","6380",光和-溪湖,0,6,6,-1,0.87
"20230823","1783","7007","7000",兆豐-竹北,18,0,18,1,3.83
"20230823","1783","0031003000340041","1040",臺銀-臺中,0,31,31,-1,6.60
"20230823","1783","1480","1480",美商高盛,21,8,13,1,2.77
"20230823","1783","7792","7790",國票-北投,0,30,30,-1,6.38
"20230823","1783","0039003800310044","9800",元大-南投,10,0,10,1,2.13
"20230823","1783","6168","6160",中國信託-嘉義,0,30,30,-1,6.38
"20230823","1783","7006","7000",兆豐-台南,10,0,10,1,2.13
"20230823","1783","0039003800310046","9800",元大-福營,0,16,16,-1,3.40
"20230823","1783","9852","9800",元大-永春,10,0,10,1,2.13
"20230823","1783","8713","8710",陽信-高雄,0,11,11,-1,2.34
"20230823","1783","5267","5260",美好-基隆,9,0,9,1,1.91
"20230823","1783","6012","6010",(牛牛牛)亞-網路,0,10,10,-1,2.13
"20230823","1783","9268","9200",凱基-台北,49,41,8,1,1.70
"20230823","1783","9834","9800",元大-中壢,1,11,10,-1,2.13
"20230823","1783","1650","1650",新加坡商瑞銀,21,15,6,1,1.28
"20230823","1783","0039003200300046","9200",凱基-站前,1,10,9,-1,1.91
"20230823","1783","003900310038004b","9100",群益金鼎-東湖,6,0,6,1,1.28
"20230823","1783","0037003000300063","7000",兆豐-民生,0,8,8,-1,1.70
"20230823","1783","9831","9800",元大-四維,5,0,5,1,1.06
"20230823","1783","9324","9300",華南永昌-岡山,0,8,8,-1,1.70
"20230823","1783","0035003300380044","5380",第一金-忠孝,5,0,5,1,1.06
"20230823","1783","1470","1470",台灣摩根士丹利,0,7,7,-1,1.49
"20230823","1783","5853","5850",統一-中壢,5,0,5,1,1.06
"20230823","1783","9623","9600",富邦-台北,0,6,6,-1,1.28
"20230823","1783","0035003900320055","5920",元富-宜蘭,5,0,5,1,1.06
"20230823","1783","0035003900320057","5920",元富-吉利,0,5,5,-1,1.06
"20230823","1783","6451","6450",永全-南崁,5,0,5,1,1.06
"20230823","1783","0039004100300030","9A00",永豐金證券,3,8,5,-1,1.06
"20230824","1783","7007","7000",兆豐-竹北,40,0,40,1,9.71
"20230824","1783","5854","5850",統一-城中,0,20,20,-1,4.85
"20230824","1783","1650","1650",新加坡商瑞銀,32,7,25,1,6.07
"20230824","1783","9200","9200",凱基,0,20,20,-1,4.85
"20230824","1783","1570","1570",港商法國興業,13,0,13,1,3.16
"20230824","1783","9315","9300",華南永昌-大甲,2,21,19,-1,4.61
"20230824","1783","8440","8440",摩根大通,11,0,11,1,2.67
"20230824","1783","0039003600320047","9600",富邦-斗六,0,12,12,-1,2.91
"20230824","1783","0037003000300069","7000",兆豐-松德,10,0,10,1,2.43
"20230824","1783","0031003000340041","1040",臺銀-臺中,0,10,10,-1,2.43
"20230824","1783","9872","9800",元大-復北,11,4,7,1,1.70
"20230824","1783","0037003000300077","7000",兆豐-新莊,0,10,10,-1,2.43
"20230824","1783","003900360031004d","9600",富邦-木柵,6,0,6,1,1.46
"20230824","1783","8849","8840",玉山-景美,0,10,10,-1,2.43
"20230824","1783","1440","1440",美林,11,6,5,1,1.21
"20230824","1783","1480","1480",美商高盛,2,11,9,-1,2.18
"20230824","1783","6383","6380",光和-和美,5,0,5,1,1.21
"20230824","1783","0036003100310041","6110",台中銀-豐原,0,8,8,-1,1.94
"20230824","1783","6450","6450",永全證券,5,0,5,1,1.21
"20230824","1783","9884","9800",元大-斗信,0,8,8,-1,1.94
"20230824","1783","9205","9200",凱基-三重,5,0,5,1,1.21
"20230824","1783","0035003900320059","5920",元富-埔里,0,7,7,-1,1.70
"20230824","1783","9229","9200",凱基-中山,5,0,5,1,1.21
"20230824","1783","9636","9600",富邦-中壢,0,7,7,-1,1.70
"20230824","1783","0035003900320076","5920",元富-桃園,3,0,3,1,0.73
"20230824","1783","8888","8880",國泰-敦南,0,7,7,-1,1.70
"20230824","1783","003600310036004b","6160",中國信託-高雄,3,0,3,1,0.73
"20230824","1783","003700300030005a","7000",兆豐-高雄,0,6,6,-1,1.46
"20230825","1783","9268","9200",凱基-台北,30,16,14,1,7.87
"20230825","1783","1040","1040",臺銀,0,20,20,-1,11.24
"20230825","1783","7032","7030",致和-佳里,10,0,10,1,5.62
"20230825","1783","003800380034004a","8840",玉山-大里,0,20,20,-1,11.24
"20230825","1783","003900410039004a","9A00",永豐金-板新,10,0,10,1,5.62
"20230825","1783","5854","5850",統一-城中,0,10,10,-1,5.62
"20230825","1783","1022","1020",合庫-台南,5,0,5,1,2.81
"20230825","1783","6162","6160",中國信託-忠孝,0,5,5,-1,2.81
"20230825","1783","0035003300380059","5380",第一金-中壢,5,0,5,1,2.81
"20230825","1783","1650","1650",新加坡商瑞銀,4,8,4,-1,2.25
"20230825","1783","0039003600320044","9600",富邦-新莊,5,0,5,1,2.81
"20230825","1783","6167","6160",中國信託-松江,0,4,4,-1,2.25
"20230825","1783","9834","9800",元大-中壢,5,0,5,1,2.81
"20230825","1783","1045","1040",臺銀-新竹,1,4,3,-1,1.69
"20230825","1783","5261","5260",美好-蘆洲,4,0,4,1,2.25
"20230825","1783","0035003900320062","5920",元富-板橋,0,3,3,-1,1.69
"20230825","1783","9234","9200",凱基-竹北,4,0,4,1,2.25
"20230825","1783","0039003100380050","9100",群益金鼎-天母,0,2,2,-1,1.12
"20230825","1783","0035003300380049","5380",第一金-頭份,3,0,3,1,1.69
"20230825","1783","9315","9300",華南永昌-大甲,0,2,2,-1,1.12
"20230825","1783","0039004100390071","9A00",永豐金-潮州,3,0,3,1,1.69
"20230825","1783","9884","9800",元大-斗信,0,2,2,-1,1.12
"20230825","1783","1480","1480",美商高盛,8,6,2,1,1.12
"20230825","1783","1440","1440",美林,6,7,1,-1,0.56
"20230825","1783","5855","5850",統一-台南,2,0,2,1,1.12
"20230825","1783","0035003800350044","5850",統一-新台中,0,1,1,-1,0.56
"20230825","1783","9636","9600",富邦-中壢,2,0,2,1,1.12
"20230825","1783","0035003800350067","5850",統一-平鎮,0,1,1,-1,0.56
"20230828","1783","7007","7000",兆豐-竹北,20,0,20,1,7.04
"20230828","1783","8150","8150",台新證券,1,35,34,-1,11.97
"20230828","1783","9898","9800",元大-新莊,10,0,10,1,3.52
"20230828","1783","9268","9200",凱基-台北,13,36,23,-1,8.10
"20230828","1783","9872","9800",元大-復北,8,0,8,1,2.82
"20230828","1783","003700370039006a","7790",國票-和平,0,15,15,-1,5.28
"20230828","1783","9659","9600",富邦-高雄,6,0,6,1,2.11
"20230828","1783","0037003000300069","7000",兆豐-松德,0,10,10,-1,3.52
"20230828","1783","0031003200360069","1260",宏遠-光隆,5,0,5,1,1.76
"20230828","1783","0039003200300046","9200",凱基-站前,0,10,10,-1,3.52
"20230828","1783","0031003000340041","1040",臺銀-臺中,5,0,5,1,1.76
"20230828","1783","1650","1650",新加坡商瑞銀,8,15,7,-1,2.46
"20230828","1783","1022","1020",合庫-台南,5,0,5,1,1.76
"20230828","1783","8440","8440",摩根大通,0,7,7,-1,2.46
"20230828","1783","8888","8880",國泰-敦南,6,1,5,1,1.76
"20230828","1783","003700300030004d","7000",兆豐-桃園,0,6,6,-1,2.11
"20230828","1783","1440","1440",美林,19,15,4,1,1.41
"20230828","1783","0031003000330041","1030",土銀-建國,0,5,5,-1,1.76
"20230828","1783","9202","9200",凱基-中港,4,0,4,1,1.41
"20230828","1783","0039003800390058","9800",元大-民生,0,5,5,-1,1.76
"20230828","1783","0039003800380056","9800",元大-長庚,4,0,4,1,1.41
"20230828","1783","003500390032006f","5920",元富-新興,0,4,4,-1,1.41
"20230828","1783","0039004100390045","9A00",永豐金-板橋,4,0,4,1,1.41
"20230828","1783","0037003000300048","7000",兆豐-東門,0,3,3,-1,1.06
"20230828","1783","5857","5850",統一-新竹,3,0,3,1,1.06
"20230828","1783","0035003900320043","5920",元富-潮州,0,2,2,-1,0.70
"20230828","1783","0038003400350045","8450",康和-澎湖,3,0,3,1,1.06
"20230828","1783","0035003900320047","5920",元富-新竹,0,2,2,-1,0.70
"20230829","1783","1480","1480",美商高盛,24,1,23,1,11.98
"20230829","1783","0031003000330041","1030",土銀-建國,0,10,10,-1,5.21
"20230829","1783","1650","1650",新加坡商瑞銀,18,1,17,1,8.85
"20230829","1783","8710","8710",陽信,0,7,7,-1,3.65
"20230829","1783","0039003200320048","9200",凱基-復興,10,0,10,1,5.21
"20230829","1783","003700300030006a","7000",兆豐-大安,0,6,6,-1,3.13
"20230829","1783","0035003300380044","5380",第一金-忠孝,6,0,6,1,3.13
"20230829","1783","5320","5320",高橋,0,5,5,-1,2.60
"20230829","1783","8888","8880",國泰-敦南,5,1,4,1,2.08
"20230829","1783","5854","5850",統一-城中,0,5,5,-1,2.60
"20230829","1783","8560","8560",新光,5,1,4,1,2.08
"20230829","1783","0035003900320055","5920",元富-宜蘭,0,5,5,-1,2.60
"20230829","1783","0039003800300075","9800",元大-府城,3,0,3,1,1.56
"20230829","1783","7006","7000",兆豐-台南,0,5,5,-1,2.60
"20230829","1783","1440","1440",美林,2,0,2,1,1.04
"20230829","1783","9655","9600",富邦-板橋,0,5,5,-1,2.60
"20230829","1783","1041","1040",臺銀-鳳山,2,0,2,1,1.04
"20230829","1783","003900380031006a","9800",元大-士林,0,5,5,-1,2.60
"20230829","1783","9314","9300",華南永昌-嘉義,2,0,2,1,1.04
"20230829","1783","9621","9600",富邦-花蓮,0,4,4,-1,2.08
"20230829","1783","003900380033006a","9800",元大-仁愛,8,6,2,1,1.04
"20230829","1783","0039004100390043","9A00",永豐金-員林,0,4,4,-1,2.08
"20230829","1783","9856","9800",元大-花蓮,2,0,2,1,1.04
"20230829","1783","003600310036004b","6160",中國信託-高雄,0,3,3,-1,1.56
"20230829","1783","9874","9800",元大-雙和,2,0,2,1,1.04
"20230829","1783","003700300030006b","7000",兆豐-員林,0,3,3,-1,1.56
"20230829","1783","0039004100380046","9A00",永豐金-敦南,2,0,2,1,1.04
"20230829","1783","0039004100390045","9A00",永豐金-板橋,0,3,3,-1,1.56
"20230830","1783","1440","1440",美林,34,0,34,1,8.52
"20230830","1783","8150","8150",台新證券,19,46,27,-1,6.77
"20230830","1783","0039003800310051","9800",元大-太平,34,2,32,1,8.02
"20230830","1783","003900410039004a","9A00",永豐金-板新,1,14,13,-1,3.26
"20230830","1783","9856","9800",元大-花蓮,20,0,20,1,5.01
"20230830","1783","0039003800310044","9800",元大-南投,0,10,10,-1,2.51
"20230830","1783","1650","1650",新加坡商瑞銀,20,3,17,1,4.26
"20230830","1783","5854","5850",統一-城中,0,10,10,-1,2.51
"20230830","1783","1480","1480",美商高盛,30,19,11,1,2.76
"20230830","1783","8563","8560",新光-新竹,0,8,8,-1,2.01
"20230830","1783","0039003200320048","9200",凱基-復興,10,0,10,1,2.51
"20230830","1783","0039003600310048","9600",富邦-新板,0,8,8,-1,2.01
"20230830","1783","9857","9800",元大-東蘆,10,0,10,1,2.51
"20230830","1783","003900360032004b","9600",富邦-中和,0,6,6,-1,1.50
"20230830","1783","9868","9800",元大-文心,10,0,10,1,2.51
"20230830","1783","5320","5320",高橋,1,6,5,-1,1.25
"20230830","1783","9898","9800",元大-新莊,10,0,10,1,2.51
"20230830","1783","0035003300380049","5380",第一金-頭份,0,5,5,-1,1.25
"20230830","1783","8458","8450",康和-台南,5,0,5,1,1.25
"20230830","1783","5853","5850",統一-中壢,1,6,5,-1,1.25
"20230830","1783","9833","9800",元大-敦化,5,0,5,1,1.25
"20230830","1783","6451","6450",永全-南崁,0,5,5,-1,1.25
"20230830","1783","8885","8880",國泰-桃園,5,1,4,1,1.00
"20230830","1783","6465","6460",大昌-桃園,0,5,5,-1,1.25
"20230830","1783","0039004100390072","9A00",永豐金-北高雄,5,1,4,1,1.00
"20230830","1783","003700300030005a","7000",兆豐-高雄,0,5,5,-1,1.25
"20230830","1783","003800380038004b","8880",國泰-板橋,4,0,4,1,1.00
"20230830","1783","1470","1470",台灣摩根士丹利,0,4,4,-1,1.00
"20230831","1783","8150","8150",台新證券,16,0,16,1,9.94
"20230831","1783","9268","9200",凱基-台北,18,29,11,-1,6.83
"20230831","1783","0039003200320048","9200",凱基-復興,10,0,10,1,6.21
"20230831","1783","9872","9800",元大-復北,0,10,10,-1,6.21
"20230831","1783","0039003800310051","9800",元大-太平,9,0,9,1,5.59
"20230831","1783","1470","1470",台灣摩根士丹利,0,9,9,-1,5.59
"20230831","1783","003900310038004b","9100",群益金鼎-東湖,7,0,7,1,4.35
"20230831","1783","1650","1650",新加坡商瑞銀,1,10,9,-1,5.59
"20230831","1783","0039003800380056","9800",元大-長庚,6,0,6,1,3.73
"20230831","1783","1480","1480",美商高盛,0,7,7,-1,4.35
"20230831","1783","0038003100350041","8150",台新-高雄,3,0,3,1,1.86
"20230831","1783","9137","9100",群益金鼎-士林,0,6,6,-1,3.73
"20230831","1783","9206","9200",凱基-高雄,3,0,3,1,1.86
"20230831","1783","0039004100390041","9A00",永豐金-羅東,0,6,6,-1,3.73
"20230831","1783","9825","9800",元大-新營,3,0,3,1,1.86
"20230831","1783","9255","9200",凱基-和平,0,4,4,-1,2.48
"20230831","1783","8560","8560",新光,3,0,3,1,1.86
"20230831","1783","1029","1020",合庫-鳳山,2,5,3,-1,1.86
"20230831","1783","9655","9600",富邦-板橋,3,0,3,1,1.86
"20230831","1783","003700370039007a","7790",國票-博愛,0,2,2,-1,1.24
"20230831","1783","0031003000330046","1030",土銀-南港,2,0,2,1,1.24
"20230831","1783","9183","9100",群益金鼎-高雄,0,2,2,-1,1.24
"20230831","1783","0038003800340041","8840",玉山-士林,2,0,2,1,1.24
"20230831","1783","9209","9200",凱基-岡山,0,2,2,-1,1.24
"20230831","1783","9234","9200",凱基-竹北,2,0,2,1,1.24
"20230831","1783","9856","9800",元大-花蓮,0,2,2,-1,1.24
"20230831","1783","9285","9200",凱基-中壢,2,0,2,1,1.24
"20230831","1783","0039003800300043","9800",元大-斗六,0,1,1,-1,0.62
"20230901","1783","0039004100390057","9A00",永豐金-市政,31,0,31,1,9.34
"20230901","1783","5961","5960",日茂-埔里,0,13,13,-1,3.92
"20230901","1783","9268","9200",凱基-台北,38,10,28,1,8.43
"20230901","1783","9202","9200",凱基-中港,0,13,13,-1,3.92
"20230901","1783","1560","1560",港商野村,27,0,27,1,8.13
"20230901","1783","0039003600320047","9600",富邦-斗六,0,10,10,-1,3.01
"20230901","1783","1650","1650",新加坡商瑞銀,28,7,21,1,6.33
"20230901","1783","7005","7000",兆豐-台中港,0,10,10,-1,3.01
"20230901","1783","1480","1480",美商高盛,19,2,17,1,5.12
"20230901","1783","9663","9600",富邦-敦南,0,10,10,-1,3.01
"20230901","1783","7007","7000",兆豐-竹北,15,0,15,1,4.52
"20230901","1783","9868","9800",元大-文心,0,10,10,-1,3.01
"20230901","1783","0031003000340041","1040",臺銀-臺中,6,1,5,1,1.51
"20230901","1783","8846","8840",玉山-板橋,0,10,10,-1,3.01
"20230901","1783","0037003000330042","7030",致和-崇德,5,0,5,1,1.51
"20230901","1783","1029","1020",合庫-鳳山,0,8,8,-1,2.41
"20230901","1783","8440","8440",摩根大通,5,0,5,1,1.51
"20230901","1783","9189","9100",群益金鼎-桃園,0,8,8,-1,2.41
"20230901","1783","9874","9800",元大-雙和,5,0,5,1,1.51
"20230901","1783","0039003800390053","9800",元大-鹿港,0,8,8,-1,2.41
"20230901","1783","0038003800340041","8840",玉山-士林,4,0,4,1,1.20
"20230901","1783","0039004100390036","9A00",永豐金-博愛,0,8,8,-1,2.41
"20230901","1783","0039003800300075","9800",元大-府城,4,0,4,1,1.20
"20230901","1783","1470","1470",台灣摩根士丹利,2,9,7,-1,2.11
"20230901","1783","0035003300380045","5380",第一金-自由,3,0,3,1,0.90
"20230901","1783","0035003900320045","5920",元富-城中,0,7,7,-1,2.11
"20230901","1783","0039004100390059","9A00",永豐金-板盛,3,0,3,1,0.90
"20230901","1783","0039003800390061","9800",元大-苑裡,0,7,7,-1,2.11
"20230904","1783","8150","8150",台新證券,16,1,15,1,7.69
"20230904","1783","9268","9200",凱基-台北,9,34,25,-1,12.82
"20230904","1783","1470","1470",台灣摩根士丹利,18,7,11,1,5.64
"20230904","1783","0039003800390044","9800",元大-左營,0,14,14,-1,7.18
"20230904","1783","8888","8880",國泰-敦南,10,0,10,1,5.13
"20230904","1783","9857","9800",元大-東蘆,0,11,11,-1,5.64
"20230904","1783","8440","8440",摩根大通,8,0,8,1,4.10
"20230904","1783","5859","5850",統一-屏東,0,7,7,-1,3.59
"20230904","1783","8156","8150",台新-三民,6,0,6,1,3.08
"20230904","1783","0039003800310067","9800",元大-大里,0,5,5,-1,2.56
"20230904","1783","8883","8880",國泰-松江,5,0,5,1,2.56
"20230904","1783","0035003300380045","5380",第一金-自由,0,4,4,-1,2.05
"20230904","1783","9136","9100",群益金鼎-西松,5,0,5,1,2.56
"20230904","1783","0035003800350063","5850",統一-仁愛,0,3,3,-1,1.54
"20230904","1783","8565","8560",新光-桃園,3,0,3,1,1.54
"20230904","1783","0035003900320045","5920",元富-城中,0,3,3,-1,1.54
"20230904","1783","0039003800330055","9800",元大-頭份,2,0,2,1,1.03
"20230904","1783","0035003900320051","5920",元富-敦南,0,3,3,-1,1.54
"20230904","1783","8882","8880",國泰-台中,2,0,2,1,1.03
"20230904","1783","8151","8150",台新-建北,0,3,3,-1,1.54
"20230904","1783","0039004100300030","9A00",永豐金證券,2,0,2,1,1.03
"20230904","1783","0038003800340041","8840",玉山-士林,0,3,3,-1,1.54
"20230904","1783","5389","5380",第一金-中山,2,0,2,1,1.03
"20230904","1783","1480","1480",美商高盛,1,3,2,-1,1.03
"20230904","1783","1650","1650",新加坡商瑞銀,9,7,2,1,1.03
"20230904","1783","1022","1020",合庫-台南,1,3,2,-1,1.03
"20230904","1783","1021","1020",合庫-台中,2,0,2,1,1.03
"20230904","1783","1440","1440",美林,1,3,2,-1,1.03
"20230905","1783","1440","1440",美林,34,0,34,1,5.87
"20230905","1783","7007","7000",兆豐-竹北,0,40,40,-1,6.91
"20230905","1783","8440","8440",摩根大通,33,5,28,1,4.84
"20230905","1783","0035003800350063","5850",統一-仁愛,0,33,33,-1,5.70
"20230905","1783","1470","1470",台灣摩根士丹利,27,4,23,1,3.97
"20230905","1783","0035003900320045","5920",元富-城中,0,33,33,-1,5.70
"20230905","1783","6168","6160",中國信託-嘉義,20,0,20,1,3.45
"20230905","1783","8151","8150",台新-建北,0,22,22,-1,3.80
"20230905","1783","0039003600320044","9600",富邦-新莊,20,0,20,1,3.45
"20230905","1783","9332","9300",華南永昌-楠梓,0,20,20,-1,3.45
"20230905","1783","1650","1650",新加坡商瑞銀,41,28,13,1,2.25
"20230905","1783","9898","9800",元大-新莊,1,18,17,-1,2.94
"20230905","1783","0039003800390067","9800",元大-嘉義,12,0,12,1,2.07
"20230905","1783","0039004100390044","9A00",永豐金-忠孝,0,15,15,-1,2.59
"20230905","1783","0039004100390041","9A00",永豐金-羅東,12,0,12,1,2.07
"20230905","1783","1022","1020",合庫-台南,0,11,11,-1,1.90
"20230905","1783","1480","1480",美商高盛,16,5,11,1,1.90
"20230905","1783","5857","5850",統一-新竹,0,10,10,-1,1.73
"20230905","1783","8711","8710",陽信-石牌,10,0,10,1,1.73
"20230905","1783","0039003600350055","9600",富邦-彰化,0,10,10,-1,1.73
"20230905","1783","8841","8840",玉山-雙和,10,0,10,1,1.73
"20230905","1783","0039003800390044","9800",元大-左營,1,11,10,-1,1.73
"20230905","1783","0039003200320048","9200",凱基-復興,10,0,10,1,1.73
"20230905","1783","0039004100390078","9A00",永豐金-桃園,0,10,10,-1,1.73
"20230905","1783","0039003800390045","9800",元大-草屯,10,0,10,1,1.73
"20230905","1783","9349","9300",華南永昌-板橋,1,10,9,-1,1.55
"20230905","1783","9831","9800",元大-四維,10,0,10,1,1.73
"20230905","1783","0038003100350042","8150",台新-台中,0,7,7,-1,1.21
"20230906","1783","9268","9200",凱基-台北,43,19,24,1,5.88
"20230906","1783","9856","9800",元大-花蓮,1,21,20,-1,4.90
"20230906","1783","1650","1650",新加坡商瑞銀,35,13,22,1,5.39
"20230906","1783","0038003800340042","8840",玉山-台中,0,16,16,-1,3.92
"20230906","1783","1470","1470",台灣摩根士丹利,16,1,15,1,3.68
"20230906","1783","7007","7000",兆豐-竹北,0,14,14,-1,3.43
"20230906","1783","9867","9800",元大-北成功,14,0,14,1,3.43
"20230906","1783","1440","1440",美林,0,13,13,-1,3.19
"20230906","1783","9278","9200",凱基-永康,12,0,12,1,2.94
"20230906","1783","9319","9300",華南永昌-鶯歌,0,12,12,-1,2.94
"20230906","1783","0039004100390063","9A00",永豐金-永康,16,5,11,1,2.70
"20230906","1783","0039004100390041","9A00",永豐金-羅東,0,12,12,-1,2.94
"20230906","1783","1480","1480",美商高盛,10,0,10,1,2.45
"20230906","1783","003900410039004a","9A00",永豐金-板新,0,12,12,-1,2.94
"20230906","1783","9831","9800",元大-四維,10,0,10,1,2.45
"20230906","1783","9871","9800",元大-忠孝,0,11,11,-1,2.70
"20230906","1783","0039003800390066","9800",元大-東港,10,0,10,1,2.45
"20230906","1783","0039003100380063","9100",群益金鼎-鳳山,0,10,10,-1,2.45
"20230906","1783","8156","8150",台新-三民,10,1,9,1,2.21
"20230906","1783","5320","5320",高橋,1,10,9,-1,2.21
"20230906","1783","0039003800310044","9800",元大-南投,6,0,6,1,1.47
"20230906","1783","0039003800310049","9800",元大-天母,0,7,7,-1,1.72
"20230906","1783","9137","9100",群益金鼎-士林,5,0,5,1,1.23
"20230906","1783","5264","5260",美好-高雄,0,6,6,-1,1.47
"20230906","1783","0035003300380044","5380",第一金-忠孝,10,5,5,1,1.23
"20230906","1783","1029","1020",合庫-鳳山,0,6,6,-1,1.47
"20230906","1783","5925","5920",元富-台中,5,0,5,1,1.23
"20230906","1783","0035003800350063","5850",統一-仁愛,0,6,6,-1,1.47
"20230907","1783","8150","8150",台新證券,30,0,30,1,5.95
"20230907","1783","1650","1650",新加坡商瑞銀,6,44,38,-1,7.54
"20230907","1783","0037003000300055","7000",兆豐-桃鶯,20,0,20,1,3.97
"20230907","1783","9268","9200",凱基-台北,37,71,34,-1,6.75
"20230907","1783","9898","9800",元大-新莊,20,0,20,1,3.97
"20230907","1783","8440","8440",摩根大通,20,52,32,-1,6.35
"20230907","1783","0039003800390045","9800",元大-草屯,20,0,20,1,3.97
"20230907","1783","1480","1480",美商高盛,2,30,28,-1,5.56
"20230907","1783","8888","8880",國泰-敦南,12,1,11,1,2.18
"20230907","1783","1440","1440",美林,7,31,24,-1,4.76
"20230907","1783","0035003300380045","5380",第一金-自由,9,0,9,1,1.79
"20230907","1783","8563","8560",新光-新竹,0,21,21,-1,4.17
"20230907","1783","9835","9800",元大-員林中山,9,0,9,1,1.79
"20230907","1783","9300","9300",華南永昌,0,18,18,-1,3.57
"20230907","1783","9255","9200",凱基-和平,11,2,9,1,1.79
"20230907","1783","1560","1560",港商野村,6,13,7,-1,1.39
"20230907","1783","5267","5260",美好-基隆,7,0,7,1,1.39
"20230907","1783","5389","5380",第一金-中山,0,6,6,-1,1.19
"20230907","1783","8580","8580",聯邦商銀,7,0,7,1,1.39
"20230907","1783","5925","5920",元富-台中,0,6,6,-1,1.19
"20230907","1783","0039003600310057","9600",富邦-東花蓮,6,0,6,1,1.19
"20230907","1783","0031003200360069","1260",宏遠-光隆,0,5,5,-1,0.99
"20230907","1783","0039004100360031","9A00",永豐金-鳳山,6,0,6,1,1.19
"20230907","1783","0037003000330042","7030",致和-崇德,0,5,5,-1,0.99
"20230907","1783","6461","6460",大昌-樹林,5,0,5,1,0.99
"20230907","1783","9831","9800",元大-四維,0,5,5,-1,0.99
"20230907","1783","9239","9200",凱基-市政,5,0,5,1,0.99
"20230907","1783","1470","1470",台灣摩根士丹利,1,5,4,-1,0.79
"20230908","1783","0039004100390039","9A00",永豐金-中壢,10,0,10,1,5.21
"20230908","1783","7007","7000",兆豐-竹北,0,30,30,-1,15.63
"20230908","1783","0039003800310079","9800",元大-善化,6,0,6,1,3.13
"20230908","1783","8440","8440",摩根大通,1,18,17,-1,8.85
"20230908","1783","0031003200360069","1260",宏遠-光隆,5,0,5,1,2.60
"20230908","1783","0039003100330044","9100",群益金鼎-潭子,0,10,10,-1,5.21
"20230908","1783","8849","8840",玉山-景美,5,0,5,1,2.60
"20230908","1783","0035003300380044","5380",第一金-忠孝,3,10,7,-1,3.65
"20230908","1783","9831","9800",元大-四維,5,0,5,1,2.60
"20230908","1783","9183","9100",群益金鼎-高雄,0,7,7,-1,3.65
"20230908","1783","003900380039004c","9800",元大-成功,5,0,5,1,2.60
"20230908","1783","8886","8880",國泰-新莊,1,6,5,-1,2.60
"20230908","1783","9255","9200",凱基-和平,4,0,4,1,2.08
"20230908","1783","9215","9200",凱基-高美館,0,5,5,-1,2.60
"20230908","1783","9285","9200",凱基-中壢,4,0,4,1,2.08
"20230908","1783","9226","9200",凱基-汐止,0,5,5,-1,2.60
"20230908","1783","0035003300380049","5380",第一金-頭份,3,0,3,1,1.56
"20230908","1783","9659","9600",富邦-高雄,0,5,5,-1,2.60
"20230908","1783","2181","2180",亞東-板橋,3,0,3,1,1.56
"20230908","1783","0039003600360046","9600",富邦-左營,0,5,5,-1,2.60
"20230908","1783","1650","1650",新加坡商瑞銀,4,1,3,1,1.56
"20230908","1783","0039003800310044","9800",元大-南投,0,4,4,-1,2.08
"20230908","1783","0035003900320069","5920",元富-中港,3,0,3,1,1.56
"20230908","1783","9188","9100",群益金鼎-三民,0,2,2,-1,1.04
"20230908","1783","9315","9300",華南永昌-大甲,3,0,3,1,1.56
"20230908","1783","1440","1440",美林,3,5,2,-1,1.04
"20230908","1783","9614","9600",富邦-基隆,10,7,3,1,1.56
"20230908","1783","0035003900320047","5920",元富-新竹,0,2,2,-1,1.04
"20230911","1783","9255","9200",凱基-和平,9,0,9,1,4.64
"20230911","1783","1650","1650",新加坡商瑞銀,1,30,29,-1,14.95
"20230911","1783","0039003800390055","9800",元大-大甲,7,0,7,1,3.61
"20230911","1783","8150","8150",台新證券,6,28,22,-1,11.34
"20230911","1783","1028","1020",合庫-彰化,5,0,5,1,2.58
"20230911","1783","1030","1030",土銀,0,8,8,-1,4.12
"20230911","1783","1022","1020",合庫-台南,5,0,5,1,2.58
"20230911","1783","1440","1440",美林,2,7,5,-1,2.58
"20230911","1783","9300","9300",華南永昌,6,1,5,1,2.58
"20230911","1783","8490","8490",京城,0,5,5,-1,2.58
"20230911","1783","003900380034004b","9800",元大-館前,5,0,5,1,2.58
"20230911","1783","1480","1480",美商高盛,0,4,4,-1,2.06
"20230911","1783","8840","8840",玉山證券,4,0,4,1,2.06
"20230911","1783","0039003800380056","9800",元大-長庚,0,4,4,-1,2.06
"20230911","1783","9663","9600",富邦-敦南,4,0,4,1,2.06
"20230911","1783","8440","8440",摩根大通,2,5,3,-1,1.55
"20230911","1783","2181","2180",亞東-板橋,3,0,3,1,1.55
"20230911","1783","1470","1470",台灣摩根士丹利,2,4,2,-1,1.03
"20230911","1783","003700300030005a","7000",兆豐-高雄,3,0,3,1,1.55
"20230911","1783","0031003000340041","1040",臺銀-臺中,0,2,2,-1,1.03
"20230911","1783","9817","9800",元大-東泰,3,0,3,1,1.55
"20230911","1783","0037003000300069","7000",兆豐-松德,0,2,2,-1,1.03
"20230911","1783","0035003300380044","5380",第一金-忠孝,2,0,2,1,1.03
"20230911","1783","003700370039006a","7790",國票-和平,0,2,2,-1,1.03
"20230911","1783","5267","5260",美好-基隆,2,0,2,1,1.03
"20230911","1783","8492","8490",京城-嘉義,0,2,2,-1,1.03
"20230911","1783","003700300030004a","7000",兆豐-公益,2,0,2,1,1.03
"20230911","1783","9328","9300",華南永昌-潮州,0,2,2,-1,1.03
"20230912","1783","9268","9200",凱基-台北,18,6,12,1,7.50
"20230912","1783","5320","5320",高橋,0,10,10,-1,6.25
"20230912","1783","9812","9800",元大-台中,6,0,6,1,3.75
"20230912","1783","003600310036004b","6160",中國信託-高雄,0,10,10,-1,6.25
"20230912","1783","9319","9300",華南永昌-鶯歌,5,0,5,1,3.13
"20230912","1783","9349","9300",華南永昌-板橋,0,10,10,-1,6.25
"20230912","1783","9238","9200",凱基-士林,4,0,4,1,2.50
"20230912","1783","8846","8840",玉山-板橋,0,7,7,-1,4.38
"20230912","1783","8888","8880",國泰-敦南,4,1,3,1,1.88
"20230912","1783","8440","8440",摩根大通,0,6,6,-1,3.75
"20230912","1783","1118","1110",台灣企銀-豐原,3,0,3,1,1.88
"20230912","1783","003700300030005a","7000",兆豐-高雄,0,5,5,-1,3.13
"20230912","1783","0031003000330046","1030",土銀-南港,5,2,3,1,1.88
"20230912","1783","1470","1470",台灣摩根士丹利,1,5,4,-1,2.50
"20230912","1783","0038003100350048","8150",台新-屏東,3,0,3,1,1.88
"20230912","1783","9314","9300",華南永昌-嘉義,0,4,4,-1,2.50
"20230912","1783","0039003600310048","9600",富邦-新板,3,0,3,1,1.88
"20230912","1783","1560","1560",港商野村,0,3,3,-1,1.88
"20230912","1783","0035003300380049","5380",第一金-頭份,3,0,3,1,1.88
"20230912","1783","1480","1480",美商高盛,0,3,3,-1,1.88
"20230912","1783","1440","1440",美林,2,0,2,1,1.25
"20230912","1783","0039003800380056","9800",元大-長庚,0,3,3,-1,1.88
"20230912","1783","5385","5380",第一金-桃園,2,0,2,1,1.25
"20230912","1783","0039004100390057","9A00",永豐金-市政,0,3,3,-1,1.88
"20230912","1783","7036","7030",致和-高雄,2,0,2,1,1.25
"20230912","1783","0039003800310051","9800",元大-太平,0,2,2,-1,1.25
"20230912","1783","8840","8840",玉山證券,2,0,2,1,1.25
"20230912","1783","2181","2180",亞東-板橋,0,2,2,-1,1.25
"20230913","1783","9874","9800",元大-雙和,27,0,27,1,13.85
"20230913","1783","8150","8150",台新證券,0,26,26,-1,13.33
"20230913","1783","1440","1440",美林,12,0,12,1,6.15
"20230913","1783","9300","9300",華南永昌,0,19,19,-1,9.74
"20230913","1783","1650","1650",新加坡商瑞銀,13,2,11,1,5.64
"20230913","1783","8846","8840",玉山-板橋,0,13,13,-1,6.67
"20230913","1783","8440","8440",摩根大通,10,0,10,1,5.13
"20230913","1783","003900380030004b","9800",元大-竹科,0,7,7,-1,3.59
"20230913","1783","8563","8560",新光-新竹,6,0,6,1,3.08
"20230913","1783","0035003300380045","5380",第一金-自由,0,6,6,-1,3.08
"20230913","1783","8885","8880",國泰-桃園,5,0,5,1,2.56
"20230913","1783","9872","9800",元大-復北,1,6,5,-1,2.56
"20230913","1783","0039003600310056","9600",富邦-板橋中山,5,0,5,1,2.56
"20230913","1783","8886","8880",國泰-新莊,0,5,5,-1,2.56
"20230913","1783","0039003800390055","9800",元大-大甲,5,0,5,1,2.56
"20230913","1783","9238","9200",凱基-士林,0,4,4,-1,2.05
"20230913","1783","1560","1560",港商野村,4,0,4,1,2.05
"20230913","1783","0039003800310069","9800",元大-西螺,0,4,4,-1,2.05
"20230913","1783","9256","9200",凱基-南崁,4,0,4,1,2.05
"20230913","1783","5383","5380",第一金-高雄,0,2,2,-1,1.03
"20230913","1783","9215","9200",凱基-高美館,3,0,3,1,1.54
"20230913","1783","003700300030004d","7000",兆豐-桃園,0,2,2,-1,1.03
"20230913","1783","0039003800310058","9800",元大-新生,3,0,3,1,1.54
"20230913","1783","9272","9200",凱基-竹科,0,2,2,-1,1.03
"20230913","1783","5856","5850",統一-台中,2,0,2,1,1.03
"20230913","1783","9315","9300",華南永昌-大甲,0,2,2,-1,1.03
"20230913","1783","2181","2180",亞東-板橋,2,0,2,1,1.03
"20230913","1783","9655","9600",富邦-板橋,0,2,2,-1,1.03
"20230914","1783","1470","1470",台灣摩根士丹利,16,1,15,1,9.09
"20230914","1783","8150","8150",台新證券,0,11,11,-1,6.67
"20230914","1783","9268","9200",凱基-台北,25,13,12,1,7.27
"20230914","1783","9625","9600",富邦-竹東,0,10,10,-1,6.06
"20230914","1783","1480","1480",美商高盛,8,0,8,1,4.85
"20230914","1783","1022","1020",合庫-台南,0,5,5,-1,3.03
"20230914","1783","1650","1650",新加坡商瑞銀,11,5,6,1,3.64
"20230914","1783","003700300030005a","7000",兆豐-高雄,0,4,4,-1,2.42
"20230914","1783","9874","9800",元大-雙和,6,0,6,1,3.64
"20230914","1783","0037003700390050","7790",國票-九鼎,0,4,4,-1,2.42
"20230914","1783","8440","8440",摩根大通,10,5,5,1,3.03
"20230914","1783","0039003200300045","9200",凱基-東門,0,4,4,-1,2.42
"20230914","1783","6950","6950",福勝,4,0,4,1,2.42
"20230914","1783","9215","9200",凱基-高美館,0,4,4,-1,2.42
"20230914","1783","003700300030004b","7000",兆豐-新營,4,0,4,1,2.42
"20230914","1783","0039003600310058","9600",富邦-大墩,0,4,4,-1,2.42
"20230914","1783","0039003600310056","9600",富邦-板橋中山,4,0,4,1,2.42
"20230914","1783","9834","9800",元大-中壢,0,4,4,-1,2.42
"20230914","1783","9872","9800",元大-復北,4,0,4,1,2.42
"20230914","1783","2181","2180",亞東-板橋,0,3,3,-1,1.82
"20230914","1783","003500390032007a","5920",元富-文心,3,0,3,1,1.82
"20230914","1783","0035003300380045","5380",第一金-自由,0,3,3,-1,1.82
"20230914","1783","9252","9200",凱基-嘉義,4,1,3,1,1.82
"20230914","1783","0035003900320077","5920",元富-佳里,0,3,3,-1,1.82
"20230914","1783","9614","9600",富邦-基隆,3,0,3,1,1.82
"20230914","1783","0039003100380050","9100",群益金鼎-天母,0,3,3,-1,1.82
"20230914","1783","003700370039005a","7790",國票-安和,2,0,2,1,1.21
"20230914","1783","0039004100390071","9A00",永豐金-潮州,0,3,3,-1,1.82
"20230915","1783","9874","9800",元大-雙和,24,0,24,1,9.20
"20230915","1783","1440","1440",美林,1,22,21,-1,8.05
"20230915","1783","9235","9200",凱基-永華,10,0,10,1,3.83
"20230915","1783","1650","1650",新加坡商瑞銀,7,23,16,-1,6.13
"20230915","1783","9838","9800",元大-豐原,10,0,10,1,3.83
"20230915","1783","9315","9300",華南永昌-大甲,0,11,11,-1,4.21
"20230915","1783","1480","1480",美商高盛,9,1,8,1,3.07
"20230915","1783","8563","8560",新光-新竹,0,10,10,-1,3.83
"20230915","1783","003900380033005a","9800",元大-鳳山,7,0,7,1,2.68
"20230915","1783","8440","8440",摩根大通,3,11,8,-1,3.07
"20230915","1783","0035003900320076","5920",元富-桃園,5,0,5,1,1.92
"20230915","1783","003900380034004b","9800",元大-館前,0,8,8,-1,3.07
"20230915","1783","0039003800340043","9800",元大-新店中正,5,0,5,1,1.92
"20230915","1783","9268","9200",凱基-台北,11,18,7,-1,2.68
"20230915","1783","003700300030004b","7000",兆豐-新營,4,0,4,1,1.53
"20230915","1783","0039003800310056","9800",元大-民雄,0,6,6,-1,2.30
"20230915","1783","9278","9200",凱基-永康,5,1,4,1,1.53
"20230915","1783","0031003200360069","1260",宏遠-光隆,0,5,5,-1,1.92
"20230915","1783","0039003800310079","9800",元大-善化,4,0,4,1,1.53
"20230915","1783","6452","6450",永全-八德,0,5,5,-1,1.92
"20230915","1783","1470","1470",台灣摩根士丹利,6,4,2,1,0.77
"20230915","1783","9831","9800",元大-四維,0,5,5,-1,1.92
"20230915","1783","7080","7080",石橋證券,2,0,2,1,0.77
"20230915","1783","5262","5260",美好-楊梅,0,4,4,-1,1.53
"20230915","1783","0037003700390058","7790",國票-中和,2,0,2,1,0.77
"20230915","1783","0039003800310068","9800",元大-屏東民生,0,4,4,-1,1.53
"20230915","1783","8846","8840",玉山-板橋,2,0,2,1,0.77
"20230915","1783","9137","9100",群益金鼎-士林,0,4,4,-1,1.53
"20230918","1783","1470","1470",台灣摩根士丹利,29,3,26,1,10.12
"20230918","1783","8563","8560",新光-新竹,0,8,8,-1,3.11
"20230918","1783","9838","9800",元大-豐原,22,0,22,1,8.56
"20230918","1783","9300","9300",華南永昌,0,7,7,-1,2.72
"20230918","1783","9268","9200",凱基-台北,21,4,17,1,6.61
"20230918","1783","9812","9800",元大-台中,0,6,6,-1,2.33
"20230918","1783","0039003600310056","9600",富邦-板橋中山,10,0,10,1,3.89
"20230918","1783","9874","9800",元大-雙和,0,6,6,-1,2.33
"20230918","1783","003900410039004d","9A00",永豐金-南投,13,3,10,1,3.89
"20230918","1783","0035003300380049","5380",第一金-頭份,0,5,5,-1,1.95
"20230918","1783","1440","1440",美林,15,7,8,1,3.11
"20230918","1783","0039003800380056","9800",元大-長庚,0,5,5,-1,1.95
"20230918","1783","0035003900320077","5920",元富-佳里,5,0,5,1,1.95
"20230918","1783","0039003800390061","9800",元大-苑裡,0,5,5,-1,1.95
"20230918","1783","9814","9800",元大-大益,5,0,5,1,1.95
"20230918","1783","0039004100370039","9A00",永豐金-埔里,0,5,5,-1,1.95
"20230918","1783","003900380033004b","9800",元大-學甲,5,0,5,1,1.95
"20230918","1783","003800380034004a","8840",玉山-大里,0,4,4,-1,1.56
"20230918","1783","9879","9800",元大-板橋三民,5,0,5,1,1.95
"20230918","1783","9315","9300",華南永昌-大甲,0,4,4,-1,1.56
"20230918","1783","1650","1650",新加坡商瑞銀,10,6,4,1,1.56
"20230918","1783","0039003800300051","9800",元大-南崁,0,3,3,-1,1.17
"20230918","1783","1560","1560",港商野村,3,0,3,1,1.17
"20230918","1783","0037003000300055","7000",兆豐-桃鶯,0,3,3,-1,1.17
"20230918","1783","8151","8150",台新-建北,3,0,3,1,1.17
"20230918","1783","9215","9200",凱基-高美館,0,3,3,-1,1.17
"20230918","1783","8882","8880",國泰-台中,3,0,3,1,1.17
"20230918","1783","9227","9200",凱基-城中,0,3,3,-1,1.17
"20230919","1783","003900380039004c","9800",元大-成功,7,0,7,1,3.98
"20230919","1783","9268","9200",凱基-台北,6,36,30,-1,17.05
"20230919","1783","0035003900320077","5920",元富-佳里,5,0,5,1,2.84
"20230919","1783","0038003100350041","8150",台新-高雄,0,10,10,-1,5.68
"20230919","1783","8841","8840",玉山-雙和,5,0,5,1,2.84
"20230919","1783","0039003100330067","9100",群益金鼎-三重,0,5,5,-1,2.84
"20230919","1783","9315","9300",華南永昌-大甲,5,0,5,1,2.84
"20230919","1783","9692","9600",富邦-嘉義,0,5,5,-1,2.84
"20230919","1783","1470","1470",台灣摩根士丹利,6,2,4,1,2.27
"20230919","1783","1440","1440",美林,2,7,5,-1,2.84
"20230919","1783","0038003100350042","8150",台新-台中,4,0,4,1,2.27
"20230919","1783","003500390032007a","5920",元富-文心,0,3,3,-1,1.70
"20230919","1783","8440","8440",摩根大通,4,0,4,1,2.27
"20230919","1783","0039003600310048","9600",富邦-新板,0,3,3,-1,1.70
"20230919","1783","8884","8880",國泰-台南,4,0,4,1,2.27
"20230919","1783","5265","5260",美好-苗栗,0,2,2,-1,1.14
"20230919","1783","0039003600310058","9600",富邦-大墩,4,0,4,1,2.27
"20230919","1783","1560","1560",港商野村,0,2,2,-1,1.14
"20230919","1783","0039003800310079","9800",元大-善化,4,0,4,1,2.27
"20230919","1783","6381","6380",光和-溪湖,0,2,2,-1,1.14
"20230919","1783","9874","9800",元大-雙和,4,0,4,1,2.27
"20230919","1783","9366","9300",華南永昌-豐原,0,2,2,-1,1.14
"20230919","1783","9215","9200",凱基-高美館,4,0,4,1,2.27
"20230919","1783","0039003800380042","9800",元大-桃園,0,2,2,-1,1.14
"20230919","1783","8561","8560",新光-台中,3,0,3,1,1.70
"20230919","1783","0039003800390055","9800",元大-大甲,0,2,2,-1,1.14
"20230919","1783","0037003700390058","7790",國票-中和,3,0,3,1,1.70
"20230919","1783","003900410039004d","9A00",永豐金-南投,2,4,2,-1,1.14
"20230920","1783","1650","1650",新加坡商瑞銀,10,0,10,1,8.62
"20230920","1783","8846","8840",玉山-板橋,0,10,10,-1,8.62
"20230920","1783","7007","7000",兆豐-竹北,10,0,10,1,8.62
"20230920","1783","9268","9200",凱基-台北,2,11,9,-1,7.76
"20230920","1783","0039003200320048","9200",凱基-復興,10,0,10,1,8.62
"20230920","1783","003700300030005a","7000",兆豐-高雄,1,7,6,-1,5.17
"20230920","1783","1440","1440",美林,7,1,6,1,5.17
"20230920","1783","0038003800340042","8840",玉山-台中,0,5,5,-1,4.31
"20230920","1783","1480","1480",美商高盛,5,0,5,1,4.31
"20230920","1783","6950","6950",福勝,0,4,4,-1,3.45
"20230920","1783","0035003900320077","5920",元富-佳里,5,0,5,1,4.31
"20230920","1783","0039003800320042","9800",元大-博愛,0,3,3,-1,2.59
"20230920","1783","0035003300380049","5380",第一金-頭份,3,0,3,1,2.59
"20230920","1783","0039004100390055","9A00",永豐金-中正,0,3,3,-1,2.59
"20230920","1783","0038003100350048","8150",台新-屏東,3,0,3,1,2.59
"20230920","1783","8843","8840",玉山-高雄,0,2,2,-1,1.72
"20230920","1783","8440","8440",摩根大通,3,0,3,1,2.59
"20230920","1783","0038003800340041","8840",玉山-士林,0,2,2,-1,1.72
"20230920","1783","003900380033004b","9800",元大-學甲,3,0,3,1,2.59
"20230920","1783","0039003600320045","9600",富邦-樹林,0,2,2,-1,1.72
"20230920","1783","0035003300380044","5380",第一金-忠孝,2,0,2,1,1.72
"20230920","1783","9657","9600",富邦-苗栗,0,2,2,-1,1.72
"20230920","1783","1560","1560",港商野村,2,0,2,1,1.72
"20230920","1783","0039003800330055","9800",元大-頭份,0,2,2,-1,1.72
"20230920","1783","003500320036004b","5260",美好-富順,4,2,2,1,1.72
"20230920","1783","003900410039004d","9A00",永豐金-南投,0,2,2,-1,1.72
"20230920","1783","9659","9600",富邦-高雄,2,0,2,1,1.72
"20230920","1783","003100320036004c","1260",宏遠-台中,0,1,1,-1,0.86
"20230921","1783","0037003700390058","7790",國票-中和,11,0,11,1,6.83
"20230921","1783","9268","9200",凱基-台北,2,25,23,-1,14.29
"20230921","1783","8840","8840",玉山證券,10,0,10,1,6.21
"20230921","1783","8440","8440",摩根大通,0,16,16,-1,9.94
"20230921","1783","1480","1480",美商高盛,9,2,7,1,4.35
"20230921","1783","1560","1560",港商野村,0,12,12,-1,7.45
"20230921","1783","9332","9300",華南永昌-楠梓,6,0,6,1,3.73
"20230921","1783","0035003800350055","5850",統一-南京,0,5,5,-1,3.11
"20230921","1783","9315","9300",華南永昌-大甲,5,0,5,1,3.11
"20230921","1783","1650","1650",新加坡商瑞銀,0,5,5,-1,3.11
"20230921","1783","0039003800310079","9800",元大-善化,5,0,5,1,3.11
"20230921","1783","0039003800320042","9800",元大-博愛,1,6,5,-1,3.11
"20230921","1783","9831","9800",元大-四維,5,0,5,1,3.11
"20230921","1783","0039003100330045","9100",群益金鼎-基隆,0,4,4,-1,2.48
"20230921","1783","003700300030005a","7000",兆豐-高雄,3,0,3,1,1.86
"20230921","1783","8150","8150",台新證券,0,3,3,-1,1.86
"20230921","1783","9898","9800",元大-新莊,3,0,3,1,1.86
"20230921","1783","8151","8150",台新-建北,0,3,3,-1,1.86
"20230921","1783","0039003800330056","9800",元大-竹南,2,0,2,1,1.24
"20230921","1783","9800","9800",元大證券,0,3,3,-1,1.86
"20230921","1783","5853","5850",統一-中壢,2,0,2,1,1.24
"20230921","1783","5927","5920",元富-林園,0,2,2,-1,1.24
"20230921","1783","0035003900320041","5920",元富-緯城,2,0,2,1,1.24
"20230921","1783","0035003900320061","5920",元富-松德,0,2,2,-1,1.24
"20230921","1783","0035003900320044","5920",元富-大昌,2,0,2,1,1.24
"20230921","1783","003700300030004a","7000",兆豐-公益,0,2,2,-1,1.24
"20230921","1783","0035003900320072","5920",元富-城東,3,1,2,1,1.24
"20230921","1783","5857","5850",統一-新竹,0,1,1,-1,0.62
"20230922","1783","8440","8440",摩根大通,7,0,7,1,9.59
"20230922","1783","0037003700390065","7790",國票-南科,0,5,5,-1,6.85
"20230922","1783","9268","9200",凱基-台北,8,3,5,1,6.85
"20230922","1783","9834","9800",元大-中壢,0,5,5,-1,6.85
"20230922","1783","0039003800390047","9800",元大-大同,5,0,5,1,6.85
"20230922","1783","1470","1470",台灣摩根士丹利,0,4,4,-1,5.48
"20230922","1783","7007","7000",兆豐-竹北,3,0,3,1,4.11
"20230922","1783","0039003600310058","9600",富邦-大墩,0,4,4,-1,5.48
"20230922","1783","0039003800390055","9800",元大-大甲,3,0,3,1,4.11
"20230922","1783","0035003900320072","5920",元富-城東,0,2,2,-1,2.74
"20230922","1783","1440","1440",美林,2,0,2,1,2.74
"20230922","1783","0031003000330046","1030",土銀-南港,0,2,2,-1,2.74
"20230922","1783","1560","1560",港商野村,2,0,2,1,2.74
"20230922","1783","9223","9200",凱基-豐中,0,2,2,-1,2.74
"20230922","1783","8561","8560",新光-台中,2,0,2,1,2.74
"20230922","1783","9255","9200",凱基-和平,0,2,2,-1,2.74
"20230922","1783","9300","9300",華南永昌,2,0,2,1,2.74
"20230922","1783","9349","9300",華南永昌-板橋,0,2,2,-1,2.74
"20230922","1783","9319","9300",華南永昌-鶯歌,2,0,2,1,2.74
"20230922","1783","8888","8880",國泰-敦南,0,1,1,-1,1.37
"20230922","1783","9853","9800",元大-南屯,2,0,2,1,2.74
"20230922","1783","1650","1650",新加坡商瑞銀,2,3,1,-1,1.37
"20230922","1783","0039003800390042","9800",元大-台中中港,2,0,2,1,2.74
"20230922","1783","1110","1110",台灣企銀,0,1,1,-1,1.37
"20230922","1783","1038","1030",土銀-和平,1,0,1,1,1.37
"20230922","1783","5600","5600",永興,0,1,1,-1,1.37
"20230922","1783","1112","1110",台灣企銀-台南,1,0,1,1,1.37
"20230922","1783","0036003100310041","6110",台中銀-豐原,0,1,1,-1,1.37
"20230925","1783","8440","8440",摩根大通,18,0,18,1,11.18
"20230925","1783","9332","9300",華南永昌-楠梓,0,10,10,-1,6.21
"20230925","1783","9268","9200",凱基-台北,13,2,11,1,6.83
"20230925","1783","8563","8560",新光-新竹,0,8,8,-1,4.97
"20230925","1783","9101","9100",群益金鼎-敦南,10,0,10,1,6.21
"20230925","1783","0039003800340043","9800",元大-新店中正,0,7,7,-1,4.35
"20230925","1783","1480","1480",美商高盛,15,7,8,1,4.97
"20230925","1783","9315","9300",華南永昌-大甲,0,6,6,-1,3.73
"20230925","1783","0039004100390043","9A00",永豐金-員林,3,0,3,1,1.86
"20230925","1783","0035003900320041","5920",元富-緯城,0,5,5,-1,3.11
"20230925","1783","8560","8560",新光,2,0,2,1,1.24
"20230925","1783","9215","9200",凱基-高美館,4,8,4,-1,2.48
"20230925","1783","0035003300380059","5380",第一金-中壢,2,0,2,1,1.24
"20230925","1783","0035003900320045","5920",元富-城中,0,4,4,-1,2.48
"20230925","1783","1470","1470",台灣摩根士丹利,5,3,2,1,1.24
"20230925","1783","0035003900320076","5920",元富-桃園,0,3,3,-1,1.86
"20230925","1783","1440","1440",美林,6,4,2,1,1.24
"20230925","1783","0035003800350063","5850",統一-仁愛,0,2,2,-1,1.24
"20230925","1783","0039003100330045","9100",群益金鼎-基隆,2,0,2,1,1.24
"20230925","1783","0035003300380049","5380",第一金-頭份,0,2,2,-1,1.24
"20230925","1783","0039003800330047","9800",元大-上新莊,2,0,2,1,1.24
"20230925","1783","003700300030005a","7000",兆豐-高雄,0,2,2,-1,1.24
"20230925","1783","0039003800330055","9800",元大-頭份,2,0,2,1,1.24
"20230925","1783","0038003800340045","8840",玉山-城中,0,2,2,-1,1.24
"20230925","1783","1560","1560",港商野村,1,0,1,1,0.62
"20230925","1783","9322","9300",華南永昌-公誠,0,2,2,-1,1.24
"20230925","1783","2180","2180",亞東,1,0,1,1,0.62
"20230925","1783","0039003600310043","9600",富邦-南京,0,2,2,-1,1.24
"20230926","1783","0039003800320042","9800",元大-博愛,10,0,10,1,12.99
"20230926","1783","1560","1560",港商野村,0,6,6,-1,7.79
"20230926","1783","9276","9200",凱基-苗栗,9,0,9,1,11.69
"20230926","1783","0039003800390047","9800",元大-大同,0,6,6,-1,7.79
"20230926","1783","1440","1440",美林,9,1,8,1,10.39
"20230926","1783","1650","1650",新加坡商瑞銀,2,7,5,-1,6.49
"20230926","1783","1470","1470",台灣摩根士丹利,3,0,3,1,3.90
"20230926","1783","1480","1480",美商高盛,0,3,3,-1,3.90
"20230926","1783","0031003000340041","1040",臺銀-臺中,2,0,2,1,2.60
"20230926","1783","9257","9200",凱基-林口,0,3,3,-1,3.90
"20230926","1783","0037003000300056","7000",兆豐-新竹,2,0,2,1,2.60
"20230926","1783","0039003800390055","9800",元大-大甲,0,3,3,-1,3.90
"20230926","1783","0035003800350059","5850",統一-土城,1,0,1,1,1.30
"20230926","1783","0039003800390056","9800",元大-北三重,0,3,3,-1,3.90
"20230926","1783","0035003800350048","5850",統一-桃園,1,0,1,1,1.30
"20230926","1783","003500320036004b","5260",美好-富順,0,2,2,-1,2.60
"20230926","1783","0035003800350041","5850",統一-基隆,1,0,1,1,1.30
"20230926","1783","0031003200360069","1260",宏遠-光隆,0,2,2,-1,2.60
"20230926","1783","0035003300380045","5380",第一金-自由,1,0,1,1,1.30
"20230926","1783","0039003600320045","9600",富邦-樹林,0,2,2,-1,2.60
"20230926","1783","003500390032006e","5920",元富-西松,1,0,1,1,1.30
"20230926","1783","9800","9800",元大證券,1,2,1,-1,1.30
"20230926","1783","8440","8440",摩根大通,1,0,1,1,1.30
"20230926","1783","0035003900320042","5920",元富-永和,0,1,1,-1,1.30
"20230926","1783","8848","8840",玉山-嘉義,1,0,1,1,1.30
"20230926","1783","8562","8560",新光-高雄,0,1,1,-1,1.30
"20230926","1783","9134","9100",群益金鼎-開元,1,0,1,1,1.30
"20230926","1783","8586","8580",聯邦-大業,0,1,1,-1,1.30
"20230927","1783","1440","1440",美林,10,0,10,1,11.49
"20230927","1783","9838","9800",元大-豐原,0,10,10,-1,11.49
"20230927","1783","1650","1650",新加坡商瑞銀,11,1,10,1,11.49
"20230927","1783","8150","8150",台新證券,0,6,6,-1,6.90
"20230927","1783","8440","8440",摩根大通,7,0,7,1,8.05
"20230927","1783","9322","9300",華南永昌-公誠,0,6,6,-1,6.90
"20230927","1783","1560","1560",港商野村,5,0,5,1,5.75
"20230927","1783","0037003000300042","7000",兆豐-板橋,0,5,5,-1,5.75
"20230927","1783","9319","9300",華南永昌-鶯歌,5,0,5,1,5.75
"20230927","1783","9363","9300",華南永昌-彰化,0,4,4,-1,4.60
"20230927","1783","9872","9800",元大-復北,5,0,5,1,5.75
"20230927","1783","9800","9800",元大證券,0,4,4,-1,4.60
"20230927","1783","8840","8840",玉山證券,3,0,3,1,3.45
"20230927","1783","9834","9800",元大-中壢,0,4,4,-1,4.60
"20230927","1783","1031","1030",土銀-台中,2,0,2,1,2.30
"20230927","1783","1470","1470",台灣摩根士丹利,3,6,3,-1,3.45
"20230927","1783","0039003800300077","9800",元大-西屯,2,0,2,1,2.30
"20230927","1783","8882","8880",國泰-台中,0,3,3,-1,3.45
"20230927","1783","0031003000340043","1040",臺銀-高雄,1,0,1,1,1.15
"20230927","1783","0035003900320041","5920",元富-緯城,0,2,2,-1,2.30
"20230927","1783","0035003300380045","5380",第一金-自由,1,0,1,1,1.15
"20230927","1783","0039003200300048","9200",凱基-基隆,0,2,2,-1,2.30
"20230927","1783","8159","8150",台新-台南,1,0,1,1,1.15
"20230927","1783","9814","9800",元大-大益,0,2,2,-1,2.30
"20230927","1783","0039003100330045","9100",群益金鼎-基隆,1,0,1,1,1.15
"20230927","1783","9893","9800",元大-大天母,0,2,2,-1,2.30
"20230927","1783","9327","9300",華南永昌-斗六,1,0,1,1,1.15
"20230927","1783","8455","8450",康和-台中,0,1,1,-1,1.15
"20230928","1783","1650","1650",新加坡商瑞銀,33,2,31,1,12.92
"20230928","1783","1480","1480",美商高盛,4,20,16,-1,6.67
"20230928","1783","1440","1440",美林,30,3,27,1,11.25
"20230928","1783","9233","9200",凱基-長庚,0,10,10,-1,4.17
"20230928","1783","8440","8440",摩根大通,23,0,23,1,9.58
"20230928","1783","0039004100390039","9A00",永豐金-中壢,0,8,8,-1,3.33
"20230928","1783","0039003800320042","9800",元大-博愛,20,0,20,1,8.33
"20230928","1783","0039003600310052","9600",富邦-南員林,0,5,5,-1,2.08
"20230928","1783","1470","1470",台灣摩根士丹利,16,2,14,1,5.83
"20230928","1783","9831","9800",元大-四維,0,5,5,-1,2.08
"20230928","1783","9898","9800",元大-新莊,7,2,5,1,2.08
"20230928","1783","1560","1560",港商野村,0,4,4,-1,1.67
"20230928","1783","0031003000330046","1030",土銀-南港,3,0,3,1,1.25
"20230928","1783","0038003100350048","8150",台新-屏東,0,4,4,-1,1.67
"20230928","1783","8886","8880",國泰-新莊,3,0,3,1,1.25
"20230928","1783","0038003800340048","8840",玉山-新竹,0,4,4,-1,1.67
"20230928","1783","9319","9300",華南永昌-鶯歌,3,0,3,1,1.25
"20230928","1783","8884","8880",國泰-台南,0,4,4,-1,1.67
"20230928","1783","9278","9200",凱基-永康,2,0,2,1,0.83
"20230928","1783","9315","9300",華南永昌-大甲,0,4,4,-1,1.67
"20230928","1783","8840","8840",玉山證券,2,0,2,1,0.83
"20230928","1783","9349","9300",華南永昌-板橋,0,4,4,-1,1.67
"20230928","1783","8849","8840",玉山-景美,2,0,2,1,0.83
"20230928","1783","0039003800310079","9800",元大-善化,0,4,4,-1,1.67
"20230928","1783","0039003100330045","9100",群益金鼎-基隆,2,0,2,1,0.83
"20230928","1783","5853","5850",統一-中壢,0,3,3,-1,1.25
"20230928","1783","9189","9100",群益金鼎-桃園,2,0,2,1,0.83
"20230928","1783","2181","2180",亞東-板橋,0,3,3,-1,1.25
"20231002","1783","8440","8440",摩根大通,29,0,29,1,17.68
"20231002","1783","9208","9200",凱基-桃園,0,12,12,-1,7.32
"20231002","1783","9838","9800",元大-豐原,10,0,10,1,6.10
"20231002","1783","6464","6460",大昌-新店,0,10,10,-1,6.10
"20231002","1783","1480","1480",美商高盛,12,3,9,1,5.49
"20231002","1783","0039003100330045","9100",群益金鼎-基隆,0,5,5,-1,3.05
"20231002","1783","003900410039004c","9A00",永豐金-台中,7,0,7,1,4.27
"20231002","1783","9616","9600",富邦-岡山,0,5,5,-1,3.05
"20231002","1783","1650","1650",新加坡商瑞銀,18,13,5,1,3.05
"20231002","1783","0039003800390049","9800",元大-蘆洲,0,5,5,-1,3.05
"20231002","1783","0036003000310064","6010",(牛牛牛)亞-鑫豐,5,0,5,1,3.05
"20231002","1783","0039004100390057","9A00",永豐金-市政,0,5,5,-1,3.05
"20231002","1783","9319","9300",華南永昌-鶯歌,5,0,5,1,3.05
"20231002","1783","9234","9200",凱基-竹北,0,4,4,-1,2.44
"20231002","1783","8150","8150",台新證券,4,0,4,1,2.44
"20231002","1783","0039003800310043","9800",元大-路竹,0,4,4,-1,2.44
"20231002","1783","9268","9200",凱基-台北,10,6,4,1,2.44
"20231002","1783","9893","9800",元大-大天母,0,4,4,-1,2.44
"20231002","1783","6110","6110",台中銀,3,0,3,1,1.83
"20231002","1783","0035003800350048","5850",統一-桃園,0,3,3,-1,1.83
"20231002","1783","003700300030004d","7000",兆豐-桃園,1,0,1,1,0.61
"20231002","1783","0035003300380049","5380",第一金-頭份,0,3,3,-1,1.83
"20231002","1783","8561","8560",新光-台中,1,0,1,1,0.61
"20231002","1783","0031003000340041","1040",臺銀-臺中,0,3,3,-1,1.83
"20231002","1783","8840","8840",玉山證券,1,0,1,1,0.61
"20231002","1783","6463","6460",大昌-新竹,0,3,3,-1,1.83
"20231002","1783","9187","9100",群益金鼎-彰化,1,0,1,1,0.61
"20231002","1783","9300","9300",華南永昌,0,3,3,-1,1.83
"20231003","1783","8150","8150",台新證券,8,0,8,1,7.77
"20231003","1783","9268","9200",凱基-台北,1,7,6,-1,5.83
"20231003","1783","0031003200360069","1260",宏遠-光隆,6,0,6,1,5.83
"20231003","1783","9208","9200",凱基-桃園,0,5,5,-1,4.85
"20231003","1783","8840","8840",玉山證券,5,0,5,1,4.85
"20231003","1783","9322","9300",華南永昌-公誠,0,5,5,-1,4.85
"20231003","1783","0038003800340043","8840",玉山-南京東路,4,0,4,1,3.88
"20231003","1783","0039003100330045","9100",群益金鼎-基隆,0,4,4,-1,3.88
"20231003","1783","0039003800380056","9800",元大-長庚,4,0,4,1,3.88
"20231003","1783","0031003000330046","1030",土銀-南港,0,3,3,-1,2.91
"20231003","1783","9898","9800",元大-新莊,4,0,4,1,3.88
"20231003","1783","6110","6110",台中銀,0,3,3,-1,2.91
"20231003","1783","1650","1650",新加坡商瑞銀,7,4,3,1,2.91
"20231003","1783","003700370039005a","7790",國票-安和,0,2,2,-1,1.94
"20231003","1783","9315","9300",華南永昌-大甲,3,0,3,1,2.91
"20231003","1783","8560","8560",新光,0,2,2,-1,1.94
"20231003","1783","9869","9800",元大-新盛,3,0,3,1,2.91
"20231003","1783","003900310038004b","9100",群益金鼎-東湖,0,2,2,-1,1.94
"20231003","1783","0039003800390061","9800",元大-苑裡,3,0,3,1,2.91
"20231003","1783","9647","9600",富邦-新竹,0,2,2,-1,1.94
"20231003","1783","1470","1470",台灣摩根士丹利,3,1,2,1,1.94
"20231003","1783","9872","9800",元大-復北,0,2,2,-1,1.94
"20231003","1783","8440","8440",摩根大通,5,3,2,1,1.94
"20231003","1783","0039004100390039","9A00",永豐金-中壢,0,2,2,-1,1.94
"20231003","1783","8842","8840",玉山-新莊,2,0,2,1,1.94
"20231003","1783","9897","9800",元大-土城,0,1,1,-1,0.97
"20231003","1783","003900380039004c","9800",元大-成功,2,0,2,1,1.94
"20231003","1783","1117","1110",台灣企銀-竹北,0,1,1,-1,0.97
"20231004","1783","7007","7000",兆豐-竹北,5,0,5,1,3.79
"20231004","1783","0039003800310061","9800",元大-歸仁,0,7,7,-1,5.30
"20231004","1783","8849","8840",玉山-景美,5,0,5,1,3.79
"20231004","1783","9268","9200",凱基-台北,8,14,6,-1,4.55
"20231004","1783","0039004100360039","9A00",永豐金-屏東,5,0,5,1,3.79
"20231004","1783","8150","8150",台新證券,0,6,6,-1,4.55
"20231004","1783","003900410039004c","9A00",永豐金-台中,5,0,5,1,3.79
"20231004","1783","9655","9600",富邦-板橋,0,5,5,-1,3.79
"20231004","1783","1480","1480",美商高盛,5,1,4,1,3.03
"20231004","1783","0039004100390057","9A00",永豐金-市政,0,5,5,-1,3.79
"20231004","1783","0038003800340043","8840",玉山-南京東路,4,0,4,1,3.03
"20231004","1783","9800","9800",元大證券,0,4,4,-1,3.03
"20231004","1783","5381","5380",第一金-員林,3,0,3,1,2.27
"20231004","1783","8561","8560",新光-台中,0,4,4,-1,3.03
"20231004","1783","0035003800350048","5850",統一-桃園,4,1,3,1,2.27
"20231004","1783","0039003800390044","9800",元大-左營,3,7,4,-1,3.03
"20231004","1783","003700300030004a","7000",兆豐-公益,3,0,3,1,2.27
"20231004","1783","1470","1470",台灣摩根士丹利,0,3,3,-1,2.27
"20231004","1783","0039003100330045","9100",群益金鼎-基隆,4,1,3,1,2.27
"20231004","1783","9204","9200",凱基-台中,0,3,3,-1,2.27
"20231004","1783","0035003900320041","5920",元富-緯城,2,0,2,1,1.52
"20231004","1783","003900410039004e","9A00",永豐金-桃盛,0,3,3,-1,2.27
"20231004","1783","003500320036004b","5260",美好-富順,4,2,2,1,1.52
"20231004","1783","1560","1560",港商野村,1,3,2,-1,1.52
"20231004","1783","9349","9300",華南永昌-板橋,2,0,2,1,1.52
"20231004","1783","9853","9800",元大-南屯,0,2,2,-1,1.52
"20231004","1783","0039003800300064","9800",元大-沙鹿,2,0,2,1,1.52
"20231004","1783","9874","9800",元大-雙和,0,2,2,-1,1.52
"20231005","1783","6161","6160",中國信託-三重,10,0,10,1,16.39
"20231005","1783","9363","9300",華南永昌-彰化,0,6,6,-1,9.84
"20231005","1783","1480","1480",美商高盛,5,0,5,1,8.20
"20231005","1783","1440","1440",美林,0,5,5,-1,8.20
"20231005","1783","0039003800320042","9800",元大-博愛,4,0,4,1,6.56
"20231005","1783","0039003800310042","9800",元大-竹北,0,5,5,-1,8.20
"20231005","1783","1560","1560",港商野村,3,0,3,1,4.92
"20231005","1783","1650","1650",新加坡商瑞銀,1,5,4,-1,6.56
"20231005","1783","0039003800300077","9800",元大-西屯,2,0,2,1,3.28
"20231005","1783","9211","9200",凱基-台南,0,4,4,-1,6.56
"20231005","1783","0035003300380044","5380",第一金-忠孝,2,0,2,1,3.28
"20231005","1783","1470","1470",台灣摩根士丹利,0,2,2,-1,3.28
"20231005","1783","0037003000300043","7000",兆豐-來福,2,0,2,1,3.28
"20231005","1783","8560","8560",新光,0,2,2,-1,3.28
"20231005","1783","0039003600310043","9600",富邦-南京,2,0,2,1,3.28
"20231005","1783","8848","8840",玉山-嘉義,0,2,2,-1,3.28
"20231005","1783","9869","9800",元大-新盛,2,0,2,1,3.28
"20231005","1783","0039003800310061","9800",元大-歸仁,0,2,2,-1,3.28
"20231005","1783","0035003300380045","5380",第一金-自由,1,0,1,1,1.64
"20231005","1783","9800","9800",元大證券,0,1,1,-1,1.64
"20231005","1783","5320","5320",高橋,1,0,1,1,1.64
"20231005","1783","5925","5920",元富-台中,0,1,1,-1,1.64
"20231005","1783","7791","7790",國票-台東,1,0,1,1,1.64
"20231005","1783","003700370039006a","7790",國票-和平,0,1,1,-1,1.64
"20231005","1783","7797","7790",國票-中正,1,0,1,1,1.64
"20231005","1783","8157","8150",台新-左楠,0,1,1,-1,1.64
"20231005","1783","8440","8440",摩根大通,2,1,1,1,1.64
"20231005","1783","9817","9800",元大-東泰,0,1,1,-1,1.64
"20231006","1783","9268","9200",凱基-台北,28,3,25,1,8.87
"20231006","1783","6160","6160",中國信託,0,17,17,-1,6.03
"20231006","1783","1650","1650",新加坡商瑞銀,21,2,19,1,6.74
"20231006","1783","6464","6460",大昌-新店,0,10,10,-1,3.55
"20231006","1783","1560","1560",港商野村,17,1,16,1,5.67
"20231006","1783","9838","9800",元大-豐原,0,8,8,-1,2.84
"20231006","1783","8150","8150",台新證券,11,0,11,1,3.90
"20231006","1783","9871","9800",元大-忠孝,0,6,6,-1,2.13
"20231006","1783","1440","1440",美林,17,7,10,1,3.55
"20231006","1783","0039003800310079","9800",元大-善化,0,6,6,-1,2.13
"20231006","1783","9308","9300",華南永昌-麻豆,10,0,10,1,3.55
"20231006","1783","0035003900320072","5920",元富-城東,0,5,5,-1,1.77
"20231006","1783","6110","6110",台中銀,10,2,8,1,2.84
"20231006","1783","6463","6460",大昌-新竹,0,5,5,-1,1.77
"20231006","1783","9208","9200",凱基-桃園,6,0,6,1,2.13
"20231006","1783","6950","6950",福勝,0,5,5,-1,1.77
"20231006","1783","8440","8440",摩根大通,13,8,5,1,1.77
"20231006","1783","0035003800350063","5850",統一-仁愛,0,4,4,-1,1.42
"20231006","1783","9875","9800",元大-土城永寧,4,0,4,1,1.42
"20231006","1783","003800380038004b","8880",國泰-板橋,0,4,4,-1,1.42
"20231006","1783","0031003200360051","1260",宏遠-高雄,3,0,3,1,1.06
"20231006","1783","9209","9200",凱基-岡山,0,4,4,-1,1.42
"20231006","1783","8151","8150",台新-建北,3,0,3,1,1.06
"20231006","1783","9255","9200",凱基-和平,0,4,4,-1,1.42
"20231006","1783","0039003800310071","9800",元大-萬華,3,0,3,1,1.06
"20231006","1783","9315","9300",華南永昌-大甲,0,4,4,-1,1.42
"20231006","1783","0039004100390062","9A00",永豐金-虎尾,3,0,3,1,1.06
"20231006","1783","9834","9800",元大-中壢,0,4,4,-1,1.42
"20231011","1783","5922","5920",元富-新店,26,0,26,1,2.17
"20231011","1783","1650","1650",新加坡商瑞銀,11,108,97,-1,8.09
"20231011","1783","7006","7000",兆豐-台南,20,0,20,1,1.67
"20231011","1783","0031003000330046","1030",土銀-南港,3,95,92,-1,7.67
"20231011","1783","0039003800300043","9800",元大-斗六,17,0,17,1,1.42
"20231011","1783","0039003800310079","9800",元大-善化,16,75,59,-1,4.92
"20231011","1783","0039003800320042","9800",元大-博愛,17,0,17,1,1.42
"20231011","1783","9268","9200",凱基-台北,51,102,51,-1,4.25
"20231011","1783","9188","9100",群益金鼎-三民,20,5,15,1,1.25
"20231011","1783","5850","5850",統一,0,50,50,-1,4.17
"20231011","1783","9872","9800",元大-復北,15,1,14,1,1.17
"20231011","1783","6168","6160",中國信託-嘉義,0,40,40,-1,3.34
"20231011","1783","0035003800350063","5850",統一-仁愛,12,0,12,1,1.00
"20231011","1783","0039003800330066","9800",元大-竹東,0,40,40,-1,3.34
"20231011","1783","0039003800310067","9800",元大-大里,11,0,11,1,0.92
"20231011","1783","1440","1440",美林,20,54,34,-1,2.84
"20231011","1783","0035003900320072","5920",元富-城東,12,2,10,1,0.83
"20231011","1783","1480","1480",美商高盛,13,42,29,-1,2.42
"20231011","1783","7032","7030",致和-佳里,10,0,10,1,0.83
"20231011","1783","1470","1470",台灣摩根士丹利,0,27,27,-1,2.25
"20231011","1783","8849","8840",玉山-景美,16,6,10,1,0.83
"20231011","1783","7007","7000",兆豐-竹北,5,30,25,-1,2.09
"20231011","1783","9315","9300",華南永昌-大甲,10,0,10,1,0.83
"20231011","1783","0031003000320043","1020",合庫-自強,0,16,16,-1,1.33
"20231011","1783","9614","9600",富邦-基隆,10,0,10,1,0.83
"20231011","1783","1560","1560",港商野村,0,13,13,-1,1.08
"20231011","1783","0039003800300061","9800",元大-承德,10,0,10,1,0.83
"20231011","1783","003900380031004c","9800",元大-莒光,1,14,13,-1,1.08
"20231012","1783","8882","8880",國泰-台中,14,0,14,1,2.00
"20231012","1783","1045","1040",臺銀-新竹,2,52,50,-1,7.15
"20231012","1783","003900380039006a","9800",元大-樹林,12,0,12,1,1.72
"20231012","1783","9657","9600",富邦-苗栗,0,49,49,-1,7.01
"20231012","1783","7034","7030",致和-金華,12,0,12,1,1.72
"20231012","1783","1480","1480",美商高盛,2,33,31,-1,4.43
"20231012","1783","9898","9800",元大-新莊,11,0,11,1,1.57
"20231012","1783","1650","1650",新加坡商瑞銀,22,52,30,-1,4.29
"20231012","1783","0039003800390045","9800",元大-草屯,11,0,11,1,1.57
"20231012","1783","5384","5380",第一金-台南,0,20,20,-1,2.86
"20231012","1783","9800","9800",元大證券,19,8,11,1,1.57
"20231012","1783","1470","1470",台灣摩根士丹利,0,14,14,-1,2.00
"20231012","1783","9661","9600",富邦-新店,10,0,10,1,1.43
"20231012","1783","9229","9200",凱基-中山,0,14,14,-1,2.00
"20231012","1783","9658","9600",富邦-建國,10,0,10,1,1.43
"20231012","1783","1440","1440",美林,13,24,11,-1,1.57
"20231012","1783","6161","6160",中國信託-三重,10,0,10,1,1.43
"20231012","1783","0035003900320063","5920",元富-烏日,0,10,10,-1,1.43
"20231012","1783","8711","8710",陽信-石牌,10,0,10,1,1.43
"20231012","1783","9812","9800",元大-台中,0,10,10,-1,1.43
"20231012","1783","9667","9600",富邦-台南,10,0,10,1,1.43
"20231012","1783","003900410039006a","9A00",永豐金-嘉義,0,10,10,-1,1.43
"20231012","1783","5261","5260",美好-蘆洲,9,0,9,1,1.29
"20231012","1783","9300","9300",華南永昌,1,9,8,-1,1.14
"20231012","1783","5386","5380",第一金-彰化,9,0,9,1,1.29
"20231012","1783","9872","9800",元大-復北,3,11,8,-1,1.14
"20231012","1783","8440","8440",摩根大通,8,0,8,1,1.14
"20231012","1783","9233","9200",凱基-長庚,0,7,7,-1,1.00
"20231013","1783","9285","9200",凱基-中壢,20,0,20,1,4.46
"20231013","1783","9268","9200",凱基-台北,12,44,32,-1,7.14
"20231013","1783","5386","5380",第一金-彰化,11,0,11,1,2.46
"20231013","1783","1470","1470",台灣摩根士丹利,0,23,23,-1,5.13
"20231013","1783","0038003400350045","8450",康和-澎湖,11,0,11,1,2.46
"20231013","1783","1560","1560",港商野村,0,12,12,-1,2.68
"20231013","1783","7006","7000",兆豐-台南,10,0,10,1,2.23
"20231013","1783","9278","9200",凱基-永康,0,10,10,-1,2.23
"20231013","1783","8560","8560",新光,12,2,10,1,2.23
"20231013","1783","0039003600310043","9600",富邦-南京,0,10,10,-1,2.23
"20231013","1783","0039003800390057","9800",元大-豐原站前,9,0,9,1,2.01
"20231013","1783","1440","1440",美林,7,16,9,-1,2.01
"20231013","1783","0039003800310065","9800",元大-佳里,8,0,8,1,1.79
"20231013","1783","003900410039004d","9A00",永豐金-南投,1,10,9,-1,2.01
"20231013","1783","003900380039004c","9800",元大-成功,20,12,8,1,1.79
"20231013","1783","0039004100390041","9A00",永豐金-羅東,0,8,8,-1,1.79
"20231013","1783","8846","8840",玉山-板橋,6,0,6,1,1.34
"20231013","1783","8563","8560",新光-新竹,1,9,8,-1,1.79
"20231013","1783","9322","9300",華南永昌-公誠,6,0,6,1,1.34
"20231013","1783","5262","5260",美好-楊梅,1,8,7,-1,1.56
"20231013","1783","003900380039006a","9800",元大-樹林,5,0,5,1,1.12
"20231013","1783","0035003300380045","5380",第一金-自由,0,7,7,-1,1.56
"20231013","1783","6161","6160",中國信託-三重,5,0,5,1,1.12
"20231013","1783","8440","8440",摩根大通,1,8,7,-1,1.56
"20231013","1783","7007","7000",兆豐-竹北,5,0,5,1,1.12
"20231013","1783","8882","8880",國泰-台中,1,8,7,-1,1.56
"20231013","1783","0039003100380063","9100",群益金鼎-鳳山,5,0,5,1,1.12
"20231013","1783","9256","9200",凱基-南崁,0,6,6,-1,1.34
"20231016","1783","1480","1480",美商高盛,37,2,35,1,4.11
"20231016","1783","0031003000340041","1040",臺銀-臺中,0,162,162,-1,19.01
"20231016","1783","7006","7000",兆豐-台南,20,0,20,1,2.35
"20231016","1783","6380","6380",光和,1,21,20,-1,2.35
"20231016","1783","0039004100360039","9A00",永豐金-屏東,20,0,20,1,2.35
"20231016","1783","9692","9600",富邦-嘉義,0,20,20,-1,2.35
"20231016","1783","5922","5920",元富-新店,17,0,17,1,2.00
"20231016","1783","1470","1470",台灣摩根士丹利,0,19,19,-1,2.23
"20231016","1783","1440","1440",美林,20,4,16,1,1.88
"20231016","1783","6464","6460",大昌-新店,1,20,19,-1,2.23
"20231016","1783","6161","6160",中國信託-三重,16,0,16,1,1.88
"20231016","1783","9655","9600",富邦-板橋,4,17,13,-1,1.53
"20231016","1783","003900380031006d","9800",元大-前金,15,0,15,1,1.76
"20231016","1783","8888","8880",國泰-敦南,5,15,10,-1,1.17
"20231016","1783","7750","7750",北城證券,11,0,11,1,1.29
"20231016","1783","003900380039004e","9800",元大-內湖,5,14,9,-1,1.06
"20231016","1783","003900410039004d","9A00",永豐金-南投,11,0,11,1,1.29
"20231016","1783","9268","9200",凱基-台北,22,30,8,-1,0.94
"20231016","1783","5382","5380",第一金-台中,10,0,10,1,1.17
"20231016","1783","0037003000300064","7000",兆豐-彰化,0,7,7,-1,0.82
"20231016","1783","9872","9800",元大-復北,15,5,10,1,1.17
"20231016","1783","0038003100350041","8150",台新-高雄,2,9,7,-1,0.82
"20231016","1783","0039004100390042","9A00",永豐金-中和,10,0,10,1,1.17
"20231016","1783","8580","8580",聯邦商銀,0,7,7,-1,0.82
"20231016","1783","0038003400350045","8450",康和-澎湖,9,0,9,1,1.06
"20231016","1783","0031003200360069","1260",宏遠-光隆,0,6,6,-1,0.70
"20231016","1783","5923","5920",元富-三重,8,0,8,1,0.94
"20231016","1783","5380","5380",第一金,0,6,6,-1,0.70
"20231017","1783","003900380039006a","9800",元大-樹林,11,0,11,1,4.66
"20231017","1783","1650","1650",新加坡商瑞銀,8,38,30,-1,12.71
"20231017","1783","1440","1440",美林,24,14,10,1,4.24
"20231017","1783","8440","8440",摩根大通,1,19,18,-1,7.63
"20231017","1783","6161","6160",中國信託-三重,10,0,10,1,4.24
"20231017","1783","1470","1470",台灣摩根士丹利,0,9,9,-1,3.81
"20231017","1783","1570","1570",港商法國興業,8,0,8,1,3.39
"20231017","1783","6380","6380",光和,0,8,8,-1,3.39
"20231017","1783","7032","7030",致和-佳里,5,0,5,1,2.12
"20231017","1783","1042","1040",臺銀-臺南,0,5,5,-1,2.12
"20231017","1783","8840","8840",玉山證券,5,0,5,1,2.12
"20231017","1783","7007","7000",兆豐-竹北,0,5,5,-1,2.12
"20231017","1783","0039004100390066","9A00",永豐金-中盛,5,0,5,1,2.12
"20231017","1783","9853","9800",元大-南屯,0,5,5,-1,2.12
"20231017","1783","9302","9300",華南永昌-台中,5,0,5,1,2.12
"20231017","1783","003900320030004e","9200",凱基-湖口,1,5,4,-1,1.69
"20231017","1783","7003","7000",兆豐-台中,4,0,4,1,1.69
"20231017","1783","1560","1560",港商野村,3,5,2,-1,0.85
"20231017","1783","6383","6380",光和-和美,3,0,3,1,1.27
"20231017","1783","0035003900320069","5920",元富-中港,0,2,2,-1,0.85
"20231017","1783","8380","8380",安泰,3,0,3,1,1.27
"20231017","1783","0036003100310041","6110",台中銀-豐原,0,2,2,-1,0.85
"20231017","1783","8586","8580",聯邦-大業,3,0,3,1,1.27
"20231017","1783","0037003000300069","7000",兆豐-松德,0,2,2,-1,0.85
"20231017","1783","0039003200300041","9200",凱基-板橋,3,0,3,1,1.27
"20231017","1783","8150","8150",台新證券,14,16,2,-1,0.85
"20231017","1783","9322","9300",華南永昌-公誠,3,0,3,1,1.27
"20231017","1783","9255","9200",凱基-和平,0,2,2,-1,0.85
"20231018","1783","0037003000300066","7000",兆豐-鹿港,20,0,20,1,8.89
"20231018","1783","9838","9800",元大-豐原,0,20,20,-1,8.89
"20231018","1783","0037003000300072","7000",兆豐-寶成,13,0,13,1,5.78
"20231018","1783","8440","8440",摩根大通,0,11,11,-1,4.89
"20231018","1783","1480","1480",美商高盛,12,1,11,1,4.89
"20231018","1783","9136","9100",群益金鼎-西松,0,9,9,-1,4.00
"20231018","1783","6161","6160",中國信託-三重,15,5,10,1,4.44
"20231018","1783","0035003900320062","5920",元富-板橋,0,8,8,-1,3.56
"20231018","1783","0039003800320041","9800",元大-羅東,8,0,8,1,3.56
"20231018","1783","5860","5860",盈溢,0,6,6,-1,2.67
"20231018","1783","1440","1440",美林,9,2,7,1,3.11
"20231018","1783","0039003800310047","9800",元大-彰化,0,6,6,-1,2.67
"20231018","1783","9333","9300",華南永昌-長虹,6,0,6,1,2.67
"20231018","1783","0035003300380044","5380",第一金-忠孝,0,4,4,-1,1.78
"20231018","1783","7006","7000",兆豐-台南,5,0,5,1,2.22
"20231018","1783","1470","1470",台灣摩根士丹利,2,6,4,-1,1.78
"20231018","1783","8888","8880",國泰-敦南,6,1,5,1,2.22
"20231018","1783","6163","6160",中國信託-永康,0,4,4,-1,1.78
"20231018","1783","9813","9800",元大-八德,5,0,5,1,2.22
"20231018","1783","0037003000300068","7000",兆豐-三民,0,4,4,-1,1.78
"20231018","1783","003900380039004a","9800",元大-彰化民生,5,0,5,1,2.22
"20231018","1783","0037003700390050","7790",國票-九鼎,0,4,4,-1,1.78
"20231018","1783","9800","9800",元大證券,7,3,4,1,1.78
"20231018","1783","0035003900320049","5920",元富-嘉義,0,3,3,-1,1.33
"20231018","1783","0035003900320069","5920",元富-中港,4,0,4,1,1.78
"20231018","1783","0035003900320057","5920",元富-吉利,0,3,3,-1,1.33
"20231018","1783","9658","9600",富邦-建國,3,0,3,1,1.33
"20231018","1783","7005","7000",兆豐-台中港,0,3,3,-1,1.33
"20231019","1783","9235","9200",凱基-永華,10,0,10,1,6.17
"20231019","1783","8150","8150",台新證券,0,11,11,-1,6.79
"20231019","1783","9268","9200",凱基-台北,11,1,10,1,6.17
"20231019","1783","003900410039004d","9A00",永豐金-南投,0,11,11,-1,6.79
"20231019","1783","1440","1440",美林,11,5,6,1,3.70
"20231019","1783","1560","1560",港商野村,0,9,9,-1,5.56
"20231019","1783","9856","9800",元大-花蓮,6,0,6,1,3.70
"20231019","1783","0035003300380045","5380",第一金-自由,0,6,6,-1,3.70
"20231019","1783","6161","6160",中國信託-三重,5,0,5,1,3.09
"20231019","1783","0035003900320069","5920",元富-中港,0,6,6,-1,3.70
"20231019","1783","9136","9100",群益金鼎-西松,5,0,5,1,3.09
"20231019","1783","9302","9300",華南永昌-台中,1,6,5,-1,3.09
"20231019","1783","9837","9800",元大-北港,5,0,5,1,3.09
"20231019","1783","1470","1470",台灣摩根士丹利,0,5,5,-1,3.09
"20231019","1783","1480","1480",美商高盛,4,0,4,1,2.47
"20231019","1783","9386","9300",華南永昌-東昇,0,4,4,-1,2.47
"20231019","1783","9665","9600",富邦-桃園,5,1,4,1,2.47
"20231019","1783","003900380039004c","9800",元大-成功,0,4,4,-1,2.47
"20231019","1783","8843","8840",玉山-高雄,3,0,3,1,1.85
"20231019","1783","0035003900320057","5920",元富-吉利,0,3,3,-1,1.85
"20231019","1783","0039003200310053","9200",凱基-幸福,3,0,3,1,1.85
"20231019","1783","003700370039005a","7790",國票-安和,0,3,3,-1,1.85
"20231019","1783","9225","9200",凱基-內埔,3,0,3,1,1.85
"20231019","1783","9223","9200",凱基-豐中,0,3,3,-1,1.85
"20231019","1783","9814","9800",元大-大益,3,0,3,1,1.85
"20231019","1783","9859","9800",元大-新竹經國,0,3,3,-1,1.85
"20231019","1783","0031003000340043","1040",臺銀-高雄,2,0,2,1,1.23
"20231019","1783","0035003300380044","5380",第一金-忠孝,0,2,2,-1,1.23
"20231020","1783","9891","9800",元大-永和,20,1,19,1,11.24
"20231020","1783","8888","8880",國泰-敦南,0,15,15,-1,8.88
"20231020","1783","0031003000320046","1020",合庫-西台中,8,0,8,1,4.73
"20231020","1783","1650","1650",新加坡商瑞銀,6,19,13,-1,7.69
"20231020","1783","0037003000300077","7000",兆豐-新莊,5,0,5,1,2.96
"20231020","1783","8586","8580",聯邦-大業,0,10,10,-1,5.92
"20231020","1783","0039003800300068","9800",元大-台北,5,0,5,1,2.96
"20231020","1783","8440","8440",摩根大通,1,10,9,-1,5.33
"20231020","1783","9871","9800",元大-忠孝,3,0,3,1,1.78
"20231020","1783","003500380035004a","5850",統一-三重,0,5,5,-1,2.96
"20231020","1783","1560","1560",港商野村,5,2,3,1,1.78
"20231020","1783","1470","1470",台灣摩根士丹利,0,4,4,-1,2.37
"20231020","1783","0035003900320077","5920",元富-佳里,3,0,3,1,1.78
"20231020","1783","9627","9600",富邦-內湖,0,3,3,-1,1.78
"20231020","1783","9300","9300",華南永昌,2,0,2,1,1.18
"20231020","1783","1440","1440",美林,12,15,3,-1,1.78
"20231020","1783","0035003800350048","5850",統一-桃園,2,0,2,1,1.18
"20231020","1783","1480","1480",美商高盛,0,3,3,-1,1.78
"20231020","1783","8843","8840",玉山-高雄,4,2,2,1,1.18
"20231020","1783","1590","1590",花旗環球,0,3,3,-1,1.78
"20231020","1783","0039003800310079","9800",元大-善化,2,0,2,1,1.18
"20231020","1783","7007","7000",兆豐-竹北,2,5,3,-1,1.78
"20231020","1783","0039003800320041","9800",元大-羅東,2,0,2,1,1.18
"20231020","1783","8849","8840",玉山-景美,0,3,3,-1,1.78
"20231020","1783","0039003800390067","9800",元大-嘉義,2,0,2,1,1.18
"20231020","1783","9858","9800",元大-龍潭,0,3,3,-1,1.78
"20231020","1783","0039004100380039","9A00",永豐金-敦北,2,0,2,1,1.18
"20231020","1783","0035003300380059","5380",第一金-中壢,0,2,2,-1,1.18
"20231023","1783","1650","1650",新加坡商瑞銀,14,6,8,1,7.02
"20231023","1783","6380","6380",光和,0,15,15,-1,13.16
"20231023","1783","9872","9800",元大-復北,7,0,7,1,6.14
"20231023","1783","0038003400350041","8450",康和-內湖,0,3,3,-1,2.63
"20231023","1783","1560","1560",港商野村,4,0,4,1,3.51
"20231023","1783","9647","9600",富邦-新竹,0,3,3,-1,2.63
"20231023","1783","1480","1480",美商高盛,5,2,3,1,2.63
"20231023","1783","1028","1020",合庫-彰化,0,2,2,-1,1.75
"20231023","1783","5854","5850",統一-城中,3,0,3,1,2.63
"20231023","1783","0037003700390050","7790",國票-九鼎,0,2,2,-1,1.75
"20231023","1783","8150","8150",台新證券,3,0,3,1,2.63
"20231023","1783","9239","9200",凱基-市政,0,2,2,-1,1.75
"20231023","1783","9136","9100",群益金鼎-西松,3,0,3,1,2.63
"20231023","1783","0039003600320045","9600",富邦-樹林,0,2,2,-1,1.75
"20231023","1783","2184","2180",亞東-新竹,2,0,2,1,1.75
"20231023","1783","9666","9600",富邦-南屯,0,2,2,-1,1.75
"20231023","1783","003700370039006d","7790",國票-中港,2,0,2,1,1.75
"20231023","1783","003900380031004e","9800",元大-金門,0,2,2,-1,1.75
"20231023","1783","8440","8440",摩根大通,2,0,2,1,1.75
"20231023","1783","0039003800390065","9800",元大-中和,0,2,2,-1,1.75
"20231023","1783","0038003400350045","8450",康和-澎湖,2,0,2,1,1.75
"20231023","1783","9813","9800",元大-八德,0,1,1,-1,0.88
"20231023","1783","9215","9200",凱基-高美館,2,0,2,1,1.75
"20231023","1783","1590","1590",花旗環球,0,1,1,-1,0.88
"20231023","1783","9658","9600",富邦-建國,2,0,2,1,1.75
"20231023","1783","1440","1440",美林,5,6,1,-1,0.88
"20231023","1783","9852","9800",元大-永春,2,0,2,1,1.75
"20231023","1783","1045","1040",臺銀-新竹,0,1,1,-1,0.88
"20231024","1783","003500390032005a","5920",元富-安南,10,0,10,1,6.80
"20231024","1783","9838","9800",元大-豐原,0,15,15,-1,10.20
"20231024","1783","9186","9100",群益金鼎-新竹,8,0,8,1,5.44
"20231024","1783","0039003800390057","9800",元大-豐原站前,0,9,9,-1,6.12
"20231024","1783","0037003700390065","7790",國票-南科,4,0,4,1,2.72
"20231024","1783","1261","1260",宏遠-民生,0,7,7,-1,4.76
"20231024","1783","9856","9800",元大-花蓮,3,0,3,1,2.04
"20231024","1783","6380","6380",光和,0,6,6,-1,4.08
"20231024","1783","0035003800350045","5850",統一-新營,3,0,3,1,2.04
"20231024","1783","1650","1650",新加坡商瑞銀,4,9,5,-1,3.40
"20231024","1783","1480","1480",美商高盛,3,0,3,1,2.04
"20231024","1783","1560","1560",港商野村,0,3,3,-1,2.04
"20231024","1783","7005","7000",兆豐-台中港,3,0,3,1,2.04
"20231024","1783","0039003600310043","9600",富邦-南京,1,4,3,-1,2.04
"20231024","1783","9647","9600",富邦-新竹,3,0,3,1,2.04
"20231024","1783","5853","5850",統一-中壢,1,3,2,-1,1.36
"20231024","1783","9661","9600",富邦-新店,3,0,3,1,2.04
"20231024","1783","1040","1040",臺銀,0,2,2,-1,1.36
"20231024","1783","003900410039004d","9A00",永豐金-南投,3,0,3,1,2.04
"20231024","1783","1028","1020",合庫-彰化,0,2,2,-1,1.36
"20231024","1783","1022","1020",合庫-台南,2,0,2,1,1.36
"20231024","1783","1020","1020",合庫證券,0,2,2,-1,1.36
"20231024","1783","003700300030005a","7000",兆豐-高雄,2,0,2,1,1.36
"20231024","1783","0035003900320050","5920",元富-同大,0,2,2,-1,1.36
"20231024","1783","8840","8840",玉山證券,2,0,2,1,1.36
"20231024","1783","0037003700390050","7790",國票-九鼎,0,2,2,-1,1.36
"20231024","1783","8843","8840",玉山-高雄,2,0,2,1,1.36
"20231024","1783","8440","8440",摩根大通,0,2,2,-1,1.36
"20231025","1783","1440","1440",美林,8,2,6,1,6.59
"20231025","1783","9856","9800",元大-花蓮,0,8,8,-1,8.79
"20231025","1783","9268","9200",凱基-台北,6,0,6,1,6.59
"20231025","1783","7007","7000",兆豐-竹北,0,5,5,-1,5.49
"20231025","1783","8440","8440",摩根大通,5,0,5,1,5.49
"20231025","1783","0037003000300077","7000",兆豐-新莊,0,5,5,-1,5.49
"20231025","1783","9814","9800",元大-大益,5,0,5,1,5.49
"20231025","1783","0039003800300068","9800",元大-台北,0,5,5,-1,5.49
"20231025","1783","9862","9800",元大-南京,5,0,5,1,5.49
"20231025","1783","1480","1480",美商高盛,1,4,3,-1,3.30
"20231025","1783","1650","1650",新加坡商瑞銀,6,2,4,1,4.40
"20231025","1783","003900410039004d","9A00",永豐金-南投,0,3,3,-1,3.30
"20231025","1783","8843","8840",玉山-高雄,4,0,4,1,4.40
"20231025","1783","0035003900320069","5920",元富-中港,0,2,2,-1,2.20
"20231025","1783","003900380031006d","9800",元大-前金,4,0,4,1,4.40
"20231025","1783","003700300030005a","7000",兆豐-高雄,0,2,2,-1,2.20
"20231025","1783","5260","5260",美好,3,0,3,1,3.30
"20231025","1783","0039003600310043","9600",富邦-南京,0,2,2,-1,2.20
"20231025","1783","0035003900320041","5920",元富-緯城,2,0,2,1,2.20
"20231025","1783","0039003800310056","9800",元大-民雄,0,2,2,-1,2.20
"20231025","1783","1560","1560",港商野村,2,0,2,1,2.20
"20231025","1783","0039003800310079","9800",元大-善化,0,2,2,-1,2.20
"20231025","1783","0039003200300048","9200",凱基-基隆,2,0,2,1,2.20
"20231025","1783","9852","9800",元大-永春,0,2,2,-1,2.20
"20231025","1783","0039003600320041","9600",富邦-信義,2,0,2,1,2.20
"20231025","1783","0039003800380043","9800",元大-三重,0,2,2,-1,2.20
"20231025","1783","0035003300380045","5380",第一金-自由,1,0,1,1,1.10
"20231025","1783","1029","1020",合庫-鳳山,0,1,1,-1,1.10
"20231026","1783","9856","9800",元大-花蓮,7,0,7,1,5.65
"20231026","1783","1650","1650",新加坡商瑞銀,1,19,18,-1,14.52
"20231026","1783","003900380039006a","9800",元大-樹林,5,0,5,1,4.03
"20231026","1783","9268","9200",凱基-台北,3,16,13,-1,10.48
"20231026","1783","6383","6380",光和-和美,5,0,5,1,4.03
"20231026","1783","1480","1480",美商高盛,0,5,5,-1,4.03
"20231026","1783","0038003100350041","8150",台新-高雄,5,0,5,1,4.03
"20231026","1783","0037003000300077","7000",兆豐-新莊,0,5,5,-1,4.03
"20231026","1783","003900380031006d","9800",元大-前金,5,0,5,1,4.03
"20231026","1783","0039003800390044","9800",元大-左營,0,5,5,-1,4.03
"20231026","1783","0039003800320041","9800",元大-羅東,5,0,5,1,4.03
"20231026","1783","9800","9800",元大證券,1,5,4,-1,3.23
"20231026","1783","9831","9800",元大-四維,5,0,5,1,4.03
"20231026","1783","0037003700390065","7790",國票-南科,0,3,3,-1,2.42
"20231026","1783","003900380033004b","9800",元大-學甲,5,0,5,1,4.03
"20231026","1783","9322","9300",華南永昌-公誠,0,3,3,-1,2.42
"20231026","1783","0039003800310043","9800",元大-路竹,4,0,4,1,3.23
"20231026","1783","9814","9800",元大-大益,0,3,3,-1,2.42
"20231026","1783","8843","8840",玉山-高雄,3,0,3,1,2.42
"20231026","1783","1590","1590",花旗環球,0,2,2,-1,1.61
"20231026","1783","8849","8840",玉山-景美,3,0,3,1,2.42
"20231026","1783","8560","8560",新光,0,2,2,-1,1.61
"20231026","1783","0038003800340043","8840",玉山-南京東路,2,0,2,1,1.61
"20231026","1783","9305","9300",華南永昌-新莊,0,2,2,-1,1.61
"20231026","1783","8884","8880",國泰-台南,2,0,2,1,1.61
"20231026","1783","9898","9800",元大-新莊,0,2,2,-1,1.61
"20231026","1783","0039003100330045","9100",群益金鼎-基隆,2,0,2,1,1.61
"20231026","1783","0035003900320063","5920",元富-烏日,0,1,1,-1,0.81
"20231027","1783","0039004100390063","9A00",永豐金-永康,20,0,20,1,3.72
"20231027","1783","0035003800350063","5850",統一-仁愛,0,23,23,-1,4.28
"20231027","1783","8440","8440",摩根大通,23,9,14,1,2.61
"20231027","1783","9867","9800",元大-北成功,0,23,23,-1,4.28
"20231027","1783","0037003700390065","7790",國票-南科,13,0,13,1,2.42
"20231027","1783","003900380031006d","9800",元大-前金,0,21,21,-1,3.91
"20231027","1783","8158","8150",台新-松江,12,0,12,1,2.23
"20231027","1783","1560","1560",港商野村,10,25,15,-1,2.79
"20231027","1783","0037003000300055","7000",兆豐-桃鶯,10,0,10,1,1.86
"20231027","1783","8843","8840",玉山-高雄,6,21,15,-1,2.79
"20231027","1783","0039003800390045","9800",元大-草屯,6,0,6,1,1.12
"20231027","1783","7790","7790",國票證券,0,12,12,-1,2.23
"20231027","1783","5603","5600",永興-台中,6,0,6,1,1.12
"20231027","1783","1480","1480",美商高盛,23,34,11,-1,2.05
"20231027","1783","9676","9600",富邦-仁愛,6,0,6,1,1.12
"20231027","1783","0039003800390044","9800",元大-左營,0,9,9,-1,1.68
"20231027","1783","1025","1020",合庫-基隆,5,0,5,1,0.93
"20231027","1783","9872","9800",元大-復北,1,9,8,-1,1.49
"20231027","1783","5856","5850",統一-台中,5,0,5,1,0.93
"20231027","1783","1440","1440",美林,12,19,7,-1,1.30
"20231027","1783","6165","6160",中國信託-新竹,5,0,5,1,0.93
"20231027","1783","9813","9800",元大-八德,0,7,7,-1,1.30
"20231027","1783","0037003000300046","7000",兆豐-虎尾,7,2,5,1,0.93
"20231027","1783","0039004100390073","9A00",永豐金-彰化,0,6,6,-1,1.12
"20231027","1783","0037003700390076","7790",國票-台中,5,0,5,1,0.93
"20231027","1783","9800","9800",元大證券,2,7,5,-1,0.93
"20231027","1783","003900320030005a","9200",凱基-台東,5,0,5,1,0.93
"20231027","1783","7007","7000",兆豐-竹北,0,5,5,-1,0.93
"20231030","1783","8847","8840",玉山-台南,11,0,11,1,4.23
"20231030","1783","9268","9200",凱基-台北,11,23,12,-1,4.62
"20231030","1783","9297","9200",凱基-文心,10,0,10,1,3.85
"20231030","1783","0039003600310043","9600",富邦-南京,0,10,10,-1,3.85
"20231030","1783","9137","9100",群益金鼎-士林,9,0,9,1,3.46
"20231030","1783","9872","9800",元大-復北,1,11,10,-1,3.85
"20231030","1783","0039003800310042","9800",元大-竹北,9,0,9,1,3.46
"20231030","1783","1560","1560",港商野村,0,8,8,-1,3.08
"20231030","1783","9856","9800",元大-花蓮,8,0,8,1,3.08
"20231030","1783","1480","1480",美商高盛,10,17,7,-1,2.69
"20231030","1783","0039003800320041","9800",元大-羅東,8,0,8,1,3.08
"20231030","1783","8560","8560",新光,0,7,7,-1,2.69
"20231030","1783","8150","8150",台新證券,6,0,6,1,2.31
"20231030","1783","8843","8840",玉山-高雄,0,7,7,-1,2.69
"20231030","1783","9665","9600",富邦-桃園,5,0,5,1,1.92
"20231030","1783","9874","9800",元大-雙和,0,6,6,-1,2.31
"20231030","1783","5260","5260",美好,5,0,5,1,1.92
"20231030","1783","6380","6380",光和,0,5,5,-1,1.92
"20231030","1783","1650","1650",新加坡商瑞銀,14,10,4,1,1.54
"20231030","1783","0037003000300046","7000",兆豐-虎尾,0,5,5,-1,1.92
"20231030","1783","0039004100390044","9A00",永豐金-忠孝,3,0,3,1,1.15
"20231030","1783","003900320030005a","9200",凱基-台東,0,5,5,-1,1.92
"20231030","1783","9667","9600",富邦-台南,3,0,3,1,1.15
"20231030","1783","9897","9800",元大-土城,0,5,5,-1,1.92
"20231030","1783","5603","5600",永興-台中,3,0,3,1,1.15
"20231030","1783","0039003800390042","9800",元大-台中中港,0,4,4,-1,1.54
"20231030","1783","003700300030004c","7000",兆豐-天母,3,0,3,1,1.15
"20231030","1783","0035003800350063","5850",統一-仁愛,0,3,3,-1,1.15
"20231031","1783","1570","1570",港商法國興業,8,0,8,1,3.07
"20231031","1783","0035003900320072","5920",元富-城東,0,15,15,-1,5.75
"20231031","1783","1470","1470",台灣摩根士丹利,7,0,7,1,2.68
"20231031","1783","6110","6110",台中銀,0,10,10,-1,3.83
"20231031","1783","9647","9600",富邦-新竹,7,0,7,1,2.68
"20231031","1783","0037003000300055","7000",兆豐-桃鶯,0,10,10,-1,3.83
"20231031","1783","0039003800310079","9800",元大-善化,7,0,7,1,2.68
"20231031","1783","9297","9200",凱基-文心,0,10,10,-1,3.83
"20231031","1783","9813","9800",元大-八德,12,6,6,1,2.30
"20231031","1783","9856","9800",元大-花蓮,0,10,10,-1,3.83
"20231031","1783","1480","1480",美商高盛,7,2,5,1,1.92
"20231031","1783","0039003200310053","9200",凱基-幸福,0,8,8,-1,3.07
"20231031","1783","1022","1020",合庫-台南,5,0,5,1,1.92
"20231031","1783","8847","8840",玉山-台南,1,7,6,-1,2.30
"20231031","1783","0039003600310058","9600",富邦-大墩,5,0,5,1,1.92
"20231031","1783","6380","6380",光和,0,5,5,-1,1.92
"20231031","1783","003900380039006a","9800",元大-樹林,5,0,5,1,1.92
"20231031","1783","7009","7000",兆豐-景美,3,8,5,-1,1.92
"20231031","1783","0039004100390073","9A00",永豐金-彰化,5,0,5,1,1.92
"20231031","1783","9322","9300",華南永昌-公誠,0,5,5,-1,1.92
"20231031","1783","1560","1560",港商野村,8,4,4,1,1.53
"20231031","1783","003900380031006e","9800",元大-旗山,0,5,5,-1,1.92
"20231031","1783","5380","5380",第一金,4,0,4,1,1.53
"20231031","1783","0039003800310071","9800",元大-萬華,0,5,5,-1,1.92
"20231031","1783","0039003100380067","9100",群益金鼎-大甲,3,0,3,1,1.15
"20231031","1783","003700300030004c","7000",兆豐-天母,5,9,4,-1,1.53
"20231031","1783","0039003100380057","9100",群益金鼎-忠孝,3,0,3,1,1.15
"20231031","1783","9268","9200",凱基-台北,19,22,3,-1,1.15
"20231101","1783","003900380039004a","9800",元大-彰化民生,10,0,10,1,8.70
"20231101","1783","7007","7000",兆豐-竹北,0,18,18,-1,15.65
"20231101","1783","1440","1440",美林,15,6,9,1,7.83
"20231101","1783","0035003900320075","5920",元富-世貿,0,7,7,-1,6.09
"20231101","1783","5921","5920",元富-高雄,10,1,9,1,7.83
"20231101","1783","1650","1650",新加坡商瑞銀,3,10,7,-1,6.09
"20231101","1783","1480","1480",美商高盛,4,0,4,1,3.48
"20231101","1783","5320","5320",高橋,0,4,4,-1,3.48
"20231101","1783","1470","1470",台灣摩根士丹利,3,0,3,1,2.61
"20231101","1783","5262","5260",美好-楊梅,0,4,4,-1,3.48
"20231101","1783","0037003700390065","7790",國票-南科,3,0,3,1,2.61
"20231101","1783","003900380034004b","9800",元大-館前,0,4,4,-1,3.48
"20231101","1783","9814","9800",元大-大益,3,0,3,1,2.61
"20231101","1783","5260","5260",美好,0,3,3,-1,2.61
"20231101","1783","003900380031004e","9800",元大-金門,3,0,3,1,2.61
"20231101","1783","5322","5320",高橋-中壢,0,3,3,-1,2.61
"20231101","1783","8156","8150",台新-三民,2,0,2,1,1.74
"20231101","1783","8150","8150",台新證券,0,2,2,-1,1.74
"20231101","1783","9665","9600",富邦-桃園,2,0,2,1,1.74
"20231101","1783","8847","8840",玉山-台南,0,2,2,-1,1.74
"20231101","1783","9667","9600",富邦-台南,2,0,2,1,1.74
"20231101","1783","9189","9100",群益金鼎-桃園,0,2,2,-1,1.74
"20231101","1783","9831","9800",元大-四維,1,0,1,1,0.87
"20231101","1783","9672","9600",富邦-員林,0,2,2,-1,1.74
"20231101","1783","7003","7000",兆豐-台中,1,0,1,1,0.87
"20231101","1783","9856","9800",元大-花蓮,0,2,2,-1,1.74
"20231101","1783","7750","7750",北城證券,1,0,1,1,0.87
"20231101","1783","0039003800380042","9800",元大-桃園,0,1,1,-1,0.87
"20231102","1783","0039004100300030","9A00",永豐金證券,11,0,11,1,12.64
"20231102","1783","7009","7000",兆豐-景美,0,5,5,-1,5.75
"20231102","1783","1480","1480",美商高盛,6,1,5,1,5.75
"20231102","1783","9676","9600",富邦-仁愛,0,5,5,-1,5.75
"20231102","1783","1590","1590",花旗環球,5,0,5,1,5.75
"20231102","1783","1650","1650",新加坡商瑞銀,1,5,4,-1,4.60
"20231102","1783","9268","9200",凱基-台北,6,1,5,1,5.75
"20231102","1783","8843","8840",玉山-高雄,0,4,4,-1,4.60
"20231102","1783","5856","5850",統一-台中,4,0,4,1,4.60
"20231102","1783","9884","9800",元大-斗信,0,4,4,-1,4.60
"20231102","1783","0038003100350041","8150",台新-高雄,2,0,2,1,2.30
"20231102","1783","0039003600310058","9600",富邦-大墩,0,3,3,-1,3.45
"20231102","1783","0039003200310045","9200",凱基-三峽,2,0,2,1,2.30
"20231102","1783","1022","1020",合庫-台南,0,2,2,-1,2.30
"20231102","1783","003900360032004b","9600",富邦-中和,2,0,2,1,2.30
"20231102","1783","003900380031006d","9800",元大-前金,0,2,2,-1,2.30
"20231102","1783","9812","9800",元大-台中,4,2,2,1,2.30
"20231102","1783","1045","1040",臺銀-新竹,0,1,1,-1,1.15
"20231102","1783","0039003800380056","9800",元大-長庚,2,0,2,1,2.30
"20231102","1783","0031003200360069","1260",宏遠-光隆,0,1,1,-1,1.15
"20231102","1783","1560","1560",港商野村,1,0,1,1,1.15
"20231102","1783","0035003900320049","5920",元富-嘉義,0,1,1,-1,1.15
"20231102","1783","1029","1020",合庫-鳳山,1,0,1,1,1.15
"20231102","1783","6161","6160",中國信託-三重,0,1,1,-1,1.15
"20231102","1783","0035003900320076","5920",元富-桃園,1,0,1,1,1.15
"20231102","1783","6380","6380",光和,0,1,1,-1,1.15
"20231102","1783","003500390032005a","5920",元富-安南,1,0,1,1,1.15
"20231102","1783","003700300030004b","7000",兆豐-新營,0,1,1,-1,1.15
"20231103","1783","0039003800390044","9800",元大-左營,4,0,4,1,4.76
"20231103","1783","7007","7000",兆豐-竹北,0,5,5,-1,5.95
"20231103","1783","1480","1480",美商高盛,3,0,3,1,3.57
"20231103","1783","8440","8440",摩根大通,1,6,5,-1,5.95
"20231103","1783","1470","1470",台灣摩根士丹利,5,2,3,1,3.57
"20231103","1783","9812","9800",元大-台中,0,4,4,-1,4.76
"20231103","1783","8560","8560",新光,3,1,2,1,2.38
"20231103","1783","1440","1440",美林,1,4,3,-1,3.57
"20231103","1783","9202","9200",凱基-中港,2,0,2,1,2.38
"20231103","1783","8881","8880",國泰-高雄,0,3,3,-1,3.57
"20231103","1783","0039003600310052","9600",富邦-南員林,2,0,2,1,2.38
"20231103","1783","003800380038004b","8880",國泰-板橋,0,2,2,-1,2.38
"20231103","1783","9852","9800",元大-永春,2,0,2,1,2.38
"20231103","1783","1650","1650",新加坡商瑞銀,3,5,2,-1,2.38
"20231103","1783","9868","9800",元大-文心,2,0,2,1,2.38
"20231103","1783","9131","9100",群益金鼎-民權,0,2,2,-1,2.38
"20231103","1783","0039004100390071","9A00",永豐金-潮州,2,0,2,1,2.38
"20231103","1783","0039003100380041","9100",群益金鼎-中壢,0,2,2,-1,2.38
"20231103","1783","0039004100390078","9A00",永豐金-桃園,2,0,2,1,2.38
"20231103","1783","9333","9300",華南永昌-長虹,0,2,2,-1,2.38
"20231103","1783","9667","9600",富邦-台南,2,0,2,1,2.38
"20231103","1783","9657","9600",富邦-苗栗,0,2,2,-1,2.38
"20231103","1783","6463","6460",大昌-新竹,1,0,1,1,1.19
"20231103","1783","0039003800310079","9800",元大-善化,0,2,2,-1,2.38
"20231103","1783","0035003900320057","5920",元富-吉利,1,0,1,1,1.19
"20231103","1783","9899","9800",元大-淡水,0,2,2,-1,2.38
"20231103","1783","5852","5850",統一-敦南,1,0,1,1,1.19
"20231103","1783","6167","6160",中國信託-松江,0,1,1,-1,1.19
"20231106","1783","1560","1560",港商野村,12,0,12,1,10.34
"20231106","1783","0039004100300030","9A00",永豐金證券,0,7,7,-1,6.03
"20231106","1783","1480","1480",美商高盛,11,0,11,1,9.48
"20231106","1783","9862","9800",元大-南京,0,6,6,-1,5.17
"20231106","1783","1470","1470",台灣摩根士丹利,9,2,7,1,6.03
"20231106","1783","0035003900320047","5920",元富-新竹,0,5,5,-1,4.31
"20231106","1783","8440","8440",摩根大通,5,0,5,1,4.31
"20231106","1783","0039003800310079","9800",元大-善化,0,5,5,-1,4.31
"20231106","1783","1021","1020",合庫-台中,4,0,4,1,3.45
"20231106","1783","003900380031007a","9800",元大-大統,0,5,5,-1,4.31
"20231106","1783","1650","1650",新加坡商瑞銀,6,2,4,1,3.45
"20231106","1783","0039004100390057","9A00",永豐金-市政,0,4,4,-1,3.45
"20231106","1783","0039003800310068","9800",元大-屏東民生,3,0,3,1,2.59
"20231106","1783","8150","8150",台新證券,0,4,4,-1,3.45
"20231106","1783","9239","9200",凱基-市政,2,0,2,1,1.72
"20231106","1783","0039003800390044","9800",元大-左營,1,5,4,-1,3.45
"20231106","1783","1440","1440",美林,6,4,2,1,1.72
"20231106","1783","7007","7000",兆豐-竹北,0,3,3,-1,2.59
"20231106","1783","0038003100350059","8150",台新-新營,2,0,2,1,1.72
"20231106","1783","0035003300380050","5380",第一金-路竹,0,2,2,-1,1.72
"20231106","1783","0038003400350046","8450",康和-仁愛,2,0,2,1,1.72
"20231106","1783","5389","5380",第一金-中山,0,2,2,-1,1.72
"20231106","1783","8560","8560",新光,10,8,2,1,1.72
"20231106","1783","6381","6380",光和-溪湖,0,2,2,-1,1.72
"20231106","1783","9333","9300",華南永昌-長虹,3,1,2,1,1.72
"20231106","1783","0037003700390045","7790",國票-南崁,0,2,2,-1,1.72
"20231106","1783","9623","9600",富邦-台北,2,0,2,1,1.72
"20231106","1783","0038003800340046","8840",玉山-桃園,0,2,2,-1,1.72
"20231107","1783","9349","9300",華南永昌-板橋,10,0,10,1,6.71
"20231107","1783","5381","5380",第一金-員林,0,13,13,-1,8.72
"20231107","1783","8847","8840",玉山-台南,10,1,9,1,6.04
"20231107","1783","9268","9200",凱基-台北,1,8,7,-1,4.70
"20231107","1783","1650","1650",新加坡商瑞銀,14,8,6,1,4.03
"20231107","1783","9813","9800",元大-八德,0,6,6,-1,4.03
"20231107","1783","0038003100350059","8150",台新-新營,6,0,6,1,4.03
"20231107","1783","1440","1440",美林,2,7,5,-1,3.36
"20231107","1783","1031","1030",土銀-台中,5,0,5,1,3.36
"20231107","1783","1560","1560",港商野村,1,6,5,-1,3.36
"20231107","1783","0035003900320048","5920",元富-信義,4,0,4,1,2.68
"20231107","1783","9108","9100",群益金鼎-海山,0,4,4,-1,2.68
"20231107","1783","003900320031004a","9200",凱基-土城,4,0,4,1,2.68
"20231107","1783","0039003800390044","9800",元大-左營,0,4,4,-1,2.68
"20231107","1783","0039003800310045","9800",元大-發財,3,0,3,1,2.01
"20231107","1783","0039004100300030","9A00",永豐金證券,0,4,4,-1,2.68
"20231107","1783","0031003000330046","1030",土銀-南港,2,0,2,1,1.34
"20231107","1783","8560","8560",新光,2,5,3,-1,2.01
"20231107","1783","1036","1030",土銀-玉里,2,0,2,1,1.34
"20231107","1783","9665","9600",富邦-桃園,0,3,3,-1,2.01
"20231107","1783","0031003000340041","1040",臺銀-臺中,2,0,2,1,1.34
"20231107","1783","9692","9600",富邦-嘉義,0,3,3,-1,2.01
"20231107","1783","8380","8380",安泰,2,0,2,1,1.34
"20231107","1783","9837","9800",元大-北港,2,5,3,-1,2.01
"20231107","1783","8440","8440",摩根大通,4,2,2,1,1.34
"20231107","1783","5385","5380",第一金-桃園,0,2,2,-1,1.34
"20231107","1783","9377","9300",華南永昌-虎尾,2,0,2,1,1.34
"20231107","1783","2184","2180",亞東-新竹,0,2,2,-1,1.34
"20231108","1783","1650","1650",新加坡商瑞銀,12,0,12,1,7.79
"20231108","1783","0035003800350063","5850",統一-仁愛,0,7,7,-1,4.55
"20231108","1783","0037003700390050","7790",國票-九鼎,11,0,11,1,7.14
"20231108","1783","7032","7030",致和-佳里,0,7,7,-1,4.55
"20231108","1783","8440","8440",摩根大通,11,2,9,1,5.84
"20231108","1783","0039003800310079","9800",元大-善化,1,6,5,-1,3.25
"20231108","1783","9268","9200",凱基-台北,13,6,7,1,4.55
"20231108","1783","003900380039004a","9800",元大-彰化民生,0,5,5,-1,3.25
"20231108","1783","1560","1560",港商野村,6,0,6,1,3.90
"20231108","1783","0039004100370039","9A00",永豐金-埔里,0,5,5,-1,3.25
"20231108","1783","1470","1470",台灣摩根士丹利,7,1,6,1,3.90
"20231108","1783","1022","1020",合庫-台南,0,4,4,-1,2.60
"20231108","1783","0037003700390065","7790",國票-南科,4,0,4,1,2.60
"20231108","1783","5856","5850",統一-台中,0,4,4,-1,2.60
"20231108","1783","0031003000330042","1030",土銀-彰化,3,0,3,1,1.95
"20231108","1783","0035003900320045","5920",元富-城中,0,4,4,-1,2.60
"20231108","1783","0035003300380046","5380",第一金-大稻埕,3,0,3,1,1.95
"20231108","1783","6110","6110",台中銀,0,4,4,-1,2.60
"20231108","1783","0035003900320062","5920",元富-板橋,3,0,3,1,1.95
"20231108","1783","003900320031004a","9200",凱基-土城,0,4,4,-1,2.60
"20231108","1783","9867","9800",元大-北成功,3,0,3,1,1.95
"20231108","1783","7007","7000",兆豐-竹北,0,3,3,-1,1.95
"20231108","1783","1440","1440",美林,16,14,2,1,1.30
"20231108","1783","8848","8840",玉山-嘉義,0,3,3,-1,1.95
"20231108","1783","6381","6380",光和-溪湖,2,0,2,1,1.30
"20231108","1783","0039004100390048","9A00",永豐金-新莊,2,5,3,-1,1.95
"20231108","1783","0038003100350059","8150",台新-新營,4,2,2,1,1.30
"20231108","1783","9667","9600",富邦-台南,0,2,2,-1,1.30
"20231109","1783","9884","9800",元大-斗信,13,0,13,1,2.53
"20231109","1783","1440","1440",美林,7,47,40,-1,7.80
"20231109","1783","8560","8560",新光,17,5,12,1,2.34
"20231109","1783","9268","9200",凱基-台北,9,46,37,-1,7.21
"20231109","1783","9867","9800",元大-北成功,15,3,12,1,2.34
"20231109","1783","8440","8440",摩根大通,11,47,36,-1,7.02
"20231109","1783","0039003100380067","9100",群益金鼎-大甲,11,0,11,1,2.14
"20231109","1783","1480","1480",美商高盛,0,24,24,-1,4.68
"20231109","1783","0035003800350059","5850",統一-土城,10,0,10,1,1.95
"20231109","1783","0031003000330046","1030",土銀-南港,0,22,22,-1,4.29
"20231109","1783","8711","8710",陽信-石牌,10,0,10,1,1.95
"20231109","1783","8847","8840",玉山-台南,1,19,18,-1,3.51
"20231109","1783","003900380039004a","9800",元大-彰化民生,10,0,10,1,1.95
"20231109","1783","1560","1560",港商野村,1,18,17,-1,3.31
"20231109","1783","9324","9300",華南永昌-岡山,8,0,8,1,1.56
"20231109","1783","0039004100390057","9A00",永豐金-市政,1,12,11,-1,2.14
"20231109","1783","9813","9800",元大-八德,8,0,8,1,1.56
"20231109","1783","0037003700390050","7790",國票-九鼎,0,11,11,-1,2.14
"20231109","1783","0031003000340041","1040",臺銀-臺中,6,0,6,1,1.17
"20231109","1783","0037003700390044","7790",國票-台南,1,11,10,-1,1.95
"20231109","1783","9663","9600",富邦-敦南,6,0,6,1,1.17
"20231109","1783","0039003800310042","9800",元大-竹北,0,9,9,-1,1.75
"20231109","1783","9831","9800",元大-四維,6,0,6,1,1.17
"20231109","1783","1470","1470",台灣摩根士丹利,0,7,7,-1,1.36
"20231109","1783","1031","1030",土銀-台中,5,0,5,1,0.97
"20231109","1783","5265","5260",美好-苗栗,0,6,6,-1,1.17
"20231109","1783","5321","5320",高橋-龍潭,5,0,5,1,0.97
"20231109","1783","9676","9600",富邦-仁愛,0,6,6,-1,1.17
"20231110","1783","0031003000340041","1040",臺銀-臺中,11,0,11,1,5.91
"20231110","1783","1650","1650",新加坡商瑞銀,4,23,19,-1,10.22
"20231110","1783","0039003100380069","9100",群益金鼎-竹南,10,0,10,1,5.38
"20231110","1783","9869","9800",元大-新盛,0,12,12,-1,6.45
"20231110","1783","9268","9200",凱基-台北,15,9,6,1,3.23
"20231110","1783","1560","1560",港商野村,0,10,10,-1,5.38
"20231110","1783","8560","8560",新光,5,0,5,1,2.69
"20231110","1783","9884","9800",元大-斗信,0,10,10,-1,5.38
"20231110","1783","0039003100380064","9100",群益金鼎-內湖,5,0,5,1,2.69
"20231110","1783","1440","1440",美林,2,10,8,-1,4.30
"20231110","1783","0039003600310046","9600",富邦-中港,5,0,5,1,2.69
"20231110","1783","9647","9600",富邦-新竹,0,7,7,-1,3.76
"20231110","1783","0039003800310079","9800",元大-善化,6,1,5,1,2.69
"20231110","1783","8150","8150",台新證券,0,6,6,-1,3.23
"20231110","1783","0039003800390049","9800",元大-蘆洲中正,5,0,5,1,2.69
"20231110","1783","8847","8840",玉山-台南,0,6,6,-1,3.23
"20231110","1783","9623","9600",富邦-台北,4,0,4,1,2.15
"20231110","1783","003900360031004e","9600",富邦-西壢,0,6,6,-1,3.23
"20231110","1783","5921","5920",元富-高雄,3,0,3,1,1.61
"20231110","1783","0039004100390073","9A00",永豐金-彰化,0,5,5,-1,2.69
"20231110","1783","0035003900320077","5920",元富-佳里,3,0,3,1,1.61
"20231110","1783","1470","1470",台灣摩根士丹利,0,4,4,-1,2.15
"20231110","1783","003700300030005a","7000",兆豐-高雄,3,0,3,1,1.61
"20231110","1783","8849","8840",玉山-景美,0,4,4,-1,2.15
"20231110","1783","9327","9300",華南永昌-斗六,3,0,3,1,1.61
"20231110","1783","9867","9800",元大-北成功,0,4,4,-1,2.15
"20231110","1783","003900380033005a","9800",元大-鳳山,3,0,3,1,1.61
"20231110","1783","5384","5380",第一金-台南,0,3,3,-1,1.61
"20231113","1783","0035003300380045","5380",第一金-自由,10,0,10,1,13.16
"20231113","1783","0039003800380042","9800",元大-桃園,0,7,7,-1,9.21
"20231113","1783","003600310036004b","6160",中國信託-高雄,3,0,3,1,3.95
"20231113","1783","1650","1650",新加坡商瑞銀,2,8,6,-1,7.89
"20231113","1783","1480","1480",美商高盛,3,0,3,1,3.95
"20231113","1783","1560","1560",港商野村,0,5,5,-1,6.58
"20231113","1783","9268","9200",凱基-台北,6,3,3,1,3.95
"20231113","1783","9604","9600",富邦-陽明,0,4,4,-1,5.26
"20231113","1783","003900360031005a","9600",富邦-永康,4,1,3,1,3.95
"20231113","1783","5921","5920",元富-高雄,0,3,3,-1,3.95
"20231113","1783","0031003000340041","1040",臺銀-臺中,2,0,2,1,2.63
"20231113","1783","0035003900320048","5920",元富-信義,0,2,2,-1,2.63
"20231113","1783","0039003100330052","9100",群益金鼎-北高雄,2,0,2,1,2.63
"20231113","1783","5320","5320",高橋,0,2,2,-1,2.63
"20231113","1783","9202","9200",凱基-中港,2,0,2,1,2.63
"20231113","1783","0037003000300050","7000",兆豐-南京,0,2,2,-1,2.63
"20231113","1783","9332","9300",華南永昌-楠梓,2,0,2,1,2.63
"20231113","1783","7032","7030",致和-佳里,0,2,2,-1,2.63
"20231113","1783","6163","6160",中國信託-永康,1,0,1,1,1.32
"20231113","1783","0039003800310068","9800",元大-屏東民生,0,2,2,-1,2.63
"20231113","1783","0031003000320045","1020",合庫-桃園,1,0,1,1,1.32
"20231113","1783","003900380039004c","9800",元大-成功,0,2,2,-1,2.63
"20231113","1783","1470","1470",台灣摩根士丹利,1,0,1,1,1.32
"20231113","1783","6210","6210",新百王,0,1,1,-1,1.32
"20231113","1783","0037003700390045","7790",國票-南崁,1,0,1,1,1.32
"20231113","1783","0036003000310064","6010",(牛牛牛)亞-鑫豐,1,2,1,-1,1.32
"20231113","1783","0038003100350041","8150",台新-高雄,1,0,1,1,1.32
"20231113","1783","6461","6460",大昌-樹林,0,1,1,-1,1.32
"20231114","1783","0031003100310046","1110",台灣企銀-北高雄,10,0,10,1,3.58
"20231114","1783","8150","8150",台新證券,0,43,43,-1,15.41
"20231114","1783","8711","8710",陽信-石牌,10,0,10,1,3.58
"20231114","1783","0039004100390057","9A00",永豐金-市政,0,20,20,-1,7.17
"20231114","1783","0039003800320042","9800",元大-博愛,9,0,9,1,3.23
"20231114","1783","003900360032004b","9600",富邦-中和,0,18,18,-1,6.45
"20231114","1783","1480","1480",美商高盛,13,5,8,1,2.87
"20231114","1783","9268","9200",凱基-台北,11,22,11,-1,3.94
"20231114","1783","7032","7030",致和-佳里,7,0,7,1,2.51
"20231114","1783","0035003300380045","5380",第一金-自由,0,10,10,-1,3.58
"20231114","1783","8849","8840",玉山-景美,6,0,6,1,2.15
"20231114","1783","9322","9300",華南永昌-公誠,1,10,9,-1,3.23
"20231114","1783","1022","1020",合庫-台南,5,0,5,1,1.79
"20231114","1783","1440","1440",美林,2,9,7,-1,2.51
"20231114","1783","6161","6160",中國信託-三重,5,0,5,1,1.79
"20231114","1783","0038003400350058","8450",康和-屏東,0,5,5,-1,1.79
"20231114","1783","9136","9100",群益金鼎-西松,5,0,5,1,1.79
"20231114","1783","9869","9800",元大-新盛,0,5,5,-1,1.79
"20231114","1783","9302","9300",華南永昌-台中,5,0,5,1,1.79
"20231114","1783","8440","8440",摩根大通,1,5,4,-1,1.43
"20231114","1783","9309","9300",華南永昌-古亭,6,1,5,1,1.79
"20231114","1783","1560","1560",港商野村,6,9,3,-1,1.08
"20231114","1783","8882","8880",國泰-台中,4,0,4,1,1.43
"20231114","1783","8584","8580",聯邦-雙和,0,3,3,-1,1.08
"20231114","1783","8560","8560",新光,4,0,4,1,1.43
"20231114","1783","9377","9300",華南永昌-虎尾,0,3,3,-1,1.08
"20231114","1783","0035003900320072","5920",元富-城東,4,0,4,1,1.43
"20231114","1783","003900380031004c","9800",元大-莒光,0,3,3,-1,1.08
"20231115","1783","6380","6380",光和,22,0,22,1,14.57
"20231115","1783","8150","8150",台新證券,0,30,30,-1,19.87
"20231115","1783","1650","1650",新加坡商瑞銀,13,2,11,1,7.28
"20231115","1783","8846","8840",玉山-板橋,0,5,5,-1,3.31
"20231115","1783","1440","1440",美林,8,0,8,1,5.30
"20231115","1783","5381","5380",第一金-員林,0,4,4,-1,2.65
"20231115","1783","8440","8440",摩根大通,8,0,8,1,5.30
"20231115","1783","003900310038004b","9100",群益金鼎-東湖,0,3,3,-1,1.99
"20231115","1783","9800","9800",元大證券,7,0,7,1,4.64
"20231115","1783","9692","9600",富邦-嘉義,0,3,3,-1,1.99
"20231115","1783","1470","1470",台灣摩根士丹利,9,2,7,1,4.64
"20231115","1783","9815","9800",元大-大灣,0,3,3,-1,1.99
"20231115","1783","1480","1480",美商高盛,5,0,5,1,3.31
"20231115","1783","0035003900320069","5920",元富-中港,0,2,2,-1,1.32
"20231115","1783","0039004100390059","9A00",永豐金-板盛,5,0,5,1,3.31
"20231115","1783","7032","7030",致和-佳里,0,2,2,-1,1.32
"20231115","1783","0031003000340041","1040",臺銀-臺中,3,0,3,1,1.99
"20231115","1783","7797","7790",國票-中正,0,2,2,-1,1.32
"20231115","1783","0038003400350045","8450",康和-澎湖,3,0,3,1,1.99
"20231115","1783","8380","8380",安泰,0,2,2,-1,1.32
"20231115","1783","0031003000340043","1040",臺銀-高雄,2,0,2,1,1.32
"20231115","1783","9211","9200",凱基-台南,0,2,2,-1,1.32
"20231115","1783","8843","8840",玉山-高雄,2,0,2,1,1.32
"20231115","1783","9272","9200",凱基-竹科,0,2,2,-1,1.32
"20231115","1783","9225","9200",凱基-內埔,2,0,2,1,1.32
"20231115","1783","9359","9300",華南永昌-中正,0,2,2,-1,1.32
"20231115","1783","9328","9300",華南永昌-潮州,2,0,2,1,1.32
"20231115","1783","9817","9800",元大-東泰,0,2,2,-1,1.32
"20231116","1783","9268","9200",凱基-台北,20,5,15,1,12.71
"20231116","1783","003900380039004c","9800",元大-成功,0,27,27,-1,22.88
"20231116","1783","1440","1440",美林,12,1,11,1,9.32
"20231116","1783","0035003900320047","5920",元富-新竹,0,7,7,-1,5.93
"20231116","1783","1560","1560",港商野村,7,0,7,1,5.93
"20231116","1783","8849","8840",玉山-景美,0,7,7,-1,5.93
"20231116","1783","1470","1470",台灣摩根士丹利,7,0,7,1,5.93
"20231116","1783","7798","7790",國票-內壢,0,4,4,-1,3.39
"20231116","1783","1590","1590",花旗環球,5,0,5,1,4.24
"20231116","1783","003500320036004b","5260",美好-富順,0,1,1,-1,0.85
"20231116","1783","8440","8440",摩根大通,3,0,3,1,2.54
"20231116","1783","0035003900320048","5920",元富-信義,0,1,1,-1,0.85
"20231116","1783","9319","9300",華南永昌-鶯歌,3,0,3,1,2.54
"20231116","1783","0036003000310064","6010",(牛牛牛)亞-鑫豐,0,1,1,-1,0.85
"20231116","1783","0039003800310065","9800",元大-佳里,3,0,3,1,2.54
"20231116","1783","6380","6380",光和,0,1,1,-1,0.85
"20231116","1783","5269","5260",美好-台中,2,0,2,1,1.69
"20231116","1783","8158","8150",台新-松江,0,1,1,-1,0.85
"20231116","1783","003500330038004e","5380",第一金-豐原,2,0,2,1,1.69
"20231116","1783","8159","8150",台新-台南,0,1,1,-1,0.85
"20231116","1783","0037003700390072","7790",國票-桃園,2,0,2,1,1.69
"20231116","1783","8380","8380",安泰,0,1,1,-1,0.85
"20231116","1783","0038003800340042","8840",玉山-台中,2,0,2,1,1.69
"20231116","1783","003800380034004a","8840",玉山-大里,0,1,1,-1,0.85
"20231116","1783","0039003600310058","9600",富邦-大墩,2,0,2,1,1.69
"20231116","1783","9189","9100",群益金鼎-桃園,0,1,1,-1,0.85
"20231116","1783","0039003800390044","9800",元大-左營,2,0,2,1,1.69
"20231116","1783","9323","9300",華南永昌-小港,0,1,1,-1,0.85
"20231117","1783","9268","9200",凱基-台北,19,1,18,1,9.38
"20231117","1783","6380","6380",光和,5,20,15,-1,7.81
"20231117","1783","8440","8440",摩根大通,15,0,15,1,7.81
"20231117","1783","8150","8150",台新證券,0,8,8,-1,4.17
"20231117","1783","1480","1480",美商高盛,13,0,13,1,6.77
"20231117","1783","8560","8560",新光,0,7,7,-1,3.65
"20231117","1783","1440","1440",美林,10,1,9,1,4.69
"20231117","1783","0039003100380044","9100",群益金鼎-東門,0,5,5,-1,2.60
"20231117","1783","0035003800350063","5850",統一-仁愛,9,0,9,1,4.69
"20231117","1783","0039004100390059","9A00",永豐金-板盛,0,5,5,-1,2.60
"20231117","1783","0035003900320045","5920",元富-城中,6,0,6,1,3.13
"20231117","1783","8882","8880",國泰-台中,0,4,4,-1,2.08
"20231117","1783","0039003600310058","9600",富邦-大墩,7,1,6,1,3.13
"20231117","1783","0037003000300063","7000",兆豐-民生,0,4,4,-1,2.08
"20231117","1783","9831","9800",元大-四維,5,0,5,1,2.60
"20231117","1783","0039003200310059","9200",凱基-東勢,0,4,4,-1,2.08
"20231117","1783","0038003800380041","8880",國泰-館前,5,0,5,1,2.60
"20231117","1783","9815","9800",元大-大灣,0,4,4,-1,2.08
"20231117","1783","9326","9300",華南永昌-南京,4,0,4,1,2.08
"20231117","1783","9871","9800",元大-忠孝,1,4,3,-1,1.56
"20231117","1783","1560","1560",港商野村,3,0,3,1,1.56
"20231117","1783","0035003900320050","5920",元富-同大,0,3,3,-1,1.56
"20231117","1783","1470","1470",台灣摩根士丹利,3,0,3,1,1.56
"20231117","1783","003700300030004c","7000",兆豐-天母,0,3,3,-1,1.56
"20231117","1783","0039003200300046","9200",凱基-站前,3,0,3,1,1.56
"20231117","1783","8158","8150",台新-松江,0,3,3,-1,1.56
"20231117","1783","5380","5380",第一金,2,0,2,1,1.04
"20231117","1783","003900380039004c","9800",元大-成功,0,3,3,-1,1.56
"20231120","1783","0039003600310043","9600",富邦-南京,40,0,40,1,9.80
"20231120","1783","8711","8710",陽信-石牌,0,22,22,-1,5.39
"20231120","1783","0031003000340041","1040",臺銀-臺中,28,0,28,1,6.86
"20231120","1783","7007","7000",兆豐-竹北,0,17,17,-1,4.17
"20231120","1783","1560","1560",港商野村,21,4,17,1,4.17
"20231120","1783","0039003800310061","9800",元大-歸仁,0,15,15,-1,3.68
"20231120","1783","9636","9600",富邦-中壢,15,0,15,1,3.68
"20231120","1783","0039003200300047","9200",凱基-彰化,0,11,11,-1,2.70
"20231120","1783","1440","1440",美林,24,10,14,1,3.43
"20231120","1783","8440","8440",摩根大通,12,22,10,-1,2.45
"20231120","1783","8847","8840",玉山-台南,11,1,10,1,2.45
"20231120","1783","1031","1030",土銀-台中,0,10,10,-1,2.45
"20231120","1783","0039004100390047","9A00",永豐金-天母,10,0,10,1,2.45
"20231120","1783","8158","8150",台新-松江,0,10,10,-1,2.45
"20231120","1783","9898","9800",元大-新莊,10,1,9,1,2.21
"20231120","1783","9255","9200",凱基-和平,0,6,6,-1,1.47
"20231120","1783","9874","9800",元大-雙和,7,0,7,1,1.72
"20231120","1783","0035003900320045","5920",元富-城中,0,6,6,-1,1.47
"20231120","1783","9667","9600",富邦-台南,7,0,7,1,1.72
"20231120","1783","9813","9800",元大-八德,0,6,6,-1,1.47
"20231120","1783","1480","1480",美商高盛,7,1,6,1,1.47
"20231120","1783","0039003100380064","9100",群益金鼎-內湖,0,5,5,-1,1.23
"20231120","1783","9268","9200",凱基-台北,18,13,5,1,1.23
"20231120","1783","8560","8560",新光,1,6,5,-1,1.23
"20231120","1783","0037003700390065","7790",國票-南科,5,0,5,1,1.23
"20231120","1783","0038003800380041","8880",國泰-館前,0,5,5,-1,1.23
"20231120","1783","8459","8450",康和-嘉義,5,0,5,1,1.23
"20231120","1783","0039003100380067","9100",群益金鼎-大甲,0,5,5,-1,1.23
"20231121","1783","9268","9200",凱基-台北,46,23,23,1,6.10
"20231121","1783","0039003600310058","9600",富邦-大墩,1,17,16,-1,4.24
"20231121","1783","0039003100380078","9100",群益金鼎-延平,10,0,10,1,2.65
"20231121","1783","0031003000340041","1040",臺銀-臺中,0,15,15,-1,3.98
"20231121","1783","9874","9800",元大-雙和,9,0,9,1,2.39
"20231121","1783","7007","7000",兆豐-竹北,0,13,13,-1,3.45
"20231121","1783","1480","1480",美商高盛,17,9,8,1,2.12
"20231121","1783","8888","8880",國泰-敦南,7,18,11,-1,2.92
"20231121","1783","0039003800310043","9800",元大-路竹,7,0,7,1,1.86
"20231121","1783","9319","9300",華南永昌-鶯歌,0,10,10,-1,2.65
"20231121","1783","1470","1470",台灣摩根士丹利,6,0,6,1,1.59
"20231121","1783","9256","9200",凱基-南崁,0,7,7,-1,1.86
"20231121","1783","1560","1560",港商野村,8,2,6,1,1.59
"20231121","1783","1440","1440",美林,16,22,6,-1,1.59
"20231121","1783","9273","9200",凱基-竹東,6,0,6,1,1.59
"20231121","1783","1260","1260",宏遠證券,0,5,5,-1,1.33
"20231121","1783","9862","9800",元大-南京,6,0,6,1,1.59
"20231121","1783","0039003200300047","9200",凱基-彰化,0,4,4,-1,1.06
"20231121","1783","6161","6160",中國信託-三重,5,0,5,1,1.33
"20231121","1783","003900380033004d","9800",元大-木柵,0,4,4,-1,1.06
"20231121","1783","003700300030004b","7000",兆豐-新營,5,0,5,1,1.33
"20231121","1783","0035003300380049","5380",第一金-頭份,0,3,3,-1,0.80
"20231121","1783","0039003800310046","9800",元大-福營,5,0,5,1,1.33
"20231121","1783","8841","8840",玉山-雙和,0,3,3,-1,0.80
"20231121","1783","003800380038004b","8880",國泰-板橋,3,0,3,1,0.80
"20231121","1783","9838","9800",元大-豐原,0,3,3,-1,0.80
"20231121","1783","1650","1650",新加坡商瑞銀,29,26,3,1,0.80
"20231121","1783","0039003800390055","9800",元大-大甲,0,3,3,-1,0.80
"20231122","1783","1022","1020",合庫-台南,5,0,5,1,3.25
"20231122","1783","1480","1480",美商高盛,1,14,13,-1,8.44
"20231122","1783","1114","1110",台灣企銀-嘉義,5,0,5,1,3.25
"20231122","1783","1650","1650",新加坡商瑞銀,9,21,12,-1,7.79
"20231122","1783","9817","9800",元大-東泰,5,0,5,1,3.25
"20231122","1783","9268","9200",凱基-台北,0,11,11,-1,7.14
"20231122","1783","9879","9800",元大-板橋三民,5,0,5,1,3.25
"20231122","1783","9300","9300",華南永昌,0,5,5,-1,3.25
"20231122","1783","0039003800310065","9800",元大-佳里,4,0,4,1,2.60
"20231122","1783","0039003800310079","9800",元大-善化,0,4,4,-1,2.60
"20231122","1783","1029","1020",合庫-鳳山,4,0,4,1,2.60
"20231122","1783","1440","1440",美林,11,14,3,-1,1.95
"20231122","1783","0035003900320050","5920",元富-同大,4,0,4,1,2.60
"20231122","1783","003600310036004b","6160",中國信託-高雄,0,3,3,-1,1.95
"20231122","1783","6160","6160",中國信託,3,0,3,1,1.95
"20231122","1783","0039003600310048","9600",富邦-新板,0,3,3,-1,1.95
"20231122","1783","0038003100350041","8150",台新-高雄,3,0,3,1,1.95
"20231122","1783","0039003100330044","9100",群益金鼎-潭子,0,2,2,-1,1.30
"20231122","1783","8440","8440",摩根大通,9,6,3,1,1.95
"20231122","1783","0039003800310043","9800",元大-路竹,0,2,2,-1,1.30
"20231122","1783","8561","8560",新光-台中,2,0,2,1,1.30
"20231122","1783","9888","9800",元大-鑫永和,0,1,1,-1,0.65
"20231122","1783","1024","1020",合庫-嘉義,2,0,2,1,1.30
"20231122","1783","9322","9300",華南永昌-公誠,0,1,1,-1,0.65
"20231122","1783","003500380035004d","5850",統一-士林,2,0,2,1,1.30
"20231122","1783","9899","9800",元大-淡水,0,1,1,-1,0.65
"20231122","1783","9215","9200",凱基-高美館,3,1,2,1,1.30
"20231122","1783","9831","9800",元大-四維,0,1,1,-1,0.65
"20231123","1783","1480","1480",美商高盛,14,0,14,1,6.48
"20231123","1783","8560","8560",新光,1,11,10,-1,4.63
"20231123","1783","9268","9200",凱基-台北,20,6,14,1,6.48
"20231123","1783","8711","8710",陽信-石牌,0,8,8,-1,3.70
"20231123","1783","1470","1470",台灣摩根士丹利,12,0,12,1,5.56
"20231123","1783","5323","5320",高橋-內壢,0,5,5,-1,2.31
"20231123","1783","1440","1440",美林,23,12,11,1,5.09
"20231123","1783","9667","9600",富邦-台南,0,5,5,-1,2.31
"20231123","1783","0039003600360046","9600",富邦-左營,8,0,8,1,3.70
"20231123","1783","003900380039004a","9800",元大-彰化民生,0,5,5,-1,2.31
"20231123","1783","9215","9200",凱基-高美館,6,0,6,1,2.78
"20231123","1783","0039003100330052","9100",群益金鼎-北高雄,0,4,4,-1,1.85
"20231123","1783","5384","5380",第一金-台南,5,0,5,1,2.31
"20231123","1783","9636","9600",富邦-中壢,2,6,4,-1,1.85
"20231123","1783","8847","8840",玉山-台南,6,1,5,1,2.31
"20231123","1783","6380","6380",光和,0,4,4,-1,1.85
"20231123","1783","0038003800380041","8880",國泰-館前,5,0,5,1,2.31
"20231123","1783","7003","7000",兆豐-台中,0,4,4,-1,1.85
"20231123","1783","6161","6160",中國信託-三重,4,0,4,1,1.85
"20231123","1783","9255","9200",凱基-和平,0,4,4,-1,1.85
"20231123","1783","1560","1560",港商野村,9,6,3,1,1.39
"20231123","1783","2181","2180",亞東-板橋,0,3,3,-1,1.39
"20231123","1783","5856","5850",統一-台中,3,0,3,1,1.39
"20231123","1783","7009","7000",兆豐-景美,0,3,3,-1,1.39
"20231123","1783","003700300030004b","7000",兆豐-新營,3,0,3,1,1.39
"20231123","1783","7032","7030",致和-佳里,0,3,3,-1,1.39
"20231123","1783","8440","8440",摩根大通,4,1,3,1,1.39
"20231123","1783","9278","9200",凱基-永康,0,3,3,-1,1.39
"20231124","1783","6161","6160",中國信託-三重,11,0,11,1,7.75
"20231124","1783","1440","1440",美林,0,18,18,-1,12.68
"20231124","1783","9285","9200",凱基-中壢,10,0,10,1,7.04
"20231124","1783","1480","1480",美商高盛,2,17,15,-1,10.56
"20231124","1783","9874","9800",元大-雙和,6,0,6,1,4.23
"20231124","1783","0039003200300048","9200",凱基-基隆,0,13,13,-1,9.15
"20231124","1783","0031003000330041","1030",土銀-建國,5,0,5,1,3.52
"20231124","1783","9268","9200",凱基-台北,4,14,10,-1,7.04
"20231124","1783","9814","9800",元大-大益,5,0,5,1,3.52
"20231124","1783","8440","8440",摩根大通,3,8,5,-1,3.52
"20231124","1783","1650","1650",新加坡商瑞銀,5,2,3,1,2.11
"20231124","1783","0039003800380056","9800",元大-長庚,0,5,5,-1,3.52
"20231124","1783","0037003700390065","7790",國票-南科,3,0,3,1,2.11
"20231124","1783","1560","1560",港商野村,0,3,3,-1,2.11
"20231124","1783","9369","9300",華南永昌-三重,3,0,3,1,2.11
"20231124","1783","0039003600320050","9600",富邦-頭份,0,3,3,-1,2.11
"20231124","1783","0039003600310058","9600",富邦-大墩,3,0,3,1,2.11
"20231124","1783","9604","9600",富邦-陽明,0,2,2,-1,1.41
"20231124","1783","003900360031005a","9600",富邦-永康,4,1,3,1,2.11
"20231124","1783","6165","6160",中國信託-新竹,0,2,2,-1,1.41
"20231124","1783","9647","9600",富邦-新竹,3,0,3,1,2.11
"20231124","1783","0039003100380042","9100",群益金鼎-板橋,0,2,2,-1,1.41
"20231124","1783","5384","5380",第一金-台南,2,0,2,1,1.41
"20231124","1783","9665","9600",富邦-桃園,0,2,2,-1,1.41
"20231124","1783","6450","6450",永全證券,2,0,2,1,1.41
"20231124","1783","9834","9800",元大-中壢,0,2,2,-1,1.41
"20231124","1783","7792","7790",國票-北投,2,0,2,1,1.41
"20231124","1783","0035003900320061","5920",元富-松德,0,2,2,-1,1.41
"20231127","1783","9268","9200",凱基-台北,70,44,26,1,3.55
"20231127","1783","0031003000340041","1040",臺銀-臺中,0,38,38,-1,5.18
"20231127","1783","7033","7030",致和-府前,20,0,20,1,2.73
"20231127","1783","1440","1440",美林,10,39,29,-1,3.96
"20231127","1783","0039003100330052","9100",群益金鼎-北高雄,20,0,20,1,2.73
"20231127","1783","003800380038004b","8880",國泰-板橋,2,25,23,-1,3.14
"20231127","1783","8888","8880",國泰-敦南,19,7,12,1,1.64
"20231127","1783","9309","9300",華南永昌-古亭,0,20,20,-1,2.73
"20231127","1783","9636","9600",富邦-中壢,11,0,11,1,1.50
"20231127","1783","0039003600310043","9600",富邦-南京,1,21,20,-1,2.73
"20231127","1783","5322","5320",高橋-中壢,10,0,10,1,1.36
"20231127","1783","1560","1560",港商野村,16,29,13,-1,1.77
"20231127","1783","8585","8580",聯邦-三重,10,0,10,1,1.36
"20231127","1783","0039003800310079","9800",元大-善化,1,12,11,-1,1.50
"20231127","1783","9285","9200",凱基-中壢,10,0,10,1,1.36
"20231127","1783","0039003800300061","9800",元大-承德,0,10,10,-1,1.36
"20231127","1783","9369","9300",華南永昌-三重,10,0,10,1,1.36
"20231127","1783","9324","9300",華南永昌-岡山,0,8,8,-1,1.09
"20231127","1783","003900380031004b","9800",元大-林園,10,0,10,1,1.36
"20231127","1783","0039003800390042","9800",元大-台中中港,0,8,8,-1,1.09
"20231127","1783","5389","5380",第一金-中山,10,0,10,1,1.36
"20231127","1783","0039003800310043","9800",元大-路竹,0,7,7,-1,0.95
"20231127","1783","0035003300380050","5380",第一金-路竹,8,0,8,1,1.09
"20231127","1783","9800","9800",元大證券,17,22,5,-1,0.68
"20231127","1783","0039003800310046","9800",元大-福營,7,0,7,1,0.95
"20231127","1783","5603","5600",永興-台中,1,6,5,-1,0.68
"20231127","1783","1470","1470",台灣摩根士丹利,6,0,6,1,0.82
"20231127","1783","0037003700390076","7790",國票-台中,0,5,5,-1,0.68
"20231128","1783","8561","8560",新光-台中,10,0,10,1,4.55
"20231128","1783","9888","9800",元大-鑫永和,0,14,14,-1,6.36
"20231128","1783","9326","9300",華南永昌-南京,10,0,10,1,4.55
"20231128","1783","9665","9600",富邦-桃園,1,11,10,-1,4.55
"20231128","1783","1590","1590",花旗環球,5,0,5,1,2.27
"20231128","1783","1650","1650",新加坡商瑞銀,15,25,10,-1,4.55
"20231128","1783","0039003600310058","9600",富邦-大墩,5,0,5,1,2.27
"20231128","1783","1440","1440",美林,2,11,9,-1,4.09
"20231128","1783","9834","9800",元大-中壢,4,0,4,1,1.82
"20231128","1783","1480","1480",美商高盛,0,7,7,-1,3.18
"20231128","1783","5389","5380",第一金-中山,4,0,4,1,1.82
"20231128","1783","6160","6160",中國信託,2,9,7,-1,3.18
"20231128","1783","8156","8150",台新-三民,4,0,4,1,1.82
"20231128","1783","8847","8840",玉山-台南,0,6,6,-1,2.73
"20231128","1783","003900380039004e","9800",元大-內湖,4,0,4,1,1.82
"20231128","1783","0038003800380041","8880",國泰-館前,0,5,5,-1,2.27
"20231128","1783","003500320036004b","5260",美好-富順,4,1,3,1,1.36
"20231128","1783","7001","7000",兆豐-嘉義,0,4,4,-1,1.82
"20231128","1783","5384","5380",第一金-台南,3,0,3,1,1.36
"20231128","1783","8151","8150",台新-建北,0,3,3,-1,1.36
"20231128","1783","0035003900320050","5920",元富-同大,3,0,3,1,1.36
"20231128","1783","0039003600320045","9600",富邦-樹林,0,3,3,-1,1.36
"20231128","1783","6464","6460",大昌-新店,3,0,3,1,1.36
"20231128","1783","0039003600320050","9600",富邦-頭份,0,3,3,-1,1.36
"20231128","1783","0039003100380067","9100",群益金鼎-大甲,3,0,3,1,1.36
"20231128","1783","003900380039004c","9800",元大-成功,0,3,3,-1,1.36
"20231128","1783","9268","9200",凱基-台北,18,15,3,1,1.36
"20231128","1783","6114","6110",台中銀-員林,0,2,2,-1,0.91
"20231129","1783","1480","1480",美商高盛,7,0,7,1,7.95
"20231129","1783","003500320036004b","5260",美好-富順,0,4,4,-1,4.55
"20231129","1783","1650","1650",新加坡商瑞銀,6,2,4,1,4.55
"20231129","1783","7009","7000",兆豐-景美,0,4,4,-1,4.55
"20231129","1783","5383","5380",第一金-高雄,4,0,4,1,4.55
"20231129","1783","7005","7000",兆豐-台中港,0,3,3,-1,3.41
"20231129","1783","003900360031005a","9600",富邦-永康,3,0,3,1,3.41
"20231129","1783","8561","8560",新光-台中,0,3,3,-1,3.41
"20231129","1783","0039003800320043","9800",元大-六合,3,0,3,1,3.41
"20231129","1783","9875","9800",元大-土城永寧,0,3,3,-1,3.41
"20231129","1783","0039003800390041","9800",元大-北投,3,0,3,1,3.41
"20231129","1783","1440","1440",美林,1,3,2,-1,2.27
"20231129","1783","7750","7750",北城證券,2,0,2,1,2.27
"20231129","1783","0031003000330046","1030",土銀-南港,0,2,2,-1,2.27
"20231129","1783","0037003700390058","7790",國票-中和,2,0,2,1,2.27
"20231129","1783","003600310036004b","6160",中國信託-高雄,0,2,2,-1,2.27
"20231129","1783","8840","8840",玉山證券,2,0,2,1,2.27
"20231129","1783","0037003700390072","7790",國票-桃園,0,2,2,-1,2.27
"20231129","1783","9268","9200",凱基-台北,5,3,2,1,2.27
"20231129","1783","0038003400350046","8450",康和-仁愛,0,2,2,-1,2.27
"20231129","1783","0039003600310048","9600",富邦-新板,2,0,2,1,2.27
"20231129","1783","8882","8880",國泰-台中,0,2,2,-1,2.27
"20231129","1783","9623","9600",富邦-台北,2,0,2,1,2.27
"20231129","1783","8885","8880",國泰-桃園,0,2,2,-1,2.27
"20231129","1783","0039003800310079","9800",元大-善化,2,0,2,1,2.27
"20231129","1783","0039003600330041","9600",富邦-八德,0,2,2,-1,2.27
"20231129","1783","0039003800330055","9800",元大-頭份,2,0,2,1,2.27
"20231129","1783","0039003800380056","9800",元大-長庚,0,2,2,-1,2.27
"20231130","1783","9268","9200",凱基-台北,17,6,11,1,8.33
"20231130","1783","9872","9800",元大-復北,0,21,21,-1,15.91
"20231130","1783","0035003300380041","5380",第一金-新興,10,0,10,1,7.58
"20231130","1783","1440","1440",美林,2,14,12,-1,9.09
"20231130","1783","0039004100300030","9A00",永豐金證券,5,0,5,1,3.79
"20231130","1783","9188","9100",群益金鼎-三民,0,11,11,-1,8.33
"20231130","1783","8841","8840",玉山-雙和,4,0,4,1,3.03
"20231130","1783","9647","9600",富邦-新竹,0,8,8,-1,6.06
"20231130","1783","003900360031005a","9600",富邦-永康,4,0,4,1,3.03
"20231130","1783","0039003100380043","9100",群益金鼎-古亭,0,7,7,-1,5.30
"20231130","1783","0039003600310048","9600",富邦-新板,3,0,3,1,2.27
"20231130","1783","1110","1110",台灣企銀,0,3,3,-1,2.27
"20231130","1783","9874","9800",元大-雙和,3,0,3,1,2.27
"20231130","1783","0031003000320045","1020",合庫-桃園,0,2,2,-1,1.52
"20231130","1783","0039003800380042","9800",元大-桃園,3,0,3,1,2.27
"20231130","1783","7005","7000",兆豐-台中港,0,2,2,-1,1.52
"20231130","1783","8888","8880",國泰-敦南,2,0,2,1,1.52
"20231130","1783","0039003800380056","9800",元大-長庚,3,5,2,-1,1.52
"20231130","1783","5862","5860",盈溢-楠梓,2,0,2,1,1.52
"20231130","1783","0031003000320041","1020",合庫-新竹,0,1,1,-1,0.76
"20231130","1783","003700300030005a","7000",兆豐-高雄,2,0,2,1,1.52
"20231130","1783","0031003000340041","1040",臺銀-臺中,1,2,1,-1,0.76
"20231130","1783","8583","8580",聯邦-忠孝,2,0,2,1,1.52
"20231130","1783","0036003100310041","6110",台中銀-豐原,0,1,1,-1,0.76
"20231130","1783","9209","9200",凱基-岡山,2,0,2,1,1.52
"20231130","1783","003700300030004d","7000",兆豐-桃園,0,1,1,-1,0.76
"20231130","1783","9254","9200",凱基-科園,2,0,2,1,1.52
"20231130","1783","0037003700390065","7790",國票-南科,0,1,1,-1,0.76
"20231201","1783","1480","1480",美商高盛,27,2,25,1,8.68
"20231201","1783","5855","5850",統一-台南,0,12,12,-1,4.17
"20231201","1783","9268","9200",凱基-台北,18,0,18,1,6.25
"20231201","1783","0035003900320062","5920",元富-板橋,0,11,11,-1,3.82
"20231201","1783","1560","1560",港商野村,13,0,13,1,4.51
"20231201","1783","9188","9100",群益金鼎-三民,9,20,11,-1,3.82
"20231201","1783","1440","1440",美林,14,6,8,1,2.78
"20231201","1783","003900360031005a","9600",富邦-永康,0,8,8,-1,2.78
"20231201","1783","8440","8440",摩根大通,8,0,8,1,2.78
"20231201","1783","7006","7000",兆豐-台南,0,7,7,-1,2.43
"20231201","1783","9647","9600",富邦-新竹,7,0,7,1,2.43
"20231201","1783","9369","9300",華南永昌-三重,0,7,7,-1,2.43
"20231201","1783","0039003800300065","9800",元大-清水,6,0,6,1,2.08
"20231201","1783","0039003800310045","9800",元大-發財,0,5,5,-1,1.74
"20231201","1783","9202","9200",凱基-中港,5,0,5,1,1.74
"20231201","1783","9817","9800",元大-東泰,0,4,4,-1,1.39
"20231201","1783","1470","1470",台灣摩根士丹利,3,0,3,1,1.04
"20231201","1783","0039003800310079","9800",元大-善化,0,4,4,-1,1.39
"20231201","1783","1036","1030",土銀-玉里,3,0,3,1,1.04
"20231201","1783","9858","9800",元大-龍潭,0,4,4,-1,1.39
"20231201","1783","8846","8840",玉山-板橋,3,0,3,1,1.04
"20231201","1783","6380","6380",光和,0,3,3,-1,1.04
"20231201","1783","0038003800380041","8880",國泰-館前,3,0,3,1,1.04
"20231201","1783","6464","6460",大昌-新店,0,3,3,-1,1.04
"20231201","1783","9134","9100",群益金鼎-開元,3,0,3,1,1.04
"20231201","1783","003700370039006d","7790",國票-中港,0,3,3,-1,1.04
"20231201","1783","5384","5380",第一金-台南,2,0,2,1,0.69
"20231201","1783","8156","8150",台新-三民,1,4,3,-1,1.04
"20231204","1783","8440","8440",摩根大通,21,0,21,1,7.27
"20231204","1783","9188","9100",群益金鼎-三民,0,16,16,-1,5.54
"20231204","1783","1560","1560",港商野村,21,0,21,1,7.27
"20231204","1783","9237","9200",凱基-敦北,0,15,15,-1,5.19
"20231204","1783","1650","1650",新加坡商瑞銀,20,2,18,1,6.23
"20231204","1783","0035003800350063","5850",統一-仁愛,0,12,12,-1,4.15
"20231204","1783","1480","1480",美商高盛,15,0,15,1,5.19
"20231204","1783","0035003900320062","5920",元富-板橋,0,11,11,-1,3.81
"20231204","1783","9268","9200",凱基-台北,18,3,15,1,5.19
"20231204","1783","0039003800310079","9800",元大-善化,0,9,9,-1,3.11
"20231204","1783","9859","9800",元大-新竹經國,11,0,11,1,3.81
"20231204","1783","0039003800310046","9800",元大-福營,0,8,8,-1,2.77
"20231204","1783","5855","5850",統一-台南,10,1,9,1,3.11
"20231204","1783","5853","5850",統一-中壢,0,5,5,-1,1.73
"20231204","1783","003500380035004a","5850",統一-三重,8,0,8,1,2.77
"20231204","1783","5321","5320",高橋-龍潭,0,5,5,-1,1.73
"20231204","1783","0031003000320043","1020",合庫-自強,6,0,6,1,2.08
"20231204","1783","5387","5380",第一金-澎湖,0,5,5,-1,1.73
"20231204","1783","9667","9600",富邦-台南,5,0,5,1,1.73
"20231204","1783","9136","9100",群益金鼎-西松,0,5,5,-1,1.73
"20231204","1783","0038003100350041","8150",台新-高雄,6,1,5,1,1.73
"20231204","1783","0039003800310069","9800",元大-西螺,0,4,4,-1,1.38
"20231204","1783","6163","6160",中國信託-永康,5,0,5,1,1.73
"20231204","1783","0039003100380078","9100",群益金鼎-延平,0,4,4,-1,1.38
"20231204","1783","6461","6460",大昌-樹林,4,0,4,1,1.38
"20231204","1783","0039003600320052","9600",富邦-園區,0,4,4,-1,1.38
"20231204","1783","8159","8150",台新-台南,4,0,4,1,1.38
"20231204","1783","0039004100390055","9A00",永豐金-中正,0,4,4,-1,1.38
"20231205","1783","9875","9800",元大-土城永寧,14,1,13,1,3.62
"20231205","1783","1440","1440",美林,9,40,31,-1,8.64
"20231205","1783","0037003000300071","7000",兆豐-內湖,11,0,11,1,3.06
"20231205","1783","8440","8440",摩根大通,4,35,31,-1,8.64
"20231205","1783","8150","8150",台新證券,11,0,11,1,3.06
"20231205","1783","1650","1650",新加坡商瑞銀,4,33,29,-1,8.08
"20231205","1783","9862","9800",元大-南京,11,0,11,1,3.06
"20231205","1783","1480","1480",美商高盛,1,18,17,-1,4.74
"20231205","1783","9647","9600",富邦-新竹,8,0,8,1,2.23
"20231205","1783","1560","1560",港商野村,1,8,7,-1,1.95
"20231205","1783","5856","5850",統一-台中,5,0,5,1,1.39
"20231205","1783","8847","8840",玉山-台南,0,7,7,-1,1.95
"20231205","1783","0031003000330041","1030",土銀-建國,5,0,5,1,1.39
"20231205","1783","9208","9200",凱基-桃園,0,7,7,-1,1.95
"20231205","1783","5380","5380",第一金,5,0,5,1,1.39
"20231205","1783","0035003800350063","5850",統一-仁愛,4,10,6,-1,1.67
"20231205","1783","5387","5380",第一金-澎湖,5,0,5,1,1.39
"20231205","1783","0039003100380064","9100",群益金鼎-內湖,0,6,6,-1,1.67
"20231205","1783","8849","8840",玉山-景美,7,2,5,1,1.39
"20231205","1783","0039003200300048","9200",凱基-基隆,0,6,6,-1,1.67
"20231205","1783","9289","9200",凱基-興隆,5,0,5,1,1.39
"20231205","1783","9859","9800",元大-新竹經國,0,5,5,-1,1.39
"20231205","1783","9817","9800",元大-東泰,5,0,5,1,1.39
"20231205","1783","5389","5380",第一金-中山,0,4,4,-1,1.11
"20231205","1783","003900380034004b","9800",元大-館前,5,0,5,1,1.39
"20231205","1783","0038003100350041","8150",台新-高雄,3,6,3,-1,0.84
"20231205","1783","8151","8150",台新-建北,4,0,4,1,1.11
"20231205","1783","6380","6380",光和,0,3,3,-1,0.84
"20231206","1783","9874","9800",元大-雙和,10,0,10,1,5.32
"20231206","1783","1650","1650",新加坡商瑞銀,2,22,20,-1,10.64
"20231206","1783","003500320036004b","5260",美好-富順,9,0,9,1,4.79
"20231206","1783","8440","8440",摩根大通,0,11,11,-1,5.85
"20231206","1783","9647","9600",富邦-新竹,6,0,6,1,3.19
"20231206","1783","0039003600320050","9600",富邦-頭份,0,10,10,-1,5.32
"20231206","1783","9878","9800",元大-金華,6,0,6,1,3.19
"20231206","1783","1440","1440",美林,5,14,9,-1,4.79
"20231206","1783","0039003800310079","9800",元大-善化,4,0,4,1,2.13
"20231206","1783","6163","6160",中國信託-永康,0,7,7,-1,3.72
"20231206","1783","0039003100380064","9100",群益金鼎-內湖,4,0,4,1,2.13
"20231206","1783","9268","9200",凱基-台北,0,7,7,-1,3.72
"20231206","1783","9817","9800",元大-東泰,4,0,4,1,2.13
"20231206","1783","9858","9800",元大-龍潭,0,6,6,-1,3.19
"20231206","1783","0039003800390044","9800",元大-左營,4,0,4,1,2.13
"20231206","1783","9859","9800",元大-新竹經國,0,6,6,-1,3.19
"20231206","1783","9300","9300",華南永昌,3,0,3,1,1.60
"20231206","1783","8888","8880",國泰-敦南,1,7,6,-1,3.19
"20231206","1783","003700300030005a","7000",兆豐-高雄,3,0,3,1,1.60
"20231206","1783","1480","1480",美商高盛,2,7,5,-1,2.66
"20231206","1783","003900310038004d","9100",群益金鼎-嘉義,3,0,3,1,1.60
"20231206","1783","0038003100350059","8150",台新-新營,0,5,5,-1,2.66
"20231206","1783","0039003100380078","9100",群益金鼎-延平,3,0,3,1,1.60
"20231206","1783","8159","8150",台新-台南,0,4,4,-1,2.13
"20231206","1783","9614","9600",富邦-基隆,3,0,3,1,1.60
"20231206","1783","0038003800380041","8880",國泰-館前,0,3,3,-1,1.60
"20231206","1783","0039003600320045","9600",富邦-樹林,3,0,3,1,1.60
"20231206","1783","1560","1560",港商野村,5,7,2,-1,1.06
"20231207","1783","9676","9600",富邦-仁愛,13,0,13,1,5.91
"20231207","1783","1440","1440",美林,0,38,38,-1,17.27
"20231207","1783","9647","9600",富邦-新竹,11,0,11,1,5.00
"20231207","1783","0039003800310067","9800",元大-大里,0,25,25,-1,11.36
"20231207","1783","9227","9200",凱基-城中,10,0,10,1,4.55
"20231207","1783","1650","1650",新加坡商瑞銀,1,17,16,-1,7.27
"20231207","1783","9875","9800",元大-土城永寧,10,0,10,1,4.55
"20231207","1783","5385","5380",第一金-桃園,0,12,12,-1,5.45
"20231207","1783","003700300030005a","7000",兆豐-高雄,9,0,9,1,4.09
"20231207","1783","9268","9200",凱基-台北,0,8,8,-1,3.64
"20231207","1783","7750","7750",北城證券,5,0,5,1,2.27
"20231207","1783","9871","9800",元大-忠孝,0,6,6,-1,2.73
"20231207","1783","9136","9100",群益金鼎-西松,5,0,5,1,2.27
"20231207","1783","8440","8440",摩根大通,0,5,5,-1,2.27
"20231207","1783","9188","9100",群益金鼎-三民,7,2,5,1,2.27
"20231207","1783","9289","9200",凱基-興隆,0,5,5,-1,2.27
"20231207","1783","8840","8840",玉山證券,4,0,4,1,1.82
"20231207","1783","0039003600320043","9600",富邦-東門,0,5,5,-1,2.27
"20231207","1783","0039003600310048","9600",富邦-新板,4,0,4,1,1.82
"20231207","1783","003900380039004c","9800",元大-成功,0,5,5,-1,2.27
"20231207","1783","0039003600320052","9600",富邦-園區,4,0,4,1,1.82
"20231207","1783","0039003100380043","9100",群益金鼎-古亭,0,4,4,-1,1.82
"20231207","1783","9817","9800",元大-東泰,4,0,4,1,1.82
"20231207","1783","1470","1470",台灣摩根士丹利,0,3,3,-1,1.36
"20231207","1783","0039003800390056","9800",元大-北三重,4,0,4,1,1.82
"20231207","1783","0039003800390055","9800",元大-大甲,0,3,3,-1,1.36
"20231207","1783","9655","9600",富邦-板橋,4,0,4,1,1.82
"20231207","1783","003700300030004b","7000",兆豐-新營,0,2,2,-1,0.91
"20231208","1783","0038003100350042","8150",台新-台中,7,0,7,1,5.65
"20231208","1783","9268","9200",凱基-台北,6,27,21,-1,16.94
"20231208","1783","0039003800310046","9800",元大-福營,5,0,5,1,4.03
"20231208","1783","8440","8440",摩根大通,0,6,6,-1,4.84
"20231208","1783","003900380034004b","9800",元大-館前,5,0,5,1,4.03
"20231208","1783","0038003400350041","8450",康和-內湖,0,6,6,-1,4.84
"20231208","1783","9871","9800",元大-忠孝,6,2,4,1,3.23
"20231208","1783","003900380039005a","9800",元大-小港,0,5,5,-1,4.03
"20231208","1783","5389","5380",第一金-中山,4,0,4,1,3.23
"20231208","1783","1650","1650",新加坡商瑞銀,2,7,5,-1,4.03
"20231208","1783","9188","9100",群益金鼎-三民,5,1,4,1,3.23
"20231208","1783","0035003300380042","5380",第一金-新竹,0,5,5,-1,4.03
"20231208","1783","9872","9800",元大-復北,4,0,4,1,3.23
"20231208","1783","1560","1560",港商野村,0,4,4,-1,3.23
"20231208","1783","8561","8560",新光-台中,4,1,3,1,2.42
"20231208","1783","0039003800380056","9800",元大-長庚,0,4,4,-1,3.23
"20231208","1783","8841","8840",玉山-雙和,3,0,3,1,2.42
"20231208","1783","8848","8840",玉山-嘉義,0,2,2,-1,1.61
"20231208","1783","8847","8840",玉山-台南,3,0,3,1,2.42
"20231208","1783","003900380039004c","9800",元大-成功,0,2,2,-1,1.61
"20231208","1783","9634","9600",富邦-羅東,3,0,3,1,2.42
"20231208","1783","003700300030004d","7000",兆豐-桃園,0,2,2,-1,1.61
"20231208","1783","9875","9800",元大-土城永寧,3,0,3,1,2.42
"20231208","1783","8492","8490",京城-嘉義,0,2,2,-1,1.61
"20231208","1783","1590","1590",花旗環球,2,0,2,1,1.61
"20231208","1783","0039003600310048","9600",富邦-新板,0,2,2,-1,1.61
"20231208","1783","8846","8840",玉山-板橋,2,0,2,1,1.61
"20231208","1783","9834","9800",元大-中壢,0,2,2,-1,1.61
"20231211","1783","0035003900320062","5920",元富-板橋,10,0,10,1,6.33
"20231211","1783","003900380039004c","9800",元大-成功,0,14,14,-1,8.86
"20231211","1783","9875","9800",元大-土城永寧,8,3,5,1,3.16
"20231211","1783","8440","8440",摩根大通,0,7,7,-1,4.43
"20231211","1783","1480","1480",美商高盛,6,1,5,1,3.16
"20231211","1783","1470","1470",台灣摩根士丹利,0,6,6,-1,3.80
"20231211","1783","0037003000300063","7000",兆豐-民生,4,0,4,1,2.53
"20231211","1783","6380","6380",光和,0,5,5,-1,3.16
"20231211","1783","003700300030005a","7000",兆豐-高雄,5,1,4,1,2.53
"20231211","1783","9209","9200",凱基-岡山,0,4,4,-1,2.53
"20231211","1783","0039003100330049","9100",群益金鼎-萬華,4,0,4,1,2.53
"20231211","1783","0039003800310051","9800",元大-太平,0,4,4,-1,2.53
"20231211","1783","9278","9200",凱基-永康,4,0,4,1,2.53
"20231211","1783","003900380039006a","9800",元大-樹林,0,3,3,-1,1.90
"20231211","1783","8459","8450",康和-嘉義,3,0,3,1,1.90
"20231211","1783","1440","1440",美林,12,15,3,-1,1.90
"20231211","1783","9692","9600",富邦-嘉義,3,0,3,1,1.90
"20231211","1783","9884","9800",元大-斗信,0,3,3,-1,1.90
"20231211","1783","0039004100300030","9A00",永豐金證券,2,0,2,1,1.27
"20231211","1783","0039003800380056","9800",元大-長庚,0,3,3,-1,1.90
"20231211","1783","0031003000330041","1030",土銀-建國,2,0,2,1,1.27
"20231211","1783","6114","6110",台中銀-員林,0,2,2,-1,1.27
"20231211","1783","1560","1560",港商野村,3,1,2,1,1.27
"20231211","1783","8849","8840",玉山-景美,0,2,2,-1,1.27
"20231211","1783","2180","2180",亞東,2,0,2,1,1.27
"20231211","1783","0039003600320050","9600",富邦-頭份,0,2,2,-1,1.27
"20231211","1783","9300","9300",華南永昌,2,0,2,1,1.27
"20231211","1783","0039003800310053","9800",元大-崇德,0,2,2,-1,1.27
"20231212","1783","9862","9800",元大-南京,11,0,11,1,7.01
"20231212","1783","1440","1440",美林,2,18,16,-1,10.19
"20231212","1783","0035003900320062","5920",元富-板橋,6,0,6,1,3.82
"20231212","1783","1650","1650",新加坡商瑞銀,4,18,14,-1,8.92
"20231212","1783","8888","8880",國泰-敦南,5,0,5,1,3.18
"20231212","1783","9183","9100",群益金鼎-高雄,0,10,10,-1,6.37
"20231212","1783","0036003100310041","6110",台中銀-豐原,5,0,5,1,3.18
"20231212","1783","1470","1470",台灣摩根士丹利,0,7,7,-1,4.46
"20231212","1783","0039003800320041","9800",元大-羅東,5,0,5,1,3.18
"20231212","1783","0039003800320042","9800",元大-博愛,0,5,5,-1,3.18
"20231212","1783","1560","1560",港商野村,10,6,4,1,2.55
"20231212","1783","9800","9800",元大證券,3,8,5,-1,3.18
"20231212","1783","1480","1480",美商高盛,3,0,3,1,1.91
"20231212","1783","0035003800350041","5850",統一-基隆,0,5,5,-1,3.18
"20231212","1783","1590","1590",花旗環球,3,0,3,1,1.91
"20231212","1783","0038003400350044","8450",康和-板橋,0,5,5,-1,3.18
"20231212","1783","9237","9200",凱基-敦北,3,0,3,1,1.91
"20231212","1783","0037003000300063","7000",兆豐-民生,1,5,4,-1,2.55
"20231212","1783","0039003800330055","9800",元大-頭份,3,0,3,1,1.91
"20231212","1783","0039004100300030","9A00",永豐金證券,2,6,4,-1,2.55
"20231212","1783","8840","8840",玉山證券,3,0,3,1,1.91
"20231212","1783","0038003100350041","8150",台新-高雄,0,3,3,-1,1.91
"20231212","1783","0031003000340041","1040",臺銀-臺中,2,0,2,1,1.27
"20231212","1783","8440","8440",摩根大通,0,3,3,-1,1.91
"20231212","1783","0035003900320050","5920",元富-同大,2,0,2,1,1.27
"20231212","1783","0039004100360031","9A00",永豐金-鳳山,0,3,3,-1,1.91
"20231212","1783","6464","6460",大昌-新店,2,0,2,1,1.27
"20231212","1783","9657","9600",富邦-苗栗,0,2,2,-1,1.27
"20231213","1783","8156","8150",台新-三民,10,0,10,1,7.69
"20231213","1783","1440","1440",美林,1,17,16,-1,12.31
"20231213","1783","003700300030005a","7000",兆豐-高雄,6,0,6,1,4.62
"20231213","1783","9268","9200",凱基-台北,4,17,13,-1,10.00
"20231213","1783","9608","9600",富邦-台東,6,0,6,1,4.62
"20231213","1783","9852","9800",元大-永春,0,9,9,-1,6.92
"20231213","1783","7032","7030",致和-佳里,5,0,5,1,3.85
"20231213","1783","1560","1560",港商野村,0,7,7,-1,5.38
"20231213","1783","003500320036004b","5260",美好-富順,4,0,4,1,3.08
"20231213","1783","0039003800330055","9800",元大-頭份,0,7,7,-1,5.38
"20231213","1783","0037003000300063","7000",兆豐-民生,4,0,4,1,3.08
"20231213","1783","1470","1470",台灣摩根士丹利,0,6,6,-1,4.62
"20231213","1783","9801","9800",元大-城東,3,0,3,1,2.31
"20231213","1783","0039003800310079","9800",元大-善化,0,4,4,-1,3.08
"20231213","1783","9859","9800",元大-新竹經國,2,0,2,1,1.54
"20231213","1783","9136","9100",群益金鼎-西松,0,2,2,-1,1.54
"20231213","1783","9869","9800",元大-新盛,2,0,2,1,1.54
"20231213","1783","0039003100330045","9100",群益金鼎-基隆,0,2,2,-1,1.54
"20231213","1783","8561","8560",新光-台中,3,1,2,1,1.54
"20231213","1783","5263","5260",美好-泰山,0,1,1,-1,0.77
"20231213","1783","0039003100330052","9100",群益金鼎-北高雄,2,0,2,1,1.54
"20231213","1783","9205","9200",凱基-三重,0,1,1,-1,0.77
"20231213","1783","9328","9300",華南永昌-潮州,2,0,2,1,1.54
"20231213","1783","1043","1040",臺銀-民權,0,1,1,-1,0.77
"20231213","1783","003900360031005a","9600",富邦-永康,4,2,2,1,1.54
"20231213","1783","7003","7000",兆豐-台中,0,1,1,-1,0.77
"20231213","1783","003900380033006a","9800",元大-仁愛,2,0,2,1,1.54
"20231213","1783","8848","8840",玉山-嘉義,0,1,1,-1,0.77
"20231214","1783","1480","1480",美商高盛,8,0,8,1,9.76
"20231214","1783","9324","9300",華南永昌-岡山,0,5,5,-1,6.10
"20231214","1783","003900380039006d","9800",元大-信義,4,0,4,1,4.88
"20231214","1783","1440","1440",美林,3,7,4,-1,4.88
"20231214","1783","5927","5920",元富-林園,3,0,3,1,3.66
"20231214","1783","9856","9800",元大-花蓮,0,3,3,-1,3.66
"20231214","1783","9268","9200",凱基-台北,9,6,3,1,3.66
"20231214","1783","1470","1470",台灣摩根士丹利,0,2,2,-1,2.44
"20231214","1783","0039003800390067","9800",元大-嘉義,3,0,3,1,3.66
"20231214","1783","5858","5850",統一-嘉義,0,2,2,-1,2.44
"20231214","1783","6162","6160",中國信託-忠孝,2,0,2,1,2.44
"20231214","1783","9223","9200",凱基-豐中,0,2,2,-1,2.44
"20231214","1783","003700300030005a","7000",兆豐-高雄,2,0,2,1,2.44
"20231214","1783","9692","9600",富邦-嘉義,0,2,2,-1,2.44
"20231214","1783","0039003200300048","9200",凱基-基隆,2,0,2,1,2.44
"20231214","1783","9875","9800",元大-土城永寧,0,2,2,-1,2.44
"20231214","1783","9359","9300",華南永昌-中正,2,0,2,1,2.44
"20231214","1783","9667","9600",富邦-台南,0,2,2,-1,2.44
"20231214","1783","8888","8880",國泰-敦南,2,1,1,1,1.22
"20231214","1783","8848","8840",玉山-嘉義,0,2,2,-1,2.44
"20231214","1783","0039004100390043","9A00",永豐金-員林,1,0,1,1,1.22
"20231214","1783","0037003000300052","7000",兆豐-小港,0,1,1,-1,1.22
"20231214","1783","1590","1590",花旗環球,1,0,1,1,1.22
"20231214","1783","003500320036004b","5260",美好-富順,0,1,1,-1,1.22
"20231214","1783","1024","1020",合庫-嘉義,1,0,1,1,1.22
"20231214","1783","0035003900320050","5920",元富-同大,0,1,1,-1,1.22
"20231214","1783","1022","1020",合庫-台南,1,0,1,1,1.22
"20231214","1783","6164","6160",中國信託-文心,0,1,1,-1,1.22
"20231215","1783","1480","1480",美商高盛,21,0,21,1,11.48
"20231215","1783","0039003100380043","9100",群益金鼎-古亭,0,9,9,-1,4.92
"20231215","1783","1470","1470",台灣摩根士丹利,14,0,14,1,7.65
"20231215","1783","8561","8560",新光-台中,0,8,8,-1,4.37
"20231215","1783","1570","1570",港商法國興業,10,0,10,1,5.46
"20231215","1783","0031003000320043","1020",合庫-自強,0,6,6,-1,3.28
"20231215","1783","1440","1440",美林,21,12,9,1,4.92
"20231215","1783","9188","9100",群益金鼎-三民,0,6,6,-1,3.28
"20231215","1783","9268","9200",凱基-台北,12,3,9,1,4.92
"20231215","1783","0039003800390056","9800",元大-北三重,2,7,5,-1,2.73
"20231215","1783","1560","1560",港商野村,8,0,8,1,4.37
"20231215","1783","6464","6460",大昌-新店,0,5,5,-1,2.73
"20231215","1783","003900380039006a","9800",元大-樹林,5,0,5,1,2.73
"20231215","1783","0037003000300043","7000",兆豐-來福,0,5,5,-1,2.73
"20231215","1783","1024","1020",合庫-嘉義,4,0,4,1,2.19
"20231215","1783","0037003000300063","7000",兆豐-民生,0,4,4,-1,2.19
"20231215","1783","9208","9200",凱基-桃園,4,0,4,1,2.19
"20231215","1783","0039003800330055","9800",元大-頭份,0,4,4,-1,2.19
"20231215","1783","1590","1590",花旗環球,3,0,3,1,1.64
"20231215","1783","8841","8840",玉山-雙和,0,4,4,-1,2.19
"20231215","1783","0036003100310041","6110",台中銀-豐原,3,0,3,1,1.64
"20231215","1783","8888","8880",國泰-敦南,0,3,3,-1,1.64
"20231215","1783","8440","8440",摩根大通,3,0,3,1,1.64
"20231215","1783","003900360031005a","9600",富邦-永康,0,3,3,-1,1.64
"20231215","1783","0039003800300044","9800",元大-北府,3,0,3,1,1.64
"20231215","1783","003500320036004b","5260",美好-富順,0,3,3,-1,1.64
"20231215","1783","7798","7790",國票-內壢,2,0,2,1,1.09
"20231215","1783","5927","5920",元富-林園,0,3,3,-1,1.64
"20231218","1783","0039003800330069","9800",元大-大雅,11,0,11,1,5.70
"20231218","1783","0031003200360069","1260",宏遠-光隆,0,13,13,-1,6.74
"20231218","1783","9188","9100",群益金鼎-三民,14,4,10,1,5.18
"20231218","1783","0039003800390066","9800",元大-東港,0,10,10,-1,5.18
"20231218","1783","8886","8880",國泰-新莊,8,0,8,1,4.15
"20231218","1783","9614","9600",富邦-基隆,0,9,9,-1,4.66
"20231218","1783","0039004100390042","9A00",永豐金-中和,8,0,8,1,4.15
"20231218","1783","1470","1470",台灣摩根士丹利,0,8,8,-1,4.15
"20231218","1783","0039003800390046","9800",元大-高雄,5,0,5,1,2.59
"20231218","1783","003500380035004a","5850",統一-三重,0,8,8,-1,4.15
"20231218","1783","0038003100350041","8150",台新-高雄,3,0,3,1,1.55
"20231218","1783","1650","1650",新加坡商瑞銀,12,17,5,-1,2.59
"20231218","1783","9692","9600",富邦-嘉義,3,0,3,1,1.55
"20231218","1783","1440","1440",美林,8,13,5,-1,2.59
"20231218","1783","9816","9800",元大-新竹,3,0,3,1,1.55
"20231218","1783","0039003100380043","9100",群益金鼎-古亭,0,5,5,-1,2.59
"20231218","1783","0039003800390057","9800",元大-豐原站前,3,0,3,1,1.55
"20231218","1783","003900380034004b","9800",元大-館前,0,5,5,-1,2.59
"20231218","1783","0031003000340043","1040",臺銀-高雄,2,0,2,1,1.04
"20231218","1783","8561","8560",新光-台中,0,3,3,-1,1.55
"20231218","1783","1115","1110",台灣企銀-太平,2,0,2,1,1.04
"20231218","1783","0035003800350063","5850",統一-仁愛,0,3,3,-1,1.55
"20231218","1783","5382","5380",第一金-台中,2,0,2,1,1.04
"20231218","1783","8849","8840",玉山-景美,0,3,3,-1,1.55
"20231218","1783","6381","6380",光和-溪湖,2,0,2,1,1.04
"20231218","1783","9817","9800",元大-東泰,0,3,3,-1,1.55
"20231218","1783","7007","7000",兆豐-竹北,2,0,2,1,1.04
"20231218","1783","0039003800310065","9800",元大-佳里,0,3,3,-1,1.55
"20231219","1783","1570","1570",港商法國興業,8,0,8,1,6.56
"20231219","1783","0031003200360069","1260",宏遠-光隆,0,12,12,-1,9.84
"20231219","1783","0037003000300063","7000",兆豐-民生,5,0,5,1,4.10
"20231219","1783","1480","1480",美商高盛,0,10,10,-1,8.20
"20231219","1783","003700300030005a","7000",兆豐-高雄,5,0,5,1,4.10
"20231219","1783","1650","1650",新加坡商瑞銀,7,17,10,-1,8.20
"20231219","1783","003900360031004b","9600",富邦-七賢,5,0,5,1,4.10
"20231219","1783","1440","1440",美林,2,11,9,-1,7.38
"20231219","1783","0038003100350041","8150",台新-高雄,6,2,4,1,3.28
"20231219","1783","1470","1470",台灣摩根士丹利,1,8,7,-1,5.74
"20231219","1783","0031003000340041","1040",臺銀-臺中,3,0,3,1,2.46
"20231219","1783","9692","9600",富邦-嘉義,0,6,6,-1,4.92
"20231219","1783","6451","6450",永全-南崁,3,0,3,1,2.46
"20231219","1783","1560","1560",港商野村,0,5,5,-1,4.10
"20231219","1783","0039003800390056","9800",元大-北三重,3,0,3,1,2.46
"20231219","1783","0031003000340043","1040",臺銀-高雄,2,4,2,-1,1.64
"20231219","1783","6381","6380",光和-溪湖,2,0,2,1,1.64
"20231219","1783","6210","6210",新百王,0,2,2,-1,1.64
"20231219","1783","6464","6460",大昌-新店,2,0,2,1,1.64
"20231219","1783","0039003800390067","9800",元大-嘉義,0,2,2,-1,1.64
"20231219","1783","8150","8150",台新證券,2,0,2,1,1.64
"20231219","1783","1022","1020",合庫-台南,0,1,1,-1,0.82
"20231219","1783","003900320030004e","9200",凱基-湖口,2,0,2,1,1.64
"20231219","1783","0035003900320047","5920",元富-新竹,0,1,1,-1,0.82
"20231219","1783","9604","9600",富邦-陽明,2,0,2,1,1.64
"20231219","1783","0037003000300066","7000",兆豐-鹿港,0,1,1,-1,0.82
"20231219","1783","0039003600350055","9600",富邦-彰化,2,0,2,1,1.64
"20231219","1783","0037003000300050","7000",兆豐-南京,0,1,1,-1,0.82
"20231220","1783","003700300030005a","7000",兆豐-高雄,4,0,4,1,5.88
"20231220","1783","9268","9200",凱基-台北,1,8,7,-1,10.29
"20231220","1783","0037003000300063","7000",兆豐-民生,3,0,3,1,4.41
"20231220","1783","1440","1440",美林,2,8,6,-1,8.82
"20231220","1783","9215","9200",凱基-高美館,3,0,3,1,4.41
"20231220","1783","1560","1560",港商野村,0,5,5,-1,7.35
"20231220","1783","9801","9800",元大-城東,3,0,3,1,4.41
"20231220","1783","1470","1470",台灣摩根士丹利,0,3,3,-1,4.41
"20231220","1783","5961","5960",日茂-埔里,2,0,2,1,2.94
"20231220","1783","6464","6460",大昌-新店,0,3,3,-1,4.41
"20231220","1783","0037003000300071","7000",兆豐-內湖,2,0,2,1,2.94
"20231220","1783","9206","9200",凱基-高雄,0,2,2,-1,2.94
"20231220","1783","9134","9100",群益金鼎-開元,2,0,2,1,2.94
"20231220","1783","9872","9800",元大-復北,0,2,2,-1,2.94
"20231220","1783","9319","9300",華南永昌-鶯歌,2,0,2,1,2.94
"20231220","1783","7003","7000",兆豐-台中,0,1,1,-1,1.47
"20231220","1783","003900360031005a","9600",富邦-永康,2,0,2,1,2.94
"20231220","1783","003700300030004a","7000",兆豐-公益,0,1,1,-1,1.47
"20231220","1783","8888","8880",國泰-敦南,1,0,1,1,1.47
"20231220","1783","0039003100380065","9100",群益金鼎-大安,0,1,1,-1,1.47
"20231220","1783","1480","1480",美商高盛,1,0,1,1,1.47
"20231220","1783","9300","9300",華南永昌,0,1,1,-1,1.47
"20231220","1783","0031003000340041","1040",臺銀-臺中,1,0,1,1,1.47
"20231220","1783","9315","9300",華南永昌-大甲,0,1,1,-1,1.47
"20231220","1783","0037003700390065","7790",國票-南科,1,0,1,1,1.47
"20231220","1783","9697","9600",富邦-虎尾,0,1,1,-1,1.47
"20231220","1783","8150","8150",台新證券,1,0,1,1,1.47
"20231220","1783","9858","9800",元大-龍潭,0,1,1,-1,1.47
"20231221","1783","7000","7000",兆豐證券,10,0,10,1,7.63
"20231221","1783","1470","1470",台灣摩根士丹利,0,5,5,-1,3.82
"20231221","1783","9308","9300",華南永昌-麻豆,10,0,10,1,7.63
"20231221","1783","9188","9100",群益金鼎-三民,2,7,5,-1,3.82
"20231221","1783","1440","1440",美林,13,4,9,1,6.87
"20231221","1783","0039003800310079","9800",元大-善化,0,5,5,-1,3.82
"20231221","1783","1650","1650",新加坡商瑞銀,8,2,6,1,4.58
"20231221","1783","0039003100380043","9100",群益金鼎-古亭,0,4,4,-1,3.05
"20231221","1783","003700300030004c","7000",兆豐-天母,6,0,6,1,4.58
"20231221","1783","9268","9200",凱基-台北,9,12,3,-1,2.29
"20231221","1783","1039","1030",土銀-士林,5,0,5,1,3.82
"20231221","1783","0039003800390056","9800",元大-北三重,1,4,3,-1,2.29
"20231221","1783","9319","9300",華南永昌-鶯歌,3,0,3,1,2.29
"20231221","1783","5382","5380",第一金-台中,0,2,2,-1,1.53
"20231221","1783","9854","9800",元大-文心興安,3,0,3,1,2.29
"20231221","1783","6160","6160",中國信託,0,2,2,-1,1.53
"20231221","1783","9856","9800",元大-花蓮,1,0,1,1,0.76
"20231221","1783","8150","8150",台新證券,1,3,2,-1,1.53
"20231221","1783","2180","2180",亞東,1,0,1,1,0.76
"20231221","1783","8157","8150",台新-左楠,0,2,2,-1,1.53
"20231221","1783","5381","5380",第一金-員林,1,0,1,1,0.76
"20231221","1783","8440","8440",摩根大通,5,7,2,-1,1.53
"20231221","1783","5857","5850",統一-新竹,1,0,1,1,0.76
"20231221","1783","8840","8840",玉山證券,0,2,2,-1,1.53
"20231221","1783","003500380035004a","5850",統一-三重,1,0,1,1,0.76
"20231221","1783","8849","8840",玉山-景美,0,2,2,-1,1.53
"20231221","1783","003500390032004c","5920",元富-中壢,1,0,1,1,0.76
"20231221","1783","003900310038004d","9100",群益金鼎-嘉義,0,2,2,-1,1.53
"20231222","1783","1480","1480",美商高盛,7,0,7,1,7.53
"20231222","1783","5856","5850",統一-台中,0,10,10,-1,10.75
"20231222","1783","1440","1440",美林,9,3,6,1,6.45
"20231222","1783","7000","7000",兆豐證券,0,10,10,-1,10.75
"20231222","1783","003700300030004c","7000",兆豐-天母,5,0,5,1,5.38
"20231222","1783","8849","8840",玉山-景美,1,7,6,-1,6.45
"20231222","1783","003900380034004b","9800",元大-館前,5,0,5,1,5.38
"20231222","1783","0038003400350044","8450",康和-板橋,0,5,5,-1,5.38
"20231222","1783","0035003900320072","5920",元富-城東,4,0,4,1,4.30
"20231222","1783","1470","1470",台灣摩根士丹利,0,5,5,-1,5.38
"20231222","1783","8560","8560",新光,4,0,4,1,4.30
"20231222","1783","1039","1030",土銀-士林,0,5,5,-1,5.38
"20231222","1783","8561","8560",新光-台中,4,0,4,1,4.30
"20231222","1783","9878","9800",元大-金華,0,4,4,-1,4.30
"20231222","1783","1025","1020",合庫-基隆,3,0,3,1,3.23
"20231222","1783","8440","8440",摩根大通,0,3,3,-1,3.23
"20231222","1783","5269","5260",美好-台中,2,0,2,1,2.15
"20231222","1783","5850","5850",統一,0,3,3,-1,3.23
"20231222","1783","1041","1040",臺銀-鳳山,2,0,2,1,2.15
"20231222","1783","9800","9800",元大證券,1,3,2,-1,2.15
"20231222","1783","0036003100310041","6110",台中銀-豐原,2,0,2,1,2.15
"20231222","1783","8157","8150",台新-左楠,0,2,2,-1,2.15
"20231222","1783","0037003000300063","7000",兆豐-民生,2,0,2,1,2.15
"20231222","1783","0039003100330049","9100",群益金鼎-萬華,0,2,2,-1,2.15
"20231222","1783","9188","9100",群益金鼎-三民,2,0,2,1,2.15
"20231222","1783","9871","9800",元大-忠孝,0,1,1,-1,1.08
"20231222","1783","9655","9600",富邦-板橋,2,0,2,1,2.15
"20231222","1783","1650","1650",新加坡商瑞銀,2,3,1,-1,1.08
"20231225","1783","6380","6380",光和,10,0,10,1,6.90
"20231225","1783","9268","9200",凱基-台北,0,21,21,-1,14.48
"20231225","1783","003900310038004a","9100",群益金鼎-永和,10,0,10,1,6.90
"20231225","1783","9878","9800",元大-金華,0,16,16,-1,11.03
"20231225","1783","003900410039006a","9A00",永豐金-嘉義,8,0,8,1,5.52
"20231225","1783","003700300030004c","7000",兆豐-天母,0,11,11,-1,7.59
"20231225","1783","003700300030005a","7000",兆豐-高雄,6,0,6,1,4.14
"20231225","1783","0035003800350059","5850",統一-土城,0,10,10,-1,6.90
"20231225","1783","7000","7000",兆豐證券,5,0,5,1,3.45
"20231225","1783","8157","8150",台新-左楠,0,8,8,-1,5.52
"20231225","1783","0037003000300071","7000",兆豐-內湖,5,0,5,1,3.45
"20231225","1783","003900410039004d","9A00",永豐金-南投,0,5,5,-1,3.45
"20231225","1783","7007","7000",兆豐-竹北,4,0,4,1,2.76
"20231225","1783","8440","8440",摩根大通,0,4,4,-1,2.76
"20231225","1783","8560","8560",新光,4,0,4,1,2.76
"20231225","1783","6163","6160",中國信託-永康,0,3,3,-1,2.07
"20231225","1783","9136","9100",群益金鼎-西松,5,1,4,1,2.76
"20231225","1783","9625","9600",富邦-竹東,0,3,3,-1,2.07
"20231225","1783","9604","9600",富邦-陽明,4,0,4,1,2.76
"20231225","1783","1650","1650",新加坡商瑞銀,2,4,2,-1,1.38
"20231225","1783","0035003300380057","5380",第一金-華江,2,0,2,1,1.38
"20231225","1783","6114","6110",台中銀-員林,0,2,2,-1,1.38
"20231225","1783","0031003000320043","1020",合庫-自強,2,0,2,1,1.38
"20231225","1783","8150","8150",台新證券,2,4,2,-1,1.38
"20231225","1783","1110","1110",台灣企銀,2,0,2,1,1.38
"20231225","1783","0039003800310065","9800",元大-佳里,0,2,2,-1,1.38
"20231225","1783","003500320036004b","5260",美好-富順,2,0,2,1,1.38
"20231225","1783","0039003800320043","9800",元大-六合,0,2,2,-1,1.38
"20231226","1783","1650","1650",新加坡商瑞銀,16,1,15,1,12.61
"20231226","1783","9308","9300",華南永昌-麻豆,0,10,10,-1,8.40
"20231226","1783","9268","9200",凱基-台北,14,2,12,1,10.08
"20231226","1783","9273","9200",凱基-竹東,0,6,6,-1,5.04
"20231226","1783","6161","6160",中國信託-三重,5,0,5,1,4.20
"20231226","1783","003900380031007a","9800",元大-大統,0,6,6,-1,5.04
"20231226","1783","8150","8150",台新證券,4,0,4,1,3.36
"20231226","1783","7000","7000",兆豐證券,0,5,5,-1,4.20
"20231226","1783","8440","8440",摩根大通,6,2,4,1,3.36
"20231226","1783","9208","9200",凱基-桃園,0,4,4,-1,3.36
"20231226","1783","0039004100300030","9A00",永豐金證券,5,1,4,1,3.36
"20231226","1783","1022","1020",合庫-台南,0,3,3,-1,2.52
"20231226","1783","9875","9800",元大-土城永寧,3,0,3,1,2.52
"20231226","1783","0038003400350044","8450",康和-板橋,0,3,3,-1,2.52
"20231226","1783","1590","1590",花旗環球,2,0,2,1,1.68
"20231226","1783","0039003100380043","9100",群益金鼎-古亭,0,3,3,-1,2.52
"20231226","1783","1480","1480",美商高盛,2,0,2,1,1.68
"20231226","1783","8888","8880",國泰-敦南,0,3,3,-1,2.52
"20231226","1783","8560","8560",新光,1,0,1,1,0.84
"20231226","1783","003500320036004b","5260",美好-富順,0,2,2,-1,1.68
"20231226","1783","8882","8880",國泰-台中,1,0,1,1,0.84
"20231226","1783","6162","6160",中國信託-忠孝,0,2,2,-1,1.68
"20231226","1783","9616","9600",富邦-岡山,1,0,1,1,0.84
"20231226","1783","0035003300380057","5380",第一金-華江,0,2,2,-1,1.68
"20231226","1783","0039003600310058","9600",富邦-大墩,2,1,1,1,0.84
"20231226","1783","003900320031004d","9200",凱基-八德,0,2,2,-1,1.68
"20231226","1783","9647","9600",富邦-新竹,1,0,1,1,0.84
"20231226","1783","9817","9800",元大-東泰,0,2,2,-1,1.68
"20231227","1783","1440","1440",美林,32,3,29,1,10.66
"20231227","1783","0031003200360069","1260",宏遠-光隆,0,16,16,-1,5.88
"20231227","1783","1650","1650",新加坡商瑞銀,31,3,28,1,10.29
"20231227","1783","7750","7750",北城證券,0,16,16,-1,5.88
"20231227","1783","9834","9800",元大-中壢,25,0,25,1,9.19
"20231227","1783","0039003800310079","9800",元大-善化,0,15,15,-1,5.51
"20231227","1783","1480","1480",美商高盛,16,1,15,1,5.51
"20231227","1783","9188","9100",群益金鼎-三民,14,26,12,-1,4.41
"20231227","1783","1570","1570",港商法國興業,11,0,11,1,4.04
"20231227","1783","0038003100350042","8150",台新-台中,0,10,10,-1,3.68
"20231227","1783","9874","9800",元大-雙和,10,0,10,1,3.68
"20231227","1783","0039003100380063","9100",群益金鼎-鳳山,0,10,10,-1,3.68
"20231227","1783","1560","1560",港商野村,5,0,5,1,1.84
"20231227","1783","003900380031007a","9800",元大-大統,0,10,10,-1,3.68
"20231227","1783","8842","8840",玉山-新莊,5,0,5,1,1.84
"20231227","1783","9875","9800",元大-土城永寧,0,10,10,-1,3.68
"20231227","1783","003900380033004e","9800",元大-大安,5,0,5,1,1.84
"20231227","1783","8560","8560",新光,0,7,7,-1,2.57
"20231227","1783","003900410039004a","9A00",永豐金-板新,5,0,5,1,1.84
"20231227","1783","9255","9200",凱基-和平,0,6,6,-1,2.21
"20231227","1783","8849","8840",玉山-景美,4,0,4,1,1.47
"20231227","1783","9332","9300",華南永昌-楠梓,0,6,6,-1,2.21
"20231227","1783","8884","8880",國泰-台南,3,0,3,1,1.10
"20231227","1783","003900310038004a","9100",群益金鼎-永和,0,5,5,-1,1.84
"20231227","1783","0039003100330044","9100",群益金鼎-潭子,3,0,3,1,1.10
"20231227","1783","0039003800320041","9800",元大-羅東,0,5,5,-1,1.84
"20231227","1783","0039003800310043","9800",元大-路竹,3,0,3,1,1.10
"20231227","1783","1035","1030",土銀-新竹,0,4,4,-1,1.47
"20231228","1783","8888","8880",國泰-敦南,10,0,10,1,4.08
"20231228","1783","0031003200360069","1260",宏遠-光隆,0,15,15,-1,6.12
"20231228","1783","003900310038004c","9100",群益金鼎-建成,10,0,10,1,4.08
"20231228","1783","9276","9200",凱基-苗栗,0,10,10,-1,4.08
"20231228","1783","8842","8840",玉山-新莊,6,0,6,1,2.45
"20231228","1783","003700300030005a","7000",兆豐-高雄,0,8,8,-1,3.27
"20231228","1783","1650","1650",新加坡商瑞銀,13,8,5,1,2.04
"20231228","1783","9300","9300",華南永昌,0,6,6,-1,2.45
"20231228","1783","9834","9800",元大-中壢,5,0,5,1,2.04
"20231228","1783","0039004100390043","9A00",永豐金-員林,0,6,6,-1,2.45
"20231228","1783","1590","1590",花旗環球,4,0,4,1,1.63
"20231228","1783","0038003100350041","8150",台新-高雄,0,5,5,-1,2.04
"20231228","1783","5856","5850",統一-台中,2,0,2,1,0.82
"20231228","1783","003900310038004a","9100",群益金鼎-永和,0,5,5,-1,2.04
"20231228","1783","0038003800340042","8840",玉山-台中,2,0,2,1,0.82
"20231228","1783","0039003800310044","9800",元大-南投,0,5,5,-1,2.04
"20231228","1783","7790","7790",國票證券,1,0,1,1,0.41
"20231228","1783","003900380034004b","9800",元大-館前,0,5,5,-1,2.04
"20231228","1783","0039003800390047","9800",元大-大同,1,0,1,1,0.41
"20231228","1783","9878","9800",元大-金華,0,5,5,-1,2.04
"20231228","1783","1440","1440",美林,8,7,1,1,0.41
"20231228","1783","9647","9600",富邦-新竹,0,4,4,-1,1.63
"20231228","1783","1560","1560",港商野村,10,9,1,1,0.41
"20231228","1783","0031003000340041","1040",臺銀-臺中,0,4,4,-1,1.63
"20231228","1783","1116","1110",台灣企銀-屏東,1,0,1,1,0.41
"20231228","1783","9188","9100",群益金鼎-三民,35,39,4,-1,1.63
"20231228","1783","0035003800350059","5850",統一-土城,1,0,1,1,0.41
"20231228","1783","9255","9200",凱基-和平,0,4,4,-1,1.63
"20231229","1783","9894","9800",元大-桃興,10,0,10,1,8.93
"20231229","1783","1650","1650",新加坡商瑞銀,3,14,11,-1,9.82
"20231229","1783","0031003200360044","1260",宏遠-台南,3,0,3,1,2.68
"20231229","1783","8888","8880",國泰-敦南,0,11,11,-1,9.82
"20231229","1783","7009","7000",兆豐-景美,3,0,3,1,2.68
"20231229","1783","1480","1480",美商高盛,0,7,7,-1,6.25
"20231229","1783","8846","8840",玉山-板橋,3,0,3,1,2.68
"20231229","1783","9136","9100",群益金鼎-西松,0,5,5,-1,4.46
"20231229","1783","8883","8880",國泰-松江,3,0,3,1,2.68
"20231229","1783","003900380030004b","9800",元大-竹科,0,5,5,-1,4.46
"20231229","1783","9188","9100",群益金鼎-三民,3,0,3,1,2.68
"20231229","1783","9856","9800",元大-花蓮,0,5,5,-1,4.46
"20231229","1783","003900360031005a","9600",富邦-永康,3,0,3,1,2.68
"20231229","1783","1560","1560",港商野村,0,4,4,-1,3.57
"20231229","1783","9692","9600",富邦-嘉義,3,0,3,1,2.68
"20231229","1783","1440","1440",美林,6,8,2,-1,1.79
"20231229","1783","5921","5920",元富-高雄,2,0,2,1,1.79
"20231229","1783","0037003000300063","7000",兆豐-民生,0,2,2,-1,1.79
"20231229","1783","6381","6380",光和-溪湖,2,0,2,1,1.79
"20231229","1783","9268","9200",凱基-台北,4,6,2,-1,1.79
"20231229","1783","0038003100350042","8150",台新-台中,2,0,2,1,1.79
"20231229","1783","9800","9800",元大證券,0,2,2,-1,1.79
"20231229","1783","0039003100330044","9100",群益金鼎-潭子,2,0,2,1,1.79
"20231229","1783","0039003800310041","9800",元大-鶯歌,0,2,2,-1,1.79
"20231229","1783","9647","9600",富邦-新竹,2,0,2,1,1.79
"20231229","1783","0039003800310069","9800",元大-西螺,0,2,2,-1,1.79
"20231229","1783","0039003800310046","9800",元大-福營,2,0,2,1,1.79
"20231229","1783","0039004100390041","9A00",永豐金-羅東,0,2,2,-1,1.79
"20240102","1783","8382","8380",安泰-楠梓,21,0,21,1,10.14
"20240102","1783","0039004100300030","9A00",永豐金證券,0,10,10,-1,4.83
"20240102","1783","8440","8440",摩根大通,18,1,17,1,8.21
"20240102","1783","003900380039004a","9800",元大-彰化民生,0,10,10,-1,4.83
"20240102","1783","1440","1440",美林,14,5,9,1,4.35
"20240102","1783","0039003600310048","9600",富邦-新板,0,8,8,-1,3.86
"20240102","1783","1021","1020",合庫-台中,6,0,6,1,2.90
"20240102","1783","9875","9800",元大-土城永寧,1,9,8,-1,3.86
"20240102","1783","1560","1560",港商野村,6,0,6,1,2.90
"20240102","1783","003700300030005a","7000",兆豐-高雄,0,6,6,-1,2.90
"20240102","1783","6381","6380",光和-溪湖,6,0,6,1,2.90
"20240102","1783","0039003100380064","9100",群益金鼎-內湖,0,6,6,-1,2.90
"20240102","1783","9676","9600",富邦-仁愛,5,1,4,1,1.93
"20240102","1783","0039004100390037","9A00",永豐金-新竹,0,6,6,-1,2.90
"20240102","1783","9188","9100",群益金鼎-三民,6,3,3,1,1.45
"20240102","1783","1260","1260",宏遠證券,0,4,4,-1,1.93
"20240102","1783","9297","9200",凱基-文心,3,0,3,1,1.45
"20240102","1783","003500320036004b","5260",美好-富順,2,6,4,-1,1.93
"20240102","1783","0039003600330041","9600",富邦-八德,3,0,3,1,1.45
"20240102","1783","9604","9600",富邦-陽明,0,3,3,-1,1.45
"20240102","1783","003700300030004c","7000",兆豐-天母,2,0,2,1,0.97
"20240102","1783","003900410039006a","9A00",永豐金-嘉義,0,3,3,-1,1.45
"20240102","1783","0031003000330046","1030",土銀-南港,2,0,2,1,0.97
"20240102","1783","9300","9300",華南永昌,0,2,2,-1,0.97
"20240102","1783","5857","5850",統一-新竹,2,0,2,1,0.97
"20240102","1783","9800","9800",元大證券,0,2,2,-1,0.97
"20240102","1783","8152","8150",台新-新莊,2,0,2,1,0.97
"20240102","1783","5268","5260",美好-台南,0,2,2,-1,0.97
"20240103","1783","7000","7000",兆豐證券,10,0,10,1,4.27
"20240103","1783","003900380039004e","9800",元大-內湖,0,10,10,-1,4.27
"20240103","1783","1560","1560",港商野村,8,1,7,1,2.99
"20240103","1783","1650","1650",新加坡商瑞銀,9,18,9,-1,3.85
"20240103","1783","1440","1440",美林,15,9,6,1,2.56
"20240103","1783","9186","9100",群益金鼎-新竹,1,10,9,-1,3.85
"20240103","1783","9386","9300",華南永昌-東昇,5,0,5,1,2.14
"20240103","1783","8440","8440",摩根大通,8,16,8,-1,3.42
"20240103","1783","003900410039006a","9A00",永豐金-嘉義,10,5,5,1,2.14
"20240103","1783","0039003600310048","9600",富邦-新板,0,7,7,-1,2.99
"20240103","1783","0039003600310058","9600",富邦-大墩,5,1,4,1,1.71
"20240103","1783","9800","9800",元大證券,0,4,4,-1,1.71
"20240103","1783","0037003000300072","7000",兆豐-寶成,3,0,3,1,1.28
"20240103","1783","0039003800310079","9800",元大-善化,0,4,4,-1,1.71
"20240103","1783","0039003800320043","9800",元大-六合,3,0,3,1,1.28
"20240103","1783","9814","9800",元大-大益,0,3,3,-1,1.28
"20240103","1783","9872","9800",元大-復北,4,1,3,1,1.28
"20240103","1783","1470","1470",台灣摩根士丹利,0,2,2,-1,0.85
"20240103","1783","0039004100390038","9A00",永豐金-大園,3,0,3,1,1.28
"20240103","1783","8560","8560",新光,3,5,2,-1,0.85
"20240103","1783","1021","1020",合庫-台中,2,0,2,1,0.85
"20240103","1783","9255","9200",凱基-和平,0,2,2,-1,0.85
"20240103","1783","0035003800350045","5850",統一-新營,2,0,2,1,0.85
"20240103","1783","9275","9200",凱基-三多,0,2,2,-1,0.85
"20240103","1783","0035003900320050","5920",元富-同大,3,1,2,1,0.85
"20240103","1783","9322","9300",華南永昌-公誠,1,3,2,-1,0.85
"20240103","1783","0035003900320075","5920",元富-世貿,2,0,2,1,0.85
"20240103","1783","0039003600310043","9600",富邦-南京,0,2,2,-1,0.85
"20240104","1783","9875","9800",元大-土城永寧,13,0,13,1,13.27
"20240104","1783","7007","7000",兆豐-竹北,0,6,6,-1,6.12
"20240104","1783","1560","1560",港商野村,9,1,8,1,8.16
"20240104","1783","9188","9100",群益金鼎-三民,0,6,6,-1,6.12
"20240104","1783","9676","9600",富邦-仁愛,6,0,6,1,6.12
"20240104","1783","0039003800390044","9800",元大-左營,0,6,6,-1,6.12
"20240104","1783","9285","9200",凱基-中壢,5,0,5,1,5.10
"20240104","1783","9665","9600",富邦-桃園,0,5,5,-1,5.10
"20240104","1783","9871","9800",元大-忠孝,5,0,5,1,5.10
"20240104","1783","9815","9800",元大-大灣,0,5,5,-1,5.10
"20240104","1783","1480","1480",美商高盛,4,0,4,1,4.08
"20240104","1783","0039003800330055","9800",元大-頭份,0,5,5,-1,5.10
"20240104","1783","1440","1440",美林,6,3,3,1,3.06
"20240104","1783","0035003300380050","5380",第一金-路竹,0,4,4,-1,4.08
"20240104","1783","0035003800350045","5850",統一-新營,2,0,2,1,2.04
"20240104","1783","0039003800390057","9800",元大-豐原站前,0,3,3,-1,3.06
"20240104","1783","0035003300380049","5380",第一金-頭份,2,0,2,1,2.04
"20240104","1783","1650","1650",新加坡商瑞銀,1,3,2,-1,2.04
"20240104","1783","1030","1030",土銀,2,0,2,1,2.04
"20240104","1783","5862","5860",盈溢-楠梓,0,2,2,-1,2.04
"20240104","1783","6451","6450",永全-南崁,2,0,2,1,2.04
"20240104","1783","6450","6450",永全證券,0,2,2,-1,2.04
"20240104","1783","0039003200300048","9200",凱基-基隆,2,0,2,1,2.04
"20240104","1783","8440","8440",摩根大通,0,2,2,-1,2.04
"20240104","1783","9255","9200",凱基-和平,2,0,2,1,2.04
"20240104","1783","0039003100330044","9100",群益金鼎-潭子,0,2,2,-1,2.04
"20240104","1783","9692","9600",富邦-嘉義,2,0,2,1,2.04
"20240104","1783","0039003600310058","9600",富邦-大墩,0,2,2,-1,2.04
"20240105","1783","9875","9800",元大-土城永寧,12,0,12,1,4.69
"20240105","1783","9268","9200",凱基-台北,4,27,23,-1,8.98
"20240105","1783","003700300030005a","7000",兆豐-高雄,11,0,11,1,4.30
"20240105","1783","1650","1650",新加坡商瑞銀,5,19,14,-1,5.47
"20240105","1783","003900380039004a","9800",元大-彰化民生,11,0,11,1,4.30
"20240105","1783","0039004100390041","9A00",永豐金-羅東,0,9,9,-1,3.52
"20240105","1783","0039003800310079","9800",元大-善化,9,0,9,1,3.52
"20240105","1783","8440","8440",摩根大通,1,9,8,-1,3.13
"20240105","1783","1560","1560",港商野村,13,4,9,1,3.52
"20240105","1783","0039004100360031","9A00",永豐金-鳳山,0,8,8,-1,3.13
"20240105","1783","0039003600320043","9600",富邦-東門,8,0,8,1,3.13
"20240105","1783","9366","9300",華南永昌-豐原,0,7,7,-1,2.73
"20240105","1783","8888","8880",國泰-敦南,6,0,6,1,2.34
"20240105","1783","9229","9200",凱基-中山,0,6,6,-1,2.34
"20240105","1783","9326","9300",華南永昌-南京,6,0,6,1,2.34
"20240105","1783","9319","9300",華南永昌-鶯歌,0,5,5,-1,1.95
"20240105","1783","0035003300380042","5380",第一金-新竹,5,0,5,1,1.95
"20240105","1783","9386","9300",華南永昌-東昇,0,5,5,-1,1.95
"20240105","1783","7750","7750",北城證券,5,0,5,1,1.95
"20240105","1783","9815","9800",元大-大灣,0,5,5,-1,1.95
"20240105","1783","9817","9800",元大-東泰,5,0,5,1,1.95
"20240105","1783","5850","5850",統一,0,4,4,-1,1.56
"20240105","1783","9871","9800",元大-忠孝,5,0,5,1,1.95
"20240105","1783","9692","9600",富邦-嘉義,0,4,4,-1,1.56
"20240105","1783","9878","9800",元大-金華,5,0,5,1,1.95
"20240105","1783","1480","1480",美商高盛,1,4,3,-1,1.17
"20240105","1783","003500320036004b","5260",美好-富順,4,1,3,1,1.17
"20240105","1783","003900310038004b","9100",群益金鼎-東湖,0,3,3,-1,1.17
"20240108","1783","7750","7750",北城證券,15,0,15,1,6.58
"20240108","1783","1650","1650",新加坡商瑞銀,1,26,25,-1,10.96
"20240108","1783","0038003800340042","8840",玉山-台中,10,0,10,1,4.39
"20240108","1783","1480","1480",美商高盛,0,17,17,-1,7.46
"20240108","1783","1590","1590",花旗環球,9,0,9,1,3.95
"20240108","1783","8440","8440",摩根大通,0,12,12,-1,5.26
"20240108","1783","5320","5320",高橋,10,1,9,1,3.95
"20240108","1783","5384","5380",第一金-台南,0,10,10,-1,4.39
"20240108","1783","0035003900320062","5920",元富-板橋,7,0,7,1,3.07
"20240108","1783","9366","9300",華南永昌-豐原,0,10,10,-1,4.39
"20240108","1783","0039003800310079","9800",元大-善化,6,0,6,1,2.63
"20240108","1783","0039003600320043","9600",富邦-東門,0,8,8,-1,3.51
"20240108","1783","0039003800330056","9800",元大-竹南,6,0,6,1,2.63
"20240108","1783","0039003800310046","9800",元大-福營,0,7,7,-1,3.07
"20240108","1783","0039004100390037","9A00",永豐金-新竹,6,0,6,1,2.63
"20240108","1783","9661","9600",富邦-新店,0,7,7,-1,3.07
"20240108","1783","6381","6380",光和-溪湖,5,0,5,1,2.19
"20240108","1783","1440","1440",美林,0,5,5,-1,2.19
"20240108","1783","0039003200300045","9200",凱基-東門,5,0,5,1,2.19
"20240108","1783","9894","9800",元大-桃興,0,4,4,-1,1.75
"20240108","1783","003900380031004c","9800",元大-莒光,5,0,5,1,2.19
"20240108","1783","003900380031004e","9800",元大-金門,0,3,3,-1,1.32
"20240108","1783","8560","8560",新光,4,0,4,1,1.75
"20240108","1783","1470","1470",台灣摩根士丹利,0,2,2,-1,0.88
"20240108","1783","0039003100300044","9100",群益金鼎-市府,4,0,4,1,1.75
"20240108","1783","0035003900320050","5920",元富-同大,0,2,2,-1,0.88
"20240108","1783","9202","9200",凱基-中港,4,0,4,1,1.75
"20240108","1783","6164","6160",中國信託-文心,0,2,2,-1,0.88
"20240109","1783","6161","6160",中國信託-三重,15,0,15,1,8.11
"20240109","1783","8849","8840",玉山-景美,0,19,19,-1,10.27
"20240109","1783","1590","1590",花旗環球,8,0,8,1,4.32
"20240109","1783","9268","9200",凱基-台北,4,17,13,-1,7.03
"20240109","1783","003900380033004e","9800",元大-大安,5,0,5,1,2.70
"20240109","1783","8440","8440",摩根大通,4,14,10,-1,5.41
"20240109","1783","9285","9200",凱基-中壢,4,0,4,1,2.16
"20240109","1783","5321","5320",高橋-龍潭,0,10,10,-1,5.41
"20240109","1783","9817","9800",元大-東泰,4,0,4,1,2.16
"20240109","1783","9856","9800",元大-花蓮,0,8,8,-1,4.32
"20240109","1783","0039003800310079","9800",元大-善化,3,0,3,1,1.62
"20240109","1783","1440","1440",美林,4,10,6,-1,3.24
"20240109","1783","0035003800350052","5850",統一-汐止,3,0,3,1,1.62
"20240109","1783","5850","5850",統一,0,6,6,-1,3.24
"20240109","1783","9676","9600",富邦-仁愛,3,0,3,1,1.62
"20240109","1783","1560","1560",港商野村,0,5,5,-1,2.70
"20240109","1783","9813","9800",元大-八德,3,0,3,1,1.62
"20240109","1783","9815","9800",元大-大灣,0,4,4,-1,2.16
"20240109","1783","0039003800390051","9800",元大-汐止,3,0,3,1,1.62
"20240109","1783","0039003800330055","9800",元大-頭份,0,4,4,-1,2.16
"20240109","1783","0035003800350044","5850",統一-新台中,2,0,2,1,1.08
"20240109","1783","0031003000330046","1030",土銀-南港,0,3,3,-1,1.62
"20240109","1783","0039003600310043","9600",富邦-南京,2,0,2,1,1.08
"20240109","1783","0038003400350046","8450",康和-仁愛,0,3,3,-1,1.62
"20240109","1783","9659","9600",富邦-高雄,2,0,2,1,1.08
"20240109","1783","9185","9100",群益金鼎-台南,0,3,3,-1,1.62
"20240109","1783","8563","8560",新光-新竹,2,0,2,1,1.08
"20240109","1783","0039003200310047","9200",凱基-五股,0,3,3,-1,1.62
"20240110","1783","7006","7000",兆豐-台南,12,0,12,1,5.48
"20240110","1783","1650","1650",新加坡商瑞銀,5,39,34,-1,15.53
"20240110","1783","8842","8840",玉山-新莊,10,0,10,1,4.57
"20240110","1783","1480","1480",美商高盛,0,18,18,-1,8.22
"20240110","1783","9875","9800",元大-土城永寧,10,0,10,1,4.57
"20240110","1783","1440","1440",美林,5,17,12,-1,5.48
"20240110","1783","0031003200360069","1260",宏遠-光隆,9,0,9,1,4.11
"20240110","1783","003900360032004a","9600",富邦-三峽,0,11,11,-1,5.02
"20240110","1783","5321","5320",高橋-龍潭,7,0,7,1,3.20
"20240110","1783","5322","5320",高橋-中壢,0,10,10,-1,4.57
"20240110","1783","0039003800310046","9800",元大-福營,6,0,6,1,2.74
"20240110","1783","1560","1560",港商野村,0,9,9,-1,4.11
"20240110","1783","1022","1020",合庫-台南,6,1,5,1,2.28
"20240110","1783","9278","9200",凱基-永康,0,9,9,-1,4.11
"20240110","1783","6161","6160",中國信託-三重,5,0,5,1,2.28
"20240110","1783","8440","8440",摩根大通,0,7,7,-1,3.20
"20240110","1783","0037003000300068","7000",兆豐-三民,5,0,5,1,2.28
"20240110","1783","0039003800310068","9800",元大-屏東民生,0,6,6,-1,2.74
"20240110","1783","003700300030005a","7000",兆豐-高雄,5,0,5,1,2.28
"20240110","1783","8849","8840",玉山-景美,0,4,4,-1,1.83
"20240110","1783","9817","9800",元大-東泰,7,2,5,1,2.28
"20240110","1783","9647","9600",富邦-新竹,0,4,4,-1,1.83
"20240110","1783","0039003800310079","9800",元大-善化,6,1,5,1,2.28
"20240110","1783","0035003300380042","5380",第一金-新竹,0,3,3,-1,1.37
"20240110","1783","0039003800310067","9800",元大-大里,4,0,4,1,1.83
"20240110","1783","0031003200360044","1260",宏遠-台南,0,3,3,-1,1.37
"20240110","1783","0031003000340041","1040",臺銀-臺中,4,0,4,1,1.83
"20240110","1783","0035003300380059","5380",第一金-中壢,0,3,3,-1,1.37
"20240111","1783","9268","9200",凱基-台北,6,0,6,1,4.65
"20240111","1783","0039003100380057","9100",群益金鼎-忠孝,0,20,20,-1,15.50
"20240111","1783","6161","6160",中國信託-三重,5,0,5,1,3.88
"20240111","1783","9255","9200",凱基-和平,0,16,16,-1,12.40
"20240111","1783","003700300030005a","7000",兆豐-高雄,5,0,5,1,3.88
"20240111","1783","0035003900320048","5920",元富-信義,0,5,5,-1,3.88
"20240111","1783","0039003800320042","9800",元大-博愛,4,0,4,1,3.10
"20240111","1783","9692","9600",富邦-嘉義,0,5,5,-1,3.88
"20240111","1783","8560","8560",新光,3,0,3,1,2.33
"20240111","1783","9655","9600",富邦-板橋,0,3,3,-1,2.33
"20240111","1783","0031003000340041","1040",臺銀-臺中,3,0,3,1,2.33
"20240111","1783","0035003900320076","5920",元富-桃園,0,3,3,-1,2.33
"20240111","1783","0037003700390050","7790",國票-九鼎,3,0,3,1,2.33
"20240111","1783","0037003000300063","7000",兆豐-民生,0,3,3,-1,2.33
"20240111","1783","9875","9800",元大-土城永寧,3,0,3,1,2.33
"20240111","1783","0039004100300030","9A00",永豐金證券,0,3,3,-1,2.33
"20240111","1783","003500330038004e","5380",第一金-豐原,2,0,2,1,1.55
"20240111","1783","003500390032006d","5920",元富-成功,0,2,2,-1,1.55
"20240111","1783","0035003300380049","5380",第一金-頭份,2,0,2,1,1.55
"20240111","1783","6164","6160",中國信託-文心,0,2,2,-1,1.55
"20240111","1783","1028","1020",合庫-彰化,2,0,2,1,1.55
"20240111","1783","5925","5920",元富-台中,0,2,2,-1,1.55
"20240111","1783","6167","6160",中國信託-松江,2,0,2,1,1.55
"20240111","1783","9186","9100",群益金鼎-新竹,0,2,2,-1,1.55
"20240111","1783","6381","6380",光和-溪湖,2,0,2,1,1.55
"20240111","1783","0039003200300048","9200",凱基-基隆,0,2,2,-1,1.55
"20240111","1783","0037003000300052","7000",兆豐-小港,2,0,2,1,1.55
"20240111","1783","1440","1440",美林,5,6,1,-1,0.78
"20240112","1783","0037003000300066","7000",兆豐-鹿港,10,0,10,1,13.33
"20240112","1783","8380","8380",安泰,0,5,5,-1,6.67
"20240112","1783","0031003000320045","1020",合庫-桃園,8,0,8,1,10.67
"20240112","1783","9255","9200",凱基-和平,0,5,5,-1,6.67
"20240112","1783","8883","8880",國泰-松江,4,0,4,1,5.33
"20240112","1783","9833","9800",元大-敦化,0,5,5,-1,6.67
"20240112","1783","0035003900320077","5920",元富-佳里,3,0,3,1,4.00
"20240112","1783","9875","9800",元大-土城永寧,0,5,5,-1,6.67
"20240112","1783","5856","5850",統一-台中,3,0,3,1,4.00
"20240112","1783","8849","8840",玉山-景美,0,4,4,-1,5.33
"20240112","1783","8560","8560",新光,3,0,3,1,4.00
"20240112","1783","9869","9800",元大-新盛,0,3,3,-1,4.00
"20240112","1783","0031003000330043","1030",土銀-白河,2,0,2,1,2.67
"20240112","1783","1650","1650",新加坡商瑞銀,2,4,2,-1,2.67
"20240112","1783","5859","5850",統一-屏東,2,0,2,1,2.67
"20240112","1783","1041","1040",臺銀-鳳山,0,2,2,-1,2.67
"20240112","1783","003700300030005a","7000",兆豐-高雄,2,0,2,1,2.67
"20240112","1783","8150","8150",台新證券,1,3,2,-1,2.67
"20240112","1783","003900380031006d","9800",元大-前金,2,0,2,1,2.67
"20240112","1783","8843","8840",玉山-高雄,0,2,2,-1,2.67
"20240112","1783","9868","9800",元大-文心,2,0,2,1,2.67
"20240112","1783","003800380038004b","8880",國泰-板橋,0,2,2,-1,2.67
"20240112","1783","0035003900320075","5920",元富-世貿,1,0,1,1,1.33
"20240112","1783","0039003800350043","9800",元大-鳳中,0,2,2,-1,2.67
"20240112","1783","003500320036004b","5260",美好-富順,2,1,1,1,1.33
"20240112","1783","0035003800350044","5850",統一-新台中,0,1,1,-1,1.33
"20240112","1783","0038003100350042","8150",台新-台中,1,0,1,1,1.33
"20240112","1783","6382","6380",光和-田中,0,1,1,-1,1.33
"20240115","1783","1440","1440",美林,17,3,14,1,11.29
"20240115","1783","9817","9800",元大-東泰,0,12,12,-1,9.68
"20240115","1783","1650","1650",新加坡商瑞銀,15,1,14,1,11.29
"20240115","1783","0031003200360069","1260",宏遠-光隆,0,10,10,-1,8.06
"20240115","1783","0031003000320045","1020",合庫-桃園,10,0,10,1,8.06
"20240115","1783","8492","8490",京城-嘉義,0,10,10,-1,8.06
"20240115","1783","9103","9100",群益金鼎-松山,10,1,9,1,7.26
"20240115","1783","9331","9300",華南永昌-鳳山,0,7,7,-1,5.65
"20240115","1783","003700300030004c","7000",兆豐-天母,6,1,5,1,4.03
"20240115","1783","0035003900320075","5920",元富-世貿,0,5,5,-1,4.03
"20240115","1783","9208","9200",凱基-桃園,3,0,3,1,2.42
"20240115","1783","1480","1480",美商高盛,1,5,4,-1,3.23
"20240115","1783","9215","9200",凱基-高美館,4,1,3,1,2.42
"20240115","1783","1470","1470",台灣摩根士丹利,0,4,4,-1,3.23
"20240115","1783","0035003300380059","5380",第一金-中壢,2,0,2,1,1.61
"20240115","1783","1590","1590",花旗環球,0,4,4,-1,3.23
"20240115","1783","9225","9200",凱基-內埔,2,0,2,1,1.61
"20240115","1783","8440","8440",摩根大通,0,4,4,-1,3.23
"20240115","1783","0039003800300044","9800",元大-北府,2,0,2,1,1.61
"20240115","1783","1560","1560",港商野村,0,3,3,-1,2.42
"20240115","1783","0039003800310067","9800",元大-大里,2,0,2,1,1.61
"20240115","1783","0031003000330043","1030",土銀-白河,0,2,2,-1,1.61
"20240115","1783","0039003800330055","9800",元大-頭份,2,0,2,1,1.61
"20240115","1783","0037003000300063","7000",兆豐-民生,0,2,2,-1,1.61
"20240115","1783","8888","8880",國泰-敦南,1,0,1,1,0.81
"20240115","1783","0037003000300052","7000",兆豐-小港,0,2,2,-1,1.61
"20240115","1783","1118","1110",台灣企銀-豐原,1,0,1,1,0.81
"20240115","1783","0039003100330067","9100",群益金鼎-三重,0,2,2,-1,1.61
"20240116","1783","9204","9200",凱基-台中,21,0,21,1,8.50
"20240116","1783","6380","6380",光和,0,23,23,-1,9.31
"20240116","1783","9661","9600",富邦-新店,10,0,10,1,4.05
"20240116","1783","1650","1650",新加坡商瑞銀,0,16,16,-1,6.48
"20240116","1783","6161","6160",中國信託-三重,10,0,10,1,4.05
"20240116","1783","9614","9600",富邦-基隆,0,9,9,-1,3.64
"20240116","1783","9359","9300",華南永昌-中正,10,2,8,1,3.24
"20240116","1783","1590","1590",花旗環球,0,8,8,-1,3.24
"20240116","1783","0039003800310079","9800",元大-善化,6,0,6,1,2.43
"20240116","1783","1470","1470",台灣摩根士丹利,0,7,7,-1,2.83
"20240116","1783","1039","1030",土銀-士林,5,0,5,1,2.02
"20240116","1783","5321","5320",高橋-龍潭,0,7,7,-1,2.83
"20240116","1783","7032","7030",致和-佳里,5,0,5,1,2.02
"20240116","1783","003700300030004c","7000",兆豐-天母,0,5,5,-1,2.02
"20240116","1783","0039003800330056","9800",元大-竹南,5,0,5,1,2.02
"20240116","1783","1440","1440",美林,0,4,4,-1,1.62
"20240116","1783","0039004100390042","9A00",永豐金-中和,5,0,5,1,2.02
"20240116","1783","9136","9100",群益金鼎-西松,0,4,4,-1,1.62
"20240116","1783","8150","8150",台新證券,4,0,4,1,1.62
"20240116","1783","9817","9800",元大-東泰,8,12,4,-1,1.62
"20240116","1783","9319","9300",華南永昌-鶯歌,4,0,4,1,1.62
"20240116","1783","0039003800380042","9800",元大-桃園,0,4,4,-1,1.62
"20240116","1783","003900360031004e","9600",富邦-西壢,4,0,4,1,1.62
"20240116","1783","8847","8840",玉山-台南,0,3,3,-1,1.21
"20240116","1783","8883","8880",國泰-松江,3,0,3,1,1.21
"20240116","1783","9268","9200",凱基-台北,7,10,3,-1,1.21
"20240116","1783","003500320036004b","5260",美好-富順,3,0,3,1,1.21
"20240116","1783","0031003000320043","1020",合庫-自強,0,1,1,-1,0.40
"20240117","1783","9812","9800",元大-台中,20,0,20,1,6.56
"20240117","1783","1650","1650",新加坡商瑞銀,6,43,37,-1,12.13
"20240117","1783","7006","7000",兆豐-台南,15,0,15,1,4.92
"20240117","1783","9268","9200",凱基-台北,7,36,29,-1,9.51
"20240117","1783","9800","9800",元大證券,15,4,11,1,3.61
"20240117","1783","1440","1440",美林,0,17,17,-1,5.57
"20240117","1783","5320","5320",高橋,10,0,10,1,3.28
"20240117","1783","1590","1590",花旗環球,0,9,9,-1,2.95
"20240117","1783","6161","6160",中國信託-三重,10,0,10,1,3.28
"20240117","1783","1470","1470",台灣摩根士丹利,0,8,8,-1,2.62
"20240117","1783","6382","6380",光和-田中,10,0,10,1,3.28
"20240117","1783","9218","9200",凱基-大直,0,8,8,-1,2.62
"20240117","1783","0037003000300066","7000",兆豐-鹿港,10,0,10,1,3.28
"20240117","1783","8440","8440",摩根大通,2,9,7,-1,2.30
"20240117","1783","8560","8560",新光,8,0,8,1,2.62
"20240117","1783","1480","1480",美商高盛,0,6,6,-1,1.97
"20240117","1783","9255","9200",凱基-和平,8,0,8,1,2.62
"20240117","1783","9136","9100",群益金鼎-西松,0,6,6,-1,1.97
"20240117","1783","9326","9300",華南永昌-南京,8,0,8,1,2.62
"20240117","1783","0035003900320072","5920",元富-城東,0,4,4,-1,1.31
"20240117","1783","0039003800390055","9800",元大-大甲,6,0,6,1,1.97
"20240117","1783","003800380038004b","8880",國泰-板橋,0,3,3,-1,0.98
"20240117","1783","0039004100390042","9A00",永豐金-中和,6,0,6,1,1.97
"20240117","1783","9225","9200",凱基-內埔,2,5,3,-1,0.98
"20240117","1783","8881","8880",國泰-高雄,5,0,5,1,1.64
"20240117","1783","0039004100390031","9A00",永豐金-松山,0,3,3,-1,0.98
"20240117","1783","9369","9300",華南永昌-三重,5,0,5,1,1.64
"20240117","1783","9667","9600",富邦-台南,0,3,3,-1,0.98
"20240118","1783","9268","9200",凱基-台北,13,1,12,1,13.48
"20240118","1783","1440","1440",美林,3,9,6,-1,6.74
"20240118","1783","6161","6160",中國信託-三重,7,0,7,1,7.87
"20240118","1783","9623","9600",富邦-台北,0,6,6,-1,6.74
"20240118","1783","9234","9200",凱基-竹北,5,0,5,1,5.62
"20240118","1783","9297","9200",凱基-文心,0,3,3,-1,3.37
"20240118","1783","003900380033005a","9800",元大-鳳山,3,0,3,1,3.37
"20240118","1783","8849","8840",玉山-景美,0,2,2,-1,2.25
"20240118","1783","0039003800390051","9800",元大-汐止,2,0,2,1,2.25
"20240118","1783","9137","9100",群益金鼎-士林,0,2,2,-1,2.25
"20240118","1783","6463","6460",大昌-新竹,2,0,2,1,2.25
"20240118","1783","9647","9600",富邦-新竹,0,2,2,-1,2.25
"20240118","1783","7005","7000",兆豐-台中港,2,0,2,1,2.25
"20240118","1783","1560","1560",港商野村,0,1,1,-1,1.12
"20240118","1783","7750","7750",北城證券,2,0,2,1,2.25
"20240118","1783","1480","1480",美商高盛,0,1,1,-1,1.12
"20240118","1783","9816","9800",元大-新竹,2,0,2,1,2.25
"20240118","1783","0035003300380045","5380",第一金-自由,0,1,1,-1,1.12
"20240118","1783","0039004100390039","9A00",永豐金-中壢,2,0,2,1,2.25
"20240118","1783","1232","1230",彰銀-七賢,0,1,1,-1,1.12
"20240118","1783","0031003000340043","1040",臺銀-高雄,1,0,1,1,1.12
"20240118","1783","5925","5920",元富-台中,0,1,1,-1,1.12
"20240118","1783","5850","5850",統一,1,0,1,1,1.12
"20240118","1783","8440","8440",摩根大通,2,3,1,-1,1.12
"20240118","1783","1029","1020",合庫-鳳山,1,0,1,1,1.12
"20240118","1783","9189","9100",群益金鼎-桃園,1,2,1,-1,1.12
"20240118","1783","0035003900320044","5920",元富-大昌,1,0,1,1,1.12
"20240118","1783","0039003600350055","9600",富邦-彰化,0,1,1,-1,1.12
"20240119","1783","9268","9200",凱基-台北,12,3,9,1,9.47
"20240119","1783","5920","5920",元富,1,16,15,-1,15.79
"20240119","1783","0031003000320045","1020",合庫-桃園,5,0,5,1,5.26
"20240119","1783","0039004100390043","9A00",永豐金-員林,0,11,11,-1,11.58
"20240119","1783","6161","6160",中國信託-三重,5,0,5,1,5.26
"20240119","1783","1039","1030",土銀-士林,0,5,5,-1,5.26
"20240119","1783","7032","7030",致和-佳里,5,0,5,1,5.26
"20240119","1783","9229","9200",凱基-中山,0,5,5,-1,5.26
"20240119","1783","9272","9200",凱基-竹科,5,0,5,1,5.26
"20240119","1783","1440","1440",美林,2,6,4,-1,4.21
"20240119","1783","003900410039004c","9A00",永豐金-台中,5,0,5,1,5.26
"20240119","1783","7000","7000",兆豐證券,0,3,3,-1,3.16
"20240119","1783","5855","5850",統一-台南,2,0,2,1,2.11
"20240119","1783","9834","9800",元大-中壢,0,3,3,-1,3.16
"20240119","1783","0035003300380042","5380",第一金-新竹,2,0,2,1,2.11
"20240119","1783","0031003000340043","1040",臺銀-高雄,0,3,3,-1,3.16
"20240119","1783","0035003900320072","5920",元富-城東,2,0,2,1,2.11
"20240119","1783","8150","8150",台新證券,0,2,2,-1,2.11
"20240119","1783","6110","6110",台中銀,2,0,2,1,2.11
"20240119","1783","1590","1590",花旗環球,0,2,2,-1,2.11
"20240119","1783","8840","8840",玉山證券,2,0,2,1,2.11
"20240119","1783","8585","8580",聯邦-三重,0,2,2,-1,2.11
"20240119","1783","8842","8840",玉山-新莊,2,0,2,1,2.11
"20240119","1783","8849","8840",玉山-景美,0,2,2,-1,2.11
"20240119","1783","0039003200300048","9200",凱基-基隆,2,0,2,1,2.11
"20240119","1783","9349","9300",華南永昌-板橋,0,2,2,-1,2.11
"20240119","1783","003900380033004b","9800",元大-學甲,2,0,2,1,2.11
"20240119","1783","9676","9600",富邦-仁愛,0,2,2,-1,2.11
"20240122","1783","1650","1650",新加坡商瑞銀,28,1,27,1,18.37
"20240122","1783","9614","9600",富邦-基隆,0,20,20,-1,13.61
"20240122","1783","003700370039006d","7790",國票-中港,10,0,10,1,6.80
"20240122","1783","0038003400350044","8450",康和-板橋,0,15,15,-1,10.20
"20240122","1783","9867","9800",元大-內湖民權,10,0,10,1,6.80
"20240122","1783","8847","8840",玉山-台南,0,9,9,-1,6.12
"20240122","1783","1570","1570",港商法國興業,8,0,8,1,5.44
"20240122","1783","5856","5850",統一-台中,0,5,5,-1,3.40
"20240122","1783","003700300030004c","7000",兆豐-天母,5,0,5,1,3.40
"20240122","1783","0035003900320055","5920",元富-宜蘭,0,3,3,-1,2.04
"20240122","1783","9667","9600",富邦-台南,5,0,5,1,3.40
"20240122","1783","0038003400350058","8450",康和-屏東,0,3,3,-1,2.04
"20240122","1783","003700300030006b","7000",兆豐-員林,2,0,2,1,1.36
"20240122","1783","9647","9600",富邦-新竹,0,3,3,-1,2.04
"20240122","1783","003500390032006f","5920",元富-新興,2,0,2,1,1.36
"20240122","1783","9834","9800",元大-中壢,0,3,3,-1,2.04
"20240122","1783","0039003100380043","9100",群益金鼎-古亭,2,0,2,1,1.36
"20240122","1783","1590","1590",花旗環球,0,2,2,-1,1.36
"20240122","1783","9275","9200",凱基-三多,2,0,2,1,1.36
"20240122","1783","1440","1440",美林,4,6,2,-1,1.36
"20240122","1783","003900380039006a","9800",元大-樹林,2,0,2,1,1.36
"20240122","1783","8150","8150",台新證券,0,2,2,-1,1.36
"20240122","1783","0039003800390055","9800",元大-大甲,2,0,2,1,1.36
"20240122","1783","9255","9200",凱基-和平,0,2,2,-1,1.36
"20240122","1783","1116","1110",台灣企銀-屏東,1,0,1,1,0.68
"20240122","1783","003900380033004e","9800",元大-大安,0,2,2,-1,1.36
"20240122","1783","0031003000340043","1040",臺銀-高雄,1,0,1,1,0.68
"20240122","1783","0039004100390039","9A00",永豐金-中壢,0,2,2,-1,1.36
"20240123","1783","003700370039006d","7790",國票-中港,18,0,18,1,16.67
"20240123","1783","8440","8440",摩根大通,0,8,8,-1,7.41
"20240123","1783","9268","9200",凱基-台北,13,2,11,1,10.19
"20240123","1783","8881","8880",國泰-高雄,0,5,5,-1,4.63
"20240123","1783","1440","1440",美林,8,1,7,1,6.48
"20240123","1783","9234","9200",凱基-竹北,0,5,5,-1,4.63
"20240123","1783","9136","9100",群益金鼎-西松,6,0,6,1,5.56
"20240123","1783","8560","8560",新光,0,4,4,-1,3.70
"20240123","1783","1118","1110",台灣企銀-豐原,5,0,5,1,4.63
"20240123","1783","9255","9200",凱基-和平,0,4,4,-1,3.70
"20240123","1783","1040","1040",臺銀,2,0,2,1,1.85
"20240123","1783","0035003900320072","5920",元富-城東,0,3,3,-1,2.78
"20240123","1783","0037003000300063","7000",兆豐-民生,2,0,2,1,1.85
"20240123","1783","003700300030004c","7000",兆豐-天母,0,3,3,-1,2.78
"20240123","1783","003700300030004d","7000",兆豐-桃園,2,0,2,1,1.85
"20240123","1783","9322","9300",華南永昌-基隆,0,3,3,-1,2.78
"20240123","1783","9324","9300",華南永昌-岡山,2,0,2,1,1.85
"20240123","1783","9676","9600",富邦-仁愛,0,3,3,-1,2.78
"20240123","1783","0039003800390041","9800",元大-北投,2,0,2,1,1.85
"20240123","1783","0039003100330059","9100",群益金鼎-館前,0,2,2,-1,1.85
"20240123","1783","003900380039004c","9800",元大-成功,2,0,2,1,1.85
"20240123","1783","0035003800350045","5850",統一-新營,0,2,2,-1,1.85
"20240123","1783","7790","7790",國票證券,1,0,1,1,0.93
"20240123","1783","003500390032006f","5920",元富-新興,1,3,2,-1,1.85
"20240123","1783","0036003000310064","6010",(牛牛牛)亞-鑫豐,1,0,1,1,0.93
"20240123","1783","7750","7750",北城證券,0,2,2,-1,1.85
"20240123","1783","0038003400350042","8450",康和-永和,1,0,1,1,0.93
"20240123","1783","9817","9800",元大-東泰,0,2,2,-1,1.85
"20240124","1783","1560","1560",港商野村,10,0,10,1,6.67
"20240124","1783","9676","9600",富邦-仁愛,0,19,19,-1,12.67
"20240124","1783","6380","6380",光和,10,0,10,1,6.67
"20240124","1783","0039004100390037","9A00",永豐金-新竹,0,12,12,-1,8.00
"20240124","1783","0037003000300066","7000",兆豐-鹿港,10,0,10,1,6.67
"20240124","1783","1480","1480",美商高盛,0,9,9,-1,6.00
"20240124","1783","9812","9800",元大-台中,10,0,10,1,6.67
"20240124","1783","9813","9800",元大-八德,0,5,5,-1,3.33
"20240124","1783","1440","1440",美林,7,3,4,1,2.67
"20240124","1783","0039004100390057","9A00",永豐金-市政,2,6,4,-1,2.67
"20240124","1783","8560","8560",新光,4,0,4,1,2.67
"20240124","1783","9255","9200",凱基-和平,0,4,4,-1,2.67
"20240124","1783","1030","1030",土銀,3,0,3,1,2.00
"20240124","1783","9268","9200",凱基-台北,9,12,3,-1,2.00
"20240124","1783","9824","9800",元大-向上,3,0,3,1,2.00
"20240124","1783","0039003600310058","9600",富邦-大墩,0,3,3,-1,2.00
"20240124","1783","003900380033005a","9800",元大-鳳山,3,0,3,1,2.00
"20240124","1783","9800","9800",元大證券,0,3,3,-1,2.00
"20240124","1783","6160","6160",中國信託,2,0,2,1,1.33
"20240124","1783","0039003200300048","9200",凱基-基隆,0,2,2,-1,1.33
"20240124","1783","8440","8440",摩根大通,8,6,2,1,1.33
"20240124","1783","1040","1040",臺銀,0,2,2,-1,1.33
"20240124","1783","9324","9300",華南永昌-岡山,2,0,2,1,1.33
"20240124","1783","003900380033004b","9800",元大-學甲,0,2,2,-1,1.33
"20240124","1783","0031003000330041","1030",土銀-建國,1,0,1,1,0.67
"20240124","1783","0039003800390067","9800",元大-嘉義,0,2,2,-1,1.33
"20240124","1783","5383","5380",第一金-高雄,1,0,1,1,0.67
"20240124","1783","0039003800310079","9800",元大-善化,0,2,2,-1,1.33
"20240125","1783","9623","9600",富邦-台北,16,0,16,1,15.09
"20240125","1783","9837","9800",元大-北港,0,18,18,-1,16.98
"20240125","1783","0037003000300070","7000",兆豐-復興,8,0,8,1,7.55
"20240125","1783","9268","9200",凱基-台北,0,15,15,-1,14.15
"20240125","1783","0035003900320055","5920",元富-宜蘭,4,0,4,1,3.77
"20240125","1783","1110","1110",台灣企銀,1,4,3,-1,2.83
"20240125","1783","0039003800310079","9800",元大-善化,4,0,4,1,3.77
"20240125","1783","0039004100390050","9A00",永豐金-竹北,0,2,2,-1,1.89
"20240125","1783","8560","8560",新光,3,0,3,1,2.83
"20240125","1783","0035003800350045","5850",統一-新營,0,2,2,-1,1.89
"20240125","1783","0037003000300063","7000",兆豐-民生,3,0,3,1,2.83
"20240125","1783","003700300030004c","7000",兆豐-天母,0,2,2,-1,1.89
"20240125","1783","9134","9100",群益金鼎-開元,3,0,3,1,2.83
"20240125","1783","003700300030005a","7000",兆豐-高雄,1,3,2,-1,1.89
"20240125","1783","0039003200310046","9200",凱基-天母,3,0,3,1,2.83
"20240125","1783","8440","8440",摩根大通,0,2,2,-1,1.89
"20240125","1783","8888","8880",國泰-敦南,2,0,2,1,1.89
"20240125","1783","8842","8840",玉山-新莊,0,2,2,-1,1.89
"20240125","1783","1024","1020",合庫-嘉義,2,0,2,1,1.89
"20240125","1783","9229","9200",凱基-中山,0,2,2,-1,1.89
"20240125","1783","6381","6380",光和-溪湖,2,0,2,1,1.89
"20240125","1783","9800","9800",元大證券,0,1,1,-1,0.94
"20240125","1783","0039003100380043","9100",群益金鼎-古亭,2,0,2,1,1.89
"20240125","1783","1116","1110",台灣企銀-屏東,0,1,1,-1,0.94
"20240125","1783","0039003600320052","9600",富邦-園區,2,0,2,1,1.89
"20240125","1783","1650","1650",新加坡商瑞銀,0,1,1,-1,0.94
"20240125","1783","9654","9600",富邦-永和,2,0,2,1,1.89
"20240125","1783","003800340035004a","8450",康和-高雄,0,1,1,-1,0.94
"20240126","1783","8440","8440",摩根大通,19,2,17,1,13.18
"20240126","1783","1040","1040",臺銀,0,18,18,-1,13.95
"20240126","1783","1650","1650",新加坡商瑞銀,15,3,12,1,9.30
"20240126","1783","9837","9800",元大-北港,0,13,13,-1,10.08
"20240126","1783","9226","9200",凱基-汐止,10,0,10,1,7.75
"20240126","1783","003900380030004b","9800",元大-竹科,0,7,7,-1,5.43
"20240126","1783","1480","1480",美商高盛,7,0,7,1,5.43
"20240126","1783","8840","8840",玉山證券,0,5,5,-1,3.88
"20240126","1783","0035003800350049","5850",統一-員林,5,0,5,1,3.88
"20240126","1783","0039003800380042","9800",元大-桃園,0,5,5,-1,3.88
"20240126","1783","1440","1440",美林,10,6,4,1,3.10
"20240126","1783","003900410039004c","9A00",永豐金-台中,0,5,5,-1,3.88
"20240126","1783","003500390032006f","5920",元富-新興,4,0,4,1,3.10
"20240126","1783","003700300030004c","7000",兆豐-天母,0,3,3,-1,2.33
"20240126","1783","003700300030005a","7000",兆豐-高雄,3,0,3,1,2.33
"20240126","1783","9667","9600",富邦-台南,0,3,3,-1,2.33
"20240126","1783","9831","9800",元大-四維,2,0,2,1,1.55
"20240126","1783","1028","1020",合庫-彰化,0,2,2,-1,1.55
"20240126","1783","0035003800350044","5850",統一-新台中,2,0,2,1,1.55
"20240126","1783","6110","6110",台中銀,0,2,2,-1,1.55
"20240126","1783","1119","1110",台灣企銀-岡山,2,0,2,1,1.55
"20240126","1783","5961","5960",日茂-埔里,0,2,2,-1,1.55
"20240126","1783","0039003200300048","9200",凱基-基隆,2,0,2,1,1.55
"20240126","1783","6380","6380",光和,0,2,2,-1,1.55
"20240126","1783","9300","9300",華南永昌,3,1,2,1,1.55
"20240126","1783","0039003800310046","9800",元大-福營,0,2,2,-1,1.55
"20240126","1783","0039003600310058","9600",富邦-大墩,2,0,2,1,1.55
"20240126","1783","0039004100380039","9A00",永豐金-敦北,0,2,2,-1,1.55
"20240129","1783","8440","8440",摩根大通,10,0,10,1,16.39
"20240129","1783","9226","9200",凱基-汐止,0,10,10,-1,16.39
"20240129","1783","1440","1440",美林,5,0,5,1,8.20
"20240129","1783","0039004100390037","9A00",永豐金-新竹,0,6,6,-1,9.84
"20240129","1783","9623","9600",富邦-台北,5,0,5,1,8.20
"20240129","1783","1042","1040",臺銀-臺南,0,5,5,-1,8.20
"20240129","1783","9237","9200",凱基-敦北,4,0,4,1,6.56
"20240129","1783","8849","8840",玉山-景美,0,4,4,-1,6.56
"20240129","1783","003700300030004c","7000",兆豐-天母,3,0,3,1,4.92
"20240129","1783","7005","7000",兆豐-台中港,0,2,2,-1,3.28
"20240129","1783","9268","9200",凱基-台北,3,0,3,1,4.92
"20240129","1783","0039003800310045","9800",元大-發財,0,2,2,-1,3.28
"20240129","1783","1650","1650",新加坡商瑞銀,2,0,2,1,3.28
"20240129","1783","1232","1230",彰銀-七賢,0,1,1,-1,1.64
"20240129","1783","5961","5960",日茂-埔里,2,0,2,1,3.28
"20240129","1783","9300","9300",華南永昌,0,1,1,-1,1.64
"20240129","1783","8492","8490",京城-嘉義,2,0,2,1,3.28
"20240129","1783","9604","9600",富邦-陽明,0,1,1,-1,1.64
"20240129","1783","0039003800310071","9800",元大-萬華,2,0,2,1,3.28
"20240129","1783","003900360031004e","9600",富邦-西壢,0,1,1,-1,1.64
"20240129","1783","0035003900320063","5920",元富-烏日,1,0,1,1,1.64
"20240129","1783","9634","9600",富邦-羅東,0,1,1,-1,1.64
"20240129","1783","0035003900320041","5920",元富-緯城,1,0,1,1,1.64
"20240129","1783","9218","9200",凱基-大直,0,1,1,-1,1.64
"20240129","1783","8900","8900",法銀巴黎,1,0,1,1,1.64
"20240129","1783","2180","2180",亞東,0,1,1,-1,1.64
"20240129","1783","003900320030004e","9200",凱基-湖口,1,0,1,1,1.64
"20240130","1783","1440","1440",美林,7,0,7,1,10.00
"20240130","1783","1040","1040",臺銀,0,9,9,-1,12.86
"20240130","1783","8561","8560",新光-台中,5,0,5,1,7.14
"20240130","1783","9268","9200",凱基-台北,2,8,6,-1,8.57
"20240130","1783","0039003100380043","9100",群益金鼎-古亭,5,0,5,1,7.14
"20240130","1783","1042","1040",臺銀-臺南,0,5,5,-1,7.14
"20240130","1783","9812","9800",元大-台中,5,0,5,1,7.14
"20240130","1783","0039003600320050","9600",富邦-頭份,0,4,4,-1,5.71
"20240130","1783","0038003800340041","8840",玉山-士林,4,0,4,1,5.71
"20240130","1783","0039003100380064","9100",群益金鼎-內湖,0,2,2,-1,2.86
"20240130","1783","8840","8840",玉山證券,3,0,3,1,4.29
"20240130","1783","8159","8150",台新-台南,0,2,2,-1,2.86
"20240130","1783","1650","1650",新加坡商瑞銀,2,0,2,1,2.86
"20240130","1783","003700370039004a","7790",國票-北高雄,0,2,2,-1,2.86
"20240130","1783","9359","9300",華南永昌-中正,2,0,2,1,2.86
"20240130","1783","9255","9200",凱基-和平,0,2,2,-1,2.86
"20240130","1783","1480","1480",美商高盛,1,0,1,1,1.43
"20240130","1783","9816","9800",元大-新竹,0,2,2,-1,2.86
"20240130","1783","0035003800350057","5850",統一-金門,1,0,1,1,1.43
"20240130","1783","0039004100390053","9A00",永豐金-南京,0,2,2,-1,2.86
"20240130","1783","8564","8560",新光-台南,1,0,1,1,1.43
"20240130","1783","1470","1470",台灣摩根士丹利,0,1,1,-1,1.43
"20240130","1783","0039003200300057","9200",凱基-大里,1,0,1,1,1.43
"20240130","1783","003700300030005a","7000",兆豐-高雄,2,3,1,-1,1.43
"20240130","1783","9215","9200",凱基-高美館,1,0,1,1,1.43
"20240130","1783","8565","8560",新光-桃園,0,1,1,-1,1.43
"20240130","1783","9275","9200",凱基-三多,1,0,1,1,1.43
"20240130","1783","8849","8840",玉山-景美,0,1,1,-1,1.43
"20240131","1783","1440","1440",美林,22,0,22,1,18.03
"20240131","1783","0039004100390037","9A00",永豐金-新竹,0,17,17,-1,13.93
"20240131","1783","1650","1650",新加坡商瑞銀,14,0,14,1,11.48
"20240131","1783","8849","8840",玉山-景美,0,9,9,-1,7.38
"20240131","1783","8882","8880",國泰-台中,10,0,10,1,8.20
"20240131","1783","9255","9200",凱基-和平,0,7,7,-1,5.74
"20240131","1783","9268","9200",凱基-台北,14,4,10,1,8.20
"20240131","1783","2187","2180",亞東-台中,0,6,6,-1,4.92
"20240131","1783","1590","1590",花旗環球,8,1,7,1,5.74
"20240131","1783","9654","9600",富邦-永和,0,6,6,-1,4.92
"20240131","1783","5383","5380",第一金-高雄,3,0,3,1,2.46
"20240131","1783","0035003800350049","5850",統一-員林,0,5,5,-1,4.10
"20240131","1783","0039003800310065","9800",元大-佳里,3,0,3,1,2.46
"20240131","1783","8561","8560",新光-台中,0,5,5,-1,4.10
"20240131","1783","0031003000330046","1030",土銀-南港,2,0,2,1,1.64
"20240131","1783","0039003600310058","9600",富邦-大墩,0,3,3,-1,2.46
"20240131","1783","0039003200310045","9200",凱基-三峽,2,0,2,1,1.64
"20240131","1783","0039003600320050","9600",富邦-頭份,0,3,3,-1,2.46
"20240131","1783","5855","5850",統一-台南,1,0,1,1,0.82
"20240131","1783","0039004100390057","9A00",永豐金-市政,0,3,3,-1,2.46
"20240131","1783","0035003800350059","5850",統一-土城,1,0,1,1,0.82
"20240131","1783","003700300030004d","7000",兆豐-桃園,0,2,2,-1,1.64
"20240131","1783","6381","6380",光和-溪湖,1,0,1,1,0.82
"20240131","1783","0039004100380046","9A00",永豐金-敦南,0,2,2,-1,1.64
"20240131","1783","8150","8150",台新證券,1,0,1,1,0.82
"20240131","1783","0035003900320041","5920",元富-緯城,0,1,1,-1,0.82
"20240131","1783","9331","9300",華南永昌-鳳山,1,0,1,1,0.82
"20240131","1783","1470","1470",台灣摩根士丹利,0,1,1,-1,0.82
"20240201","1783","8882","8880",國泰-台中,10,0,10,1,8.55
"20240201","1783","0039003800310079","9800",元大-善化,0,10,10,-1,8.55
"20240201","1783","9308","9300",華南永昌-麻豆,10,0,10,1,8.55
"20240201","1783","0039004100390037","9A00",永豐金-新竹,0,10,10,-1,8.55
"20240201","1783","1440","1440",美林,8,0,8,1,6.84
"20240201","1783","1480","1480",美商高盛,4,9,5,-1,4.27
"20240201","1783","1650","1650",新加坡商瑞銀,20,12,8,1,6.84
"20240201","1783","5383","5380",第一金-高雄,0,3,3,-1,2.56
"20240201","1783","9268","9200",凱基-台北,17,10,7,1,5.98
"20240201","1783","9604","9600",富邦-陽明,2,5,3,-1,2.56
"20240201","1783","8561","8560",新光-台中,5,0,5,1,4.27
"20240201","1783","9625","9600",富邦-竹東,0,3,3,-1,2.56
"20240201","1783","0039003800390053","9800",元大-鹿港,5,0,5,1,4.27
"20240201","1783","003500380035004a","5850",統一-三重,0,2,2,-1,1.71
"20240201","1783","1590","1590",花旗環球,2,0,2,1,1.71
"20240201","1783","5961","5960",日茂-埔里,0,2,2,-1,1.71
"20240201","1783","0037003000300073","7000",兆豐-岡山,2,0,2,1,1.71
"20240201","1783","003500320036004b","5260",美好-富順,0,2,2,-1,1.71
"20240201","1783","8560","8560",新光,2,0,2,1,1.71
"20240201","1783","1560","1560",港商野村,0,2,2,-1,1.71
"20240201","1783","9800","9800",元大證券,1,0,1,1,0.85
"20240201","1783","0037003000300052","7000",兆豐-小港,0,2,2,-1,1.71
"20240201","1783","1470","1470",台灣摩根士丹利,1,0,1,1,0.85
"20240201","1783","8849","8840",玉山-景美,0,2,2,-1,1.71
"20240201","1783","003500390032006f","5920",元富-新興,1,0,1,1,0.85
"20240201","1783","0039004100390055","9A00",永豐金-中正,0,2,2,-1,1.71
"20240201","1783","0038003100350042","8150",台新-台中,1,0,1,1,0.85
"20240201","1783","9814","9800",元大-大益,0,2,2,-1,1.71
"20240202","1783","0039003800320043","9800",元大-六合,50,0,50,1,5.95
"20240202","1783","1440","1440",美林,18,68,50,-1,5.95
"20240202","1783","0035003900320049","5920",元富-嘉義,43,0,43,1,5.11
"20240202","1783","0039003600320044","9600",富邦-新莊,0,21,21,-1,2.50
"20240202","1783","8440","8440",摩根大通,69,35,34,1,4.04
"20240202","1783","5320","5320",高橋,0,20,20,-1,2.38
"20240202","1783","9329","9300",華南永昌-朴子,17,0,17,1,2.02
"20240202","1783","6380","6380",光和,0,20,20,-1,2.38
"20240202","1783","1650","1650",新加坡商瑞銀,18,2,16,1,1.90
"20240202","1783","0039003800310079","9800",元大-善化,0,17,17,-1,2.02
"20240202","1783","8562","8560",新光-高雄,17,1,16,1,1.90
"20240202","1783","0039003100380067","9100",群益金鼎-大甲,0,14,14,-1,1.66
"20240202","1783","9654","9600",富邦-永和,13,0,13,1,1.55
"20240202","1783","0031003000340041","1040",臺銀-臺中,1,11,10,-1,1.19
"20240202","1783","1480","1480",美商高盛,45,34,11,1,1.31
"20240202","1783","9871","9800",元大-忠孝,0,10,10,-1,1.19
"20240202","1783","5856","5850",統一-台中,8,0,8,1,0.95
"20240202","1783","0038003800340042","8840",玉山-台中,1,10,9,-1,1.07
"20240202","1783","0031003000320046","1020",合庫-西台中,8,0,8,1,0.95
"20240202","1783","8883","8880",國泰-松江,0,9,9,-1,1.07
"20240202","1783","5262","5260",美好-楊梅,7,0,7,1,0.83
"20240202","1783","9300","9300",華南永昌,0,9,9,-1,1.07
"20240202","1783","0039004100390055","9A00",永豐金-中正,10,3,7,1,0.83
"20240202","1783","1024","1020",合庫-嘉義,0,8,8,-1,0.95
"20240202","1783","0039003100330052","9100",群益金鼎-北高雄,6,0,6,1,0.71
"20240202","1783","0039003800390051","9800",元大-汐止,2,10,8,-1,0.95
"20240202","1783","9636","9600",富邦-中壢,6,0,6,1,0.71
"20240202","1783","0035003900320055","5920",元富-宜蘭,0,7,7,-1,0.83
"20240205","1783","0038003400350045","8450",康和-澎湖,8,0,8,1,4.10
"20240205","1783","8562","8560",新光-高雄,0,15,15,-1,7.69
"20240205","1783","0039003800390051","9800",元大-汐止,8,0,8,1,4.10
"20240205","1783","9268","9200",凱基-台北,1,15,14,-1,7.18
"20240205","1783","0039003800390041","9800",元大-北投,7,0,7,1,3.59
"20240205","1783","1440","1440",美林,7,20,13,-1,6.67
"20240205","1783","9329","9300",華南永昌-朴子,6,0,6,1,3.08
"20240205","1783","8150","8150",台新證券,1,12,11,-1,5.64
"20240205","1783","9623","9600",富邦-台北,7,1,6,1,3.08
"20240205","1783","0039003100330052","9100",群益金鼎-北高雄,0,6,6,-1,3.08
"20240205","1783","0039003800320043","9800",元大-六合,8,2,6,1,3.08
"20240205","1783","0031003000340043","1040",臺銀-高雄,0,5,5,-1,2.56
"20240205","1783","0039004100390055","9A00",永豐金-中正,5,0,5,1,2.56
"20240205","1783","5856","5850",統一-台中,0,5,5,-1,2.56
"20240205","1783","5266","5260",美好-中壢,5,0,5,1,2.56
"20240205","1783","1480","1480",美商高盛,0,4,4,-1,2.05
"20240205","1783","003900380031006e","9800",元大-旗山,5,0,5,1,2.56
"20240205","1783","9657","9600",富邦-苗栗,0,4,4,-1,2.05
"20240205","1783","0039003800310046","9800",元大-福營,4,0,4,1,2.05
"20240205","1783","0039003600310043","9600",富邦-南京,0,3,3,-1,1.54
"20240205","1783","8882","8880",國泰-台中,4,0,4,1,2.05
"20240205","1783","0039003800320042","9800",元大-博愛,0,3,3,-1,1.54
"20240205","1783","8520","8520",中農,4,0,4,1,2.05
"20240205","1783","0039003800390059","9800",元大-基隆,0,3,3,-1,1.54
"20240205","1783","003500390032006f","5920",元富-新興,5,2,3,1,1.54
"20240205","1783","0037003700390072","7790",國票-桃園,0,2,2,-1,1.03
"20240205","1783","003700300030004c","7000",兆豐-天母,3,0,3,1,1.54
"20240205","1783","0039003100380042","9100",群益金鼎-板橋,0,2,2,-1,1.03
"20240215","1783","9268","9200",凱基-台北,46,5,41,1,13.18
"20240215","1783","8880","8880",國泰證券,0,17,17,-1,5.47
"20240215","1783","8440","8440",摩根大通,45,9,36,1,11.58
"20240215","1783","9205","9200",凱基-三重,0,13,13,-1,4.18
"20240215","1783","6168","6160",中國信託-嘉義,20,0,20,1,6.43
"20240215","1783","9359","9300",華南永昌-中正,0,10,10,-1,3.22
"20240215","1783","0039003800320043","9800",元大-六合,13,0,13,1,4.18
"20240215","1783","9661","9600",富邦-新店,0,10,10,-1,3.22
"20240215","1783","1480","1480",美商高盛,15,6,9,1,2.89
"20240215","1783","9665","9600",富邦-桃園,0,10,10,-1,3.22
"20240215","1783","1650","1650",新加坡商瑞銀,11,2,9,1,2.89
"20240215","1783","9812","9800",元大-台中,0,10,10,-1,3.22
"20240215","1783","1590","1590",花旗環球,11,3,8,1,2.57
"20240215","1783","0031003000320046","1020",合庫-西台中,0,8,8,-1,2.57
"20240215","1783","1470","1470",台灣摩根士丹利,7,0,7,1,2.25
"20240215","1783","0039003800390051","9800",元大-汐止,0,8,8,-1,2.57
"20240215","1783","003700300030004c","7000",兆豐-天母,5,0,5,1,1.61
"20240215","1783","9654","9600",富邦-永和,0,6,6,-1,1.93
"20240215","1783","8150","8150",台新證券,5,0,5,1,1.61
"20240215","1783","003900410039005a","9A00",永豐金-復興,0,6,6,-1,1.93
"20240215","1783","0037003000300070","7000",兆豐-復興,4,0,4,1,1.29
"20240215","1783","6165","6160",中國信託-新竹,0,5,5,-1,1.61
"20240215","1783","9854","9800",元大-文心興安,4,0,4,1,1.29
"20240215","1783","0039003800390059","9800",元大-基隆,0,5,5,-1,1.61
"20240215","1783","8560","8560",新光,3,0,3,1,0.96
"20240215","1783","0035003800350044","5850",統一-新台中,0,4,4,-1,1.29
"20240215","1783","0038003800340042","8840",玉山-台中,3,0,3,1,0.96
"20240215","1783","003900360031005a","9600",富邦-永康,0,4,4,-1,1.29
"20240216","1783","9268","9200",凱基-台北,29,6,23,1,9.75
"20240216","1783","1480","1480",美商高盛,1,10,9,-1,3.81
"20240216","1783","1470","1470",台灣摩根士丹利,15,0,15,1,6.36
"20240216","1783","8880","8880",國泰證券,0,8,8,-1,3.39
"20240216","1783","8440","8440",摩根大通,18,10,8,1,3.39
"20240216","1783","1030","1030",土銀,0,7,7,-1,2.97
"20240216","1783","0039003800310067","9800",元大-大里,5,0,5,1,2.12
"20240216","1783","0035003900320045","5920",元富-城中,0,6,6,-1,2.54
"20240216","1783","1650","1650",新加坡商瑞銀,9,4,5,1,2.12
"20240216","1783","0037003000300070","7000",兆豐-復興,0,6,6,-1,2.54
"20240216","1783","6114","6110",台中銀-員林,5,0,5,1,2.12
"20240216","1783","003900380039006a","9800",元大-樹林,0,6,6,-1,2.54
"20240216","1783","0039003800320042","9800",元大-博愛,17,12,5,1,2.12
"20240216","1783","0031003000340041","1040",臺銀-臺中,0,5,5,-1,2.12
"20240216","1783","5385","5380",第一金-桃園,4,0,4,1,1.69
"20240216","1783","003700300030005a","7000",兆豐-高雄,0,5,5,-1,2.12
"20240216","1783","0039003600320045","9600",富邦-樹林,4,0,4,1,1.69
"20240216","1783","0039003800310079","9800",元大-善化,0,5,5,-1,2.12
"20240216","1783","9647","9600",富邦-新竹,4,0,4,1,1.69
"20240216","1783","0039004100390037","9A00",永豐金-新竹,0,5,5,-1,2.12
"20240216","1783","9889","9800",元大-員林,4,0,4,1,1.69
"20240216","1783","003900410039006a","9A00",永豐金-嘉義,0,5,5,-1,2.12
"20240216","1783","0039003600310048","9600",富邦-新板,3,0,3,1,1.27
"20240216","1783","0039003100380067","9100",群益金鼎-大甲,0,4,4,-1,1.69
"20240216","1783","9692","9600",富邦-嘉義,3,0,3,1,1.27
"20240216","1783","5261","5260",美好-蘆洲,0,3,3,-1,1.27
"20240216","1783","0035003900320061","5920",元富-松德,2,0,2,1,0.85
"20240216","1783","003500320036004b","5260",美好-富順,0,3,3,-1,1.27
"20240219","1783","8151","8150",台新-建北,10,0,10,1,6.90
"20240219","1783","1650","1650",新加坡商瑞銀,2,12,10,-1,6.90
"20240219","1783","0039003800390059","9800",元大-基隆,10,0,10,1,6.90
"20240219","1783","003700300030005a","7000",兆豐-高雄,0,7,7,-1,4.83
"20240219","1783","8440","8440",摩根大通,10,1,9,1,6.21
"20240219","1783","9268","9200",凱基-台北,1,7,6,-1,4.14
"20240219","1783","9647","9600",富邦-新竹,5,0,5,1,3.45
"20240219","1783","1480","1480",美商高盛,1,6,5,-1,3.45
"20240219","1783","003900380031006e","9800",元大-旗山,5,0,5,1,3.45
"20240219","1783","0039003800310052","9800",元大-竹山,0,5,5,-1,3.45
"20240219","1783","1470","1470",台灣摩根士丹利,3,0,3,1,2.07
"20240219","1783","8880","8880",國泰證券,0,4,4,-1,2.76
"20240219","1783","6161","6160",中國信託-三重,3,0,3,1,2.07
"20240219","1783","0039003100380063","9100",群益金鼎-鳳山,0,4,4,-1,2.76
"20240219","1783","0039003600310048","9600",富邦-新板,3,0,3,1,2.07
"20240219","1783","1560","1560",港商野村,1,4,3,-1,2.07
"20240219","1783","9800","9800",元大證券,3,0,3,1,2.07
"20240219","1783","1440","1440",美林,4,7,3,-1,2.07
"20240219","1783","0039004100390068","9A00",永豐金-台南,3,0,3,1,2.07
"20240219","1783","9858","9800",元大-龍潭,0,3,3,-1,2.07
"20240219","1783","003500320036004b","5260",美好-富順,2,0,2,1,1.38
"20240219","1783","9871","9800",元大-忠孝,0,3,3,-1,2.07
"20240219","1783","5386","5380",第一金-彰化,2,0,2,1,1.38
"20240219","1783","8848","8840",玉山-嘉義,0,2,2,-1,1.38
"20240219","1783","003500390032004e","5920",元富-虎尾,2,0,2,1,1.38
"20240219","1783","0039003100300044","9100",群益金鼎-市府,0,2,2,-1,1.38
"20240219","1783","9661","9600",富邦-新店,2,0,2,1,1.38
"20240219","1783","9209","9200",凱基-岡山,0,2,2,-1,1.38
"20240220","1783","003900380031006e","9800",元大-旗山,7,0,7,1,7.69
"20240220","1783","9268","9200",凱基-台北,2,10,8,-1,8.79
"20240220","1783","9647","9600",富邦-新竹,6,0,6,1,6.59
"20240220","1783","0039003100330044","9100",群益金鼎-潭子,0,5,5,-1,5.49
"20240220","1783","5383","5380",第一金-高雄,6,0,6,1,6.59
"20240220","1783","0039003800320042","9800",元大-博愛,0,5,5,-1,5.49
"20240220","1783","0039003800320043","9800",元大-六合,5,0,5,1,5.49
"20240220","1783","9235","9200",凱基-永華,0,4,4,-1,4.40
"20240220","1783","9208","9200",凱基-桃園,3,0,3,1,3.30
"20240220","1783","0039003800390046","9800",元大-高雄,1,5,4,-1,4.40
"20240220","1783","0039003600310048","9600",富邦-新板,3,0,3,1,3.30
"20240220","1783","003600310036004b","6160",中國信託-高雄,0,4,4,-1,4.40
"20240220","1783","0038003800340042","8840",玉山-台中,2,0,2,1,2.20
"20240220","1783","7032","7030",致和-佳里,0,3,3,-1,3.30
"20240220","1783","003500320036004b","5260",美好-富順,2,0,2,1,2.20
"20240220","1783","9303","9300",華南永昌-高雄,0,2,2,-1,2.20
"20240220","1783","003700300030005a","7000",兆豐-高雄,2,0,2,1,2.20
"20240220","1783","5262","5260",美好-楊梅,0,2,2,-1,2.20
"20240220","1783","0039003800300044","9800",元大-北府,2,0,2,1,2.20
"20240220","1783","1650","1650",新加坡商瑞銀,0,2,2,-1,2.20
"20240220","1783","9813","9800",元大-八德,2,0,2,1,2.20
"20240220","1783","0031003000330046","1030",土銀-南港,0,2,2,-1,2.20
"20240220","1783","0039003800390051","9800",元大-汐止,2,0,2,1,2.20
"20240220","1783","0037003700390050","7790",國票-九鼎,0,2,2,-1,2.20
"20240220","1783","0039003800350043","9800",元大-鳳中,1,0,1,1,1.10
"20240220","1783","0039003100330048","9100",群益金鼎-屏東,0,2,2,-1,2.20
"20240220","1783","8840","8840",玉山證券,1,0,1,1,1.10
"20240220","1783","9831","9800",元大-四維,3,5,2,-1,2.20
"20240221","1783","6161","6160",中國信託-三重,5,0,5,1,7.69
"20240221","1783","8880","8880",國泰證券,0,8,8,-1,12.31
"20240221","1783","8440","8440",摩根大通,6,1,5,1,7.69
"20240221","1783","1480","1480",美商高盛,0,5,5,-1,7.69
"20240221","1783","003700300030004d","7000",兆豐-桃園,4,0,4,1,6.15
"20240221","1783","9889","9800",元大-員林,0,4,4,-1,6.15
"20240221","1783","1030","1030",土銀,3,0,3,1,4.62
"20240221","1783","5856","5850",統一-台中,0,2,2,-1,3.08
"20240221","1783","003500390032005a","5920",元富-安南,3,0,3,1,4.62
"20240221","1783","8849","8840",玉山-景美,1,3,2,-1,3.08
"20240221","1783","003900380031006e","9800",元大-旗山,3,0,3,1,4.62
"20240221","1783","9268","9200",凱基-台北,1,3,2,-1,3.08
"20240221","1783","5386","5380",第一金-彰化,2,0,2,1,3.08
"20240221","1783","9108","9100",群益金鼎-海山,0,1,1,-1,1.54
"20240221","1783","003700300030005a","7000",兆豐-高雄,2,0,2,1,3.08
"20240221","1783","0035003300380059","5380",第一金-中壢,0,1,1,-1,1.54
"20240221","1783","8888","8880",國泰-敦南,1,0,1,1,1.54
"20240221","1783","0038003400350058","8450",康和-屏東,0,1,1,-1,1.54
"20240221","1783","5389","5380",第一金-中山,1,0,1,1,1.54
"20240221","1783","0038003800340042","8840",玉山-台中,0,1,1,-1,1.54
"20240221","1783","2181","2180",亞東-板橋,1,0,1,1,1.54
"20240221","1783","9137","9100",群益金鼎-士林,0,1,1,-1,1.54
"20240221","1783","0037003000300068","7000",兆豐-三民,1,0,1,1,1.54
"20240221","1783","9239","9200",凱基-市政,0,1,1,-1,1.54
"20240221","1783","7798","7790",國票-內壢,1,0,1,1,1.54
"20240221","1783","9322","9300",華南永昌-基隆,0,1,1,-1,1.54
"20240221","1783","0037003700390058","7790",國票-中和,1,0,1,1,1.54
"20240221","1783","9329","9300",華南永昌-朴子,0,1,1,-1,1.54
"20240222","1783","9303","9300",華南永昌-高雄,7,0,7,1,5.83
"20240222","1783","0039003800300077","9800",元大-西屯,0,11,11,-1,9.17
"20240222","1783","5383","5380",第一金-高雄,5,0,5,1,4.17
"20240222","1783","9672","9600",富邦-員林,0,5,5,-1,4.17
"20240222","1783","003700300030004c","7000",兆豐-天母,5,0,5,1,4.17
"20240222","1783","9814","9800",元大-大益,0,5,5,-1,4.17
"20240222","1783","003700300030004e","7000",兆豐-埔墘,5,0,5,1,4.17
"20240222","1783","9858","9800",元大-龍潭,0,5,5,-1,4.17
"20240222","1783","1440","1440",美林,8,4,4,1,3.33
"20240222","1783","9636","9600",富邦-中壢,0,4,4,-1,3.33
"20240222","1783","8563","8560",新光-新竹,4,0,4,1,3.33
"20240222","1783","5322","5320",高橋-中壢,0,4,4,-1,3.33
"20240222","1783","003700300030005a","7000",兆豐-高雄,3,0,3,1,2.50
"20240222","1783","6164","6160",中國信託-文心,0,3,3,-1,2.50
"20240222","1783","9815","9800",元大-大灣,3,0,3,1,2.50
"20240222","1783","003500390032005a","5920",元富-安南,0,3,3,-1,2.50
"20240222","1783","0039003800330056","9800",元大-竹南,3,0,3,1,2.50
"20240222","1783","7008","7000",兆豐-三重,0,3,3,-1,2.50
"20240222","1783","0039004100390058","9A00",永豐金-竹科,3,0,3,1,2.50
"20240222","1783","0035003800350052","5850",統一-汐止,0,2,2,-1,1.67
"20240222","1783","8560","8560",新光,5,3,2,1,1.67
"20240222","1783","5856","5850",統一-台中,0,2,2,-1,1.67
"20240222","1783","0039004100300030","9A00",永豐金證券,2,0,2,1,1.67
"20240222","1783","6163","6160",中國信託-永康,0,2,2,-1,1.67
"20240222","1783","1650","1650",新加坡商瑞銀,4,2,2,1,1.67
"20240222","1783","6452","6450",永全-八德,0,2,2,-1,1.67
"20240222","1783","9332","9300",華南永昌-楠梓,2,0,2,1,1.67
"20240222","1783","7798","7790",國票-內壢,0,2,2,-1,1.67
"20240223","1783","5385","5380",第一金-桃園,6,0,6,1,5.04
"20240223","1783","9268","9200",凱基-台北,2,12,10,-1,8.40
"20240223","1783","0035003800350044","5850",統一-新台中,5,0,5,1,4.20
"20240223","1783","9647","9600",富邦-新竹,0,7,7,-1,5.88
"20240223","1783","7750","7750",北城證券,5,0,5,1,4.20
"20240223","1783","1480","1480",美商高盛,0,6,6,-1,5.04
"20240223","1783","003900380031006e","9800",元大-旗山,5,0,5,1,4.20
"20240223","1783","0036003100310041","6110",台中銀-豐原,0,5,5,-1,4.20
"20240223","1783","0038003400350042","8450",康和-永和,4,0,4,1,3.36
"20240223","1783","6164","6160",中國信託-文心,0,4,4,-1,3.36
"20240223","1783","003700300030004c","7000",兆豐-天母,3,0,3,1,2.52
"20240223","1783","8880","8880",國泰證券,0,4,4,-1,3.36
"20240223","1783","9215","9200",凱基-高美館,3,0,3,1,2.52
"20240223","1783","0039003100380043","9100",群益金鼎-古亭,0,4,4,-1,3.36
"20240223","1783","9303","9300",華南永昌-高雄,3,0,3,1,2.52
"20240223","1783","9667","9600",富邦-台南,0,4,4,-1,3.36
"20240223","1783","0039003800300068","9800",元大-台北,3,0,3,1,2.52
"20240223","1783","8560","8560",新光,3,6,3,-1,2.52
"20240223","1783","8440","8440",摩根大通,6,4,2,1,1.68
"20240223","1783","0036003000310064","6010",(牛牛牛)亞-鑫豐,0,2,2,-1,1.68
"20240223","1783","8840","8840",玉山證券,2,0,2,1,1.68
"20240223","1783","9136","9100",群益金鼎-西松,0,2,2,-1,1.68
"20240223","1783","9288","9200",凱基-埔墘,2,0,2,1,1.68
"20240223","1783","9202","9200",凱基-中港,0,2,2,-1,1.68
"20240223","1783","9657","9600",富邦-苗栗,2,0,2,1,1.68
"20240223","1783","0039003800310045","9800",元大-發財,0,2,2,-1,1.68
"20240223","1783","0039003600350055","9600",富邦-彰化,2,0,2,1,1.68
"20240223","1783","0035003900320061","5920",元富-松德,0,1,1,-1,0.84
"20240226","1783","1440","1440",美林,13,0,13,1,8.02
"20240226","1783","0037003000300063","7000",兆豐-民生,0,10,10,-1,6.17
"20240226","1783","0039003800390059","9800",元大-基隆,10,0,10,1,6.17
"20240226","1783","003700300030004c","7000",兆豐-天母,0,8,8,-1,4.94
"20240226","1783","0039003800310051","9800",元大-太平,10,0,10,1,6.17
"20240226","1783","9875","9800",元大-土城永寧,4,12,8,-1,4.94
"20240226","1783","8440","8440",摩根大通,8,0,8,1,4.94
"20240226","1783","0038003400350044","8450",康和-板橋,0,7,7,-1,4.32
"20240226","1783","1560","1560",港商野村,8,2,6,1,3.70
"20240226","1783","0039003800330056","9800",元大-竹南,0,6,6,-1,3.70
"20240226","1783","1042","1040",臺銀-臺南,5,0,5,1,3.09
"20240226","1783","0039003800300044","9800",元大-北府,0,5,5,-1,3.09
"20240226","1783","0039003800390051","9800",元大-汐止,5,0,5,1,3.09
"20240226","1783","0038003400350042","8450",康和-永和,0,4,4,-1,2.47
"20240226","1783","0035003800350046","5850",統一-彰化,3,0,3,1,1.85
"20240226","1783","8880","8880",國泰證券,0,4,4,-1,2.47
"20240226","1783","8847","8840",玉山-台南,5,2,3,1,1.85
"20240226","1783","0039003800390042","9800",元大-台中中港,0,4,4,-1,2.47
"20240226","1783","9226","9200",凱基-汐止,3,0,3,1,1.85
"20240226","1783","003700300030005a","7000",兆豐-高雄,0,3,3,-1,1.85
"20240226","1783","9229","9200",凱基-中山,3,0,3,1,1.85
"20240226","1783","9255","9200",凱基-和平,0,3,3,-1,1.85
"20240226","1783","5928","5920",元富-新莊,2,0,2,1,1.23
"20240226","1783","9322","9300",華南永昌-基隆,0,2,2,-1,1.23
"20240226","1783","1650","1650",新加坡商瑞銀,2,0,2,1,1.23
"20240226","1783","0031003000340044","1040",臺銀-金山,0,2,2,-1,1.23
"20240226","1783","0035003900320048","5920",元富-信義,2,0,2,1,1.23
"20240226","1783","0035003800350042","5850",統一-永和,0,2,2,-1,1.23
"20240227","1783","0038003800380041","8880",國泰-館前,7,0,7,1,5.11
"20240227","1783","9217","9200",凱基-松山,0,5,5,-1,3.65
"20240227","1783","0039003800300061","9800",元大-承德,6,0,6,1,4.38
"20240227","1783","0039003800310065","9800",元大-佳里,0,5,5,-1,3.65
"20240227","1783","8882","8880",國泰-台中,5,0,5,1,3.65
"20240227","1783","0039003800390049","9800",元大-蘆洲中正,0,5,5,-1,3.65
"20240227","1783","9285","9200",凱基-中壢,5,0,5,1,3.65
"20240227","1783","0038003100350041","8150",台新-高雄,0,5,5,-1,3.65
"20240227","1783","0035003800350048","5850",統一-桃園,4,0,4,1,2.92
"20240227","1783","0035003900320069","5920",元富-中港,0,4,4,-1,2.92
"20240227","1783","003700370039004a","7790",國票-北高雄,4,0,4,1,2.92
"20240227","1783","9672","9600",富邦-員林,1,5,4,-1,2.92
"20240227","1783","9871","9800",元大-忠孝,4,0,4,1,2.92
"20240227","1783","0039003800310058","9800",元大-新生,0,4,4,-1,2.92
"20240227","1783","9326","9300",華南永昌-南京,3,0,3,1,2.19
"20240227","1783","0039003800330056","9800",元大-竹南,0,4,4,-1,2.92
"20240227","1783","0039003800300043","9800",元大-斗六,3,0,3,1,2.19
"20240227","1783","1440","1440",美林,1,4,3,-1,2.19
"20240227","1783","9874","9800",元大-雙和,3,0,3,1,2.19
"20240227","1783","9859","9800",元大-新竹經國,0,3,3,-1,2.19
"20240227","1783","8151","8150",台新-建北,2,0,2,1,1.46
"20240227","1783","9229","9200",凱基-中山,0,3,3,-1,2.19
"20240227","1783","8883","8880",國泰-松江,2,0,2,1,1.46
"20240227","1783","0031003000340043","1040",臺銀-高雄,0,2,2,-1,1.46
"20240227","1783","003800380038004b","8880",國泰-板橋,2,0,2,1,1.46
"20240227","1783","1022","1020",合庫-台南,0,2,2,-1,1.46
"20240227","1783","9657","9600",富邦-苗栗,2,0,2,1,1.46
"20240227","1783","5386","5380",第一金-彰化,0,2,2,-1,1.46
"20240229","1783","0035003900320062","5920",元富-板橋,10,0,10,1,7.87
"20240229","1783","0037003700390063","7790",國票-敦北法人,0,10,10,-1,7.87
"20240229","1783","003500390032006f","5920",元富-新興,6,0,6,1,4.72
"20240229","1783","9692","9600",富邦-嘉義,0,9,9,-1,7.09
"20240229","1783","0036003000310064","6010",(牛牛牛)亞-鑫豐,5,0,5,1,3.94
"20240229","1783","0038003100350059","8150",台新-新營,0,8,8,-1,6.30
"20240229","1783","0039003800300068","9800",元大-台北,5,0,5,1,3.94
"20240229","1783","8560","8560",新光,0,4,4,-1,3.15
"20240229","1783","1650","1650",新加坡商瑞銀,5,0,5,1,3.94
"20240229","1783","0031003000330041","1030",土銀-建國,0,4,4,-1,3.15
"20240229","1783","1440","1440",美林,3,0,3,1,2.36
"20240229","1783","0039003600320050","9600",富邦-頭份,0,4,4,-1,3.15
"20240229","1783","003700300030004c","7000",兆豐-天母,3,0,3,1,2.36
"20240229","1783","0039003800310079","9800",元大-善化,0,4,4,-1,3.15
"20240229","1783","8150","8150",台新證券,3,0,3,1,2.36
"20240229","1783","9185","9100",群益金鼎-台南,0,3,3,-1,2.36
"20240229","1783","003900380031004e","9800",元大-金門,3,0,3,1,2.36
"20240229","1783","9647","9600",富邦-新竹,0,3,3,-1,2.36
"20240229","1783","9831","9800",元大-四維,4,1,3,1,2.36
"20240229","1783","0039003800300043","9800",元大-斗六,0,3,3,-1,2.36
"20240229","1783","8440","8440",摩根大通,7,5,2,1,1.57
"20240229","1783","9874","9800",元大-雙和,0,3,3,-1,2.36
"20240229","1783","1560","1560",港商野村,2,0,2,1,1.57
"20240229","1783","0039004100390041","9A00",永豐金-羅東,0,2,2,-1,1.57
"20240229","1783","9208","9200",凱基-桃園,2,0,2,1,1.57
"20240229","1783","1021","1020",合庫-台中,0,2,2,-1,1.57
"20240229","1783","9226","9200",凱基-汐止,2,0,2,1,1.57
"20240229","1783","5383","5380",第一金-高雄,0,2,2,-1,1.57
"20240301","1783","9329","9300",華南永昌-朴子,7,0,7,1,6.67
"20240301","1783","5380","5380",第一金,0,13,13,-1,12.38
"20240301","1783","9268","9200",凱基-台北,8,2,6,1,5.71
"20240301","1783","9892","9800",元大-屏東,0,7,7,-1,6.67
"20240301","1783","9898","9800",元大-新莊,5,0,5,1,4.76
"20240301","1783","9300","9300",華南永昌,0,5,5,-1,4.76
"20240301","1783","1470","1470",台灣摩根士丹利,4,0,4,1,3.81
"20240301","1783","1025","1020",合庫-基隆,0,5,5,-1,4.76
"20240301","1783","6164","6160",中國信託-文心,4,0,4,1,3.81
"20240301","1783","9676","9600",富邦-仁愛,0,5,5,-1,4.76
"20240301","1783","9875","9800",元大-土城永寧,3,0,3,1,2.86
"20240301","1783","8847","8840",玉山-台南,1,5,4,-1,3.81
"20240301","1783","1440","1440",美林,6,3,3,1,2.86
"20240301","1783","0039003200300047","9200",凱基-彰化,0,3,3,-1,2.86
"20240301","1783","9697","9600",富邦-虎尾,3,0,3,1,2.86
"20240301","1783","9623","9600",富邦-台北,0,3,3,-1,2.86
"20240301","1783","9824","9800",元大-向上,3,0,3,1,2.86
"20240301","1783","9812","9800",元大-台中,0,2,2,-1,1.90
"20240301","1783","9665","9600",富邦-桃園,2,0,2,1,1.90
"20240301","1783","9608","9600",富邦-台東,0,2,2,-1,1.90
"20240301","1783","9285","9200",凱基-中壢,2,0,2,1,1.90
"20240301","1783","0039003800300064","9800",元大-沙鹿,0,1,1,-1,0.95
"20240301","1783","7797","7790",國票-中正,2,0,2,1,1.90
"20240301","1783","8888","8880",國泰-敦南,0,1,1,-1,0.95
"20240301","1783","8440","8440",摩根大通,5,3,2,1,1.90
"20240301","1783","7790","7790",國票證券,0,1,1,-1,0.95
"20240301","1783","0039003800310067","9800",元大-大里,2,0,2,1,1.90
"20240301","1783","1038","1030",土銀-和平,0,1,1,-1,0.95
"20240304","1783","0035003900320062","5920",元富-板橋,10,0,10,1,5.00
"20240304","1783","9859","9800",元大-新竹經國,0,25,25,-1,12.50
"20240304","1783","9309","9300",華南永昌-古亭,10,0,10,1,5.00
"20240304","1783","6168","6160",中國信託-嘉義,0,10,10,-1,5.00
"20240304","1783","0037003000300058","7000",兆豐-永和,5,0,5,1,2.50
"20240304","1783","9268","9200",凱基-台北,13,23,10,-1,5.00
"20240304","1783","8847","8840",玉山-台南,5,0,5,1,2.50
"20240304","1783","0039004100390043","9A00",永豐金-員林,0,8,8,-1,4.00
"20240304","1783","0039003600310043","9600",富邦-南京,5,0,5,1,2.50
"20240304","1783","1020","1020",合庫證券,0,7,7,-1,3.50
"20240304","1783","9875","9800",元大-土城永寧,5,0,5,1,2.50
"20240304","1783","0035003900320045","5920",元富-城中,0,6,6,-1,3.00
"20240304","1783","003500380035004d","5850",統一-士林,4,0,4,1,2.00
"20240304","1783","8459","8450",康和-嘉義,0,6,6,-1,3.00
"20240304","1783","003700300030005a","7000",兆豐-高雄,4,0,4,1,2.00
"20240304","1783","1480","1480",美商高盛,0,5,5,-1,2.50
"20240304","1783","0038003400350045","8450",康和-澎湖,4,0,4,1,2.00
"20240304","1783","0039004100360039","9A00",永豐金-屏東,0,5,5,-1,2.50
"20240304","1783","0038003100350042","8150",台新-台中,5,1,4,1,2.00
"20240304","1783","0031003200360044","1260",宏遠-台南,0,4,4,-1,2.00
"20240304","1783","1110","1110",台灣企銀,3,0,3,1,1.50
"20240304","1783","1560","1560",港商野村,0,3,3,-1,1.50
"20240304","1783","0036003000310064","6010",(牛牛牛)亞-鑫豐,3,0,3,1,1.50
"20240304","1783","8560","8560",新光,7,10,3,-1,1.50
"20240304","1783","6110","6110",台中銀,3,0,3,1,1.50
"20240304","1783","0031003000330043","1030",土銀-白河,0,2,2,-1,1.00
"20240304","1783","0038003800340042","8840",玉山-台中,3,0,3,1,1.50
"20240304","1783","003500390032006f","5920",元富-新興,0,2,2,-1,1.00
"20240305","1783","5923","5920",元富-三重,10,0,10,1,6.49
"20240305","1783","8560","8560",新光,0,24,24,-1,15.58
"20240305","1783","1440","1440",美林,18,8,10,1,6.49
"20240305","1783","9268","9200",凱基-台北,9,25,16,-1,10.39
"20240305","1783","9875","9800",元大-土城永寧,8,0,8,1,5.19
"20240305","1783","5380","5380",第一金,0,5,5,-1,3.25
"20240305","1783","1560","1560",港商野村,8,2,6,1,3.90
"20240305","1783","0037003000300058","7000",兆豐-永和,0,5,5,-1,3.25
"20240305","1783","0039003800390041","9800",元大-北投,6,0,6,1,3.90
"20240305","1783","7001","7000",兆豐-嘉義,0,4,4,-1,2.60
"20240305","1783","6161","6160",中國信託-三重,5,0,5,1,3.25
"20240305","1783","8152","8150",台新-新莊,0,4,4,-1,2.60
"20240305","1783","1042","1040",臺銀-臺南,4,0,4,1,2.60
"20240305","1783","0038003800340042","8840",玉山-台中,0,3,3,-1,1.95
"20240305","1783","8458","8450",康和-台南,4,0,4,1,2.60
"20240305","1783","0038003800340045","8840",玉山-城中,0,3,3,-1,1.95
"20240305","1783","0039003100380043","9100",群益金鼎-古亭,4,0,4,1,2.60
"20240305","1783","9692","9600",富邦-嘉義,0,3,3,-1,1.95
"20240305","1783","0039003800300065","9800",元大-清水,4,0,4,1,2.60
"20240305","1783","9655","9600",富邦-板橋,0,3,3,-1,1.95
"20240305","1783","0039003800310067","9800",元大-大里,2,0,2,1,1.30
"20240305","1783","8843","8840",玉山-高雄,0,2,2,-1,1.30
"20240305","1783","7750","7750",北城證券,2,0,2,1,1.30
"20240305","1783","0039003600310043","9600",富邦-南京,1,3,2,-1,1.30
"20240305","1783","8440","8440",摩根大通,3,1,2,1,1.30
"20240305","1783","0039003800390050","9800",元大-敦南,0,2,2,-1,1.30
"20240305","1783","0039003100330049","9100",群益金鼎-萬華,2,0,2,1,1.30
"20240305","1783","9305","9300",華南永昌-新莊,0,2,2,-1,1.30
"20240306","1783","0035003900320062","5920",元富-板橋,11,0,11,1,3.86
"20240306","1783","9892","9800",元大-屏東,2,52,50,-1,17.54
"20240306","1783","8565","8560",新光-桃園,10,0,10,1,3.51
"20240306","1783","9623","9600",富邦-台北,0,13,13,-1,4.56
"20240306","1783","5850","5850",統一,10,0,10,1,3.51
"20240306","1783","6168","6160",中國信託-嘉義,0,10,10,-1,3.51
"20240306","1783","9268","9200",凱基-台北,17,7,10,1,3.51
"20240306","1783","003900380031004b","9800",元大-林園,0,10,10,-1,3.51
"20240306","1783","003700300030005a","7000",兆豐-高雄,7,0,7,1,2.46
"20240306","1783","0039004100360039","9A00",永豐金-屏東,1,10,9,-1,3.16
"20240306","1783","8561","8560",新光-台中,7,0,7,1,2.46
"20240306","1783","0039003800310069","9800",元大-西螺,0,7,7,-1,2.46
"20240306","1783","0039003100380043","9100",群益金鼎-古亭,8,1,7,1,2.46
"20240306","1783","1440","1440",美林,2,8,6,-1,2.11
"20240306","1783","9215","9200",凱基-高美館,10,3,7,1,2.46
"20240306","1783","0039003800300061","9800",元大-承德,0,6,6,-1,2.11
"20240306","1783","0039003100380067","9100",群益金鼎-大甲,6,0,6,1,2.11
"20240306","1783","9300","9300",華南永昌,1,7,6,-1,2.11
"20240306","1783","9604","9600",富邦-陽明,6,0,6,1,2.11
"20240306","1783","8711","8710",陽信-石牌,0,5,5,-1,1.75
"20240306","1783","9205","9200",凱基-三重,5,0,5,1,1.75
"20240306","1783","003700300030004d","7000",兆豐-桃園,0,4,4,-1,1.40
"20240306","1783","9309","9300",華南永昌-古亭,5,0,5,1,1.75
"20240306","1783","8520","8520",中農,0,4,4,-1,1.40
"20240306","1783","9661","9600",富邦-新店,5,0,5,1,1.75
"20240306","1783","8150","8150",台新證券,1,4,3,-1,1.05
"20240306","1783","003900380031006e","9800",元大-旗山,5,0,5,1,1.75
"20240306","1783","0038003100350059","8150",台新-新營,1,4,3,-1,1.05
"20240307","1783","0039004100390055","9A00",永豐金-中正,20,0,20,1,10.75
"20240307","1783","1440","1440",美林,2,22,20,-1,10.75
"20240307","1783","0035003900320062","5920",元富-板橋,10,0,10,1,5.38
"20240307","1783","8440","8440",摩根大通,0,18,18,-1,9.68
"20240307","1783","1650","1650",新加坡商瑞銀,9,1,8,1,4.30
"20240307","1783","0039004100390041","9A00",永豐金-羅東,0,9,9,-1,4.84
"20240307","1783","1590","1590",花旗環球,8,0,8,1,4.30
"20240307","1783","5266","5260",美好-中壢,0,5,5,-1,2.69
"20240307","1783","9307","9300",華南永昌-大安,5,0,5,1,2.69
"20240307","1783","5856","5850",統一-台中,0,5,5,-1,2.69
"20240307","1783","9667","9600",富邦-台南,5,0,5,1,2.69
"20240307","1783","8849","8840",玉山-景美,0,5,5,-1,2.69
"20240307","1783","9898","9800",元大-新莊,3,0,3,1,1.61
"20240307","1783","003900310038004b","9100",群益金鼎-東湖,0,5,5,-1,2.69
"20240307","1783","9623","9600",富邦-台北,3,0,3,1,1.61
"20240307","1783","9636","9600",富邦-中壢,0,5,5,-1,2.69
"20240307","1783","9661","9600",富邦-新店,3,0,3,1,1.61
"20240307","1783","9692","9600",富邦-嘉義,0,5,5,-1,2.69
"20240307","1783","1480","1480",美商高盛,9,7,2,1,1.08
"20240307","1783","0039004100360039","9A00",永豐金-屏東,0,5,5,-1,2.69
"20240307","1783","5862","5860",盈溢-楠梓,2,0,2,1,1.08
"20240307","1783","1560","1560",港商野村,0,4,4,-1,2.15
"20240307","1783","5927","5920",元富-林園,2,0,2,1,1.08
"20240307","1783","9255","9200",凱基-和平,0,4,4,-1,2.15
"20240307","1783","6012","6010",(牛牛牛)亞-網路,2,0,2,1,1.08
"20240307","1783","9300","9300",華南永昌,0,4,4,-1,2.15
"20240307","1783","6161","6160",中國信託-三重,2,0,2,1,1.08
"20240307","1783","003900360031004e","9600",富邦-西壢,0,4,4,-1,2.15
"20240308","1783","0035003900320062","5920",元富-板橋,15,0,15,1,6.67
"20240308","1783","1440","1440",美林,0,17,17,-1,7.56
"20240308","1783","6161","6160",中國信託-三重,10,0,10,1,4.44
"20240308","1783","1480","1480",美商高盛,1,16,15,-1,6.67
"20240308","1783","003900380031006e","9800",元大-旗山,10,0,10,1,4.44
"20240308","1783","9300","9300",華南永昌,0,13,13,-1,5.78
"20240308","1783","003700300030006a","7000",兆豐-大安,6,0,6,1,2.67
"20240308","1783","0039004100390043","9A00",永豐金-員林,0,12,12,-1,5.33
"20240308","1783","0037003700390065","7790",國票-南科,6,0,6,1,2.67
"20240308","1783","5850","5850",統一,0,10,10,-1,4.44
"20240308","1783","8847","8840",玉山-台南,6,0,6,1,2.67
"20240308","1783","9654","9600",富邦-永和,1,10,9,-1,4.00
"20240308","1783","9834","9800",元大-中壢,6,0,6,1,2.67
"20240308","1783","0039003100380067","9100",群益金鼎-大甲,0,7,7,-1,3.11
"20240308","1783","8881","8880",國泰-高雄,5,0,5,1,2.22
"20240308","1783","003900380030006c","9800",元大-虎尾,0,6,6,-1,2.67
"20240308","1783","0039003800370041","9800",元大-楊梅,5,0,5,1,2.22
"20240308","1783","8880","8880",國泰證券,0,5,5,-1,2.22
"20240308","1783","8560","8560",新光,4,0,4,1,1.78
"20240308","1783","0039004100360039","9A00",永豐金-屏東,0,5,5,-1,2.22
"20240308","1783","9285","9200",凱基-中壢,4,0,4,1,1.78
"20240308","1783","0039004100390052","9A00",永豐金-信義,0,5,5,-1,2.22
"20240308","1783","003900380039004e","9800",元大-內湖,4,0,4,1,1.78
"20240308","1783","9859","9800",元大-新竹經國,0,4,4,-1,1.78
"20240308","1783","0038003400350045","8450",康和-澎湖,3,0,3,1,1.33
"20240308","1783","003700300030005a","7000",兆豐-高雄,0,3,3,-1,1.33
"20240308","1783","9138","9100",群益金鼎-中港,3,0,3,1,1.33
"20240308","1783","0038003800340045","8840",玉山-城中,0,3,3,-1,1.33
"20240311","1783","0039004100390055","9A00",永豐金-中正,12,0,12,1,8.22
"20240311","1783","1440","1440",美林,0,16,16,-1,10.96
"20240311","1783","9697","9600",富邦-虎尾,10,0,10,1,6.85
"20240311","1783","5385","5380",第一金-桃園,0,10,10,-1,6.85
"20240311","1783","9268","9200",凱基-台北,14,6,8,1,5.48
"20240311","1783","0039004100360039","9A00",永豐金-屏東,0,10,10,-1,6.85
"20240311","1783","0039003800300044","9800",元大-北府,5,0,5,1,3.42
"20240311","1783","9208","9200",凱基-桃園,1,11,10,-1,6.85
"20240311","1783","1650","1650",新加坡商瑞銀,9,4,5,1,3.42
"20240311","1783","8880","8880",國泰證券,0,7,7,-1,4.79
"20240311","1783","1033","1030",土銀-高雄,5,0,5,1,3.42
"20240311","1783","7750","7750",北城證券,0,5,5,-1,3.42
"20240311","1783","9834","9800",元大-中壢,5,0,5,1,3.42
"20240311","1783","8150","8150",台新證券,0,5,5,-1,3.42
"20240311","1783","0039003800390045","9800",元大-草屯,3,0,3,1,2.05
"20240311","1783","0039003600320043","9600",富邦-東門,0,3,3,-1,2.05
"20240311","1783","6161","6160",中國信託-三重,3,0,3,1,2.05
"20240311","1783","9300","9300",華南永昌,0,3,3,-1,2.05
"20240311","1783","8884","8880",國泰-台南,3,0,3,1,2.05
"20240311","1783","5386","5380",第一金-彰化,0,2,2,-1,1.37
"20240311","1783","0035003300380049","5380",第一金-頭份,3,0,3,1,2.05
"20240311","1783","1042","1040",臺銀-臺南,0,2,2,-1,1.37
"20240311","1783","0039003800390042","9800",元大-台中中港,2,0,2,1,1.37
"20240311","1783","0036003100310041","6110",台中銀-豐原,2,4,2,-1,1.37
"20240311","1783","7009","7000",兆豐-景美,2,0,2,1,1.37
"20240311","1783","8440","8440",摩根大通,2,4,2,-1,1.37
"20240311","1783","9215","9200",凱基-高美館,3,1,2,1,1.37
"20240311","1783","8561","8560",新光-台中,0,2,2,-1,1.37
"20240312","1783","8440","8440",摩根大通,28,2,26,1,9.63
"20240312","1783","9208","9200",凱基-桃園,0,38,38,-1,14.07
"20240312","1783","1440","1440",美林,35,10,25,1,9.26
"20240312","1783","9600","9600",富邦證券,0,35,35,-1,12.96
"20240312","1783","1650","1650",新加坡商瑞銀,23,1,22,1,8.15
"20240312","1783","0039004100390043","9A00",永豐金-員林,0,16,16,-1,5.93
"20240312","1783","0039004100390055","9A00",永豐金-中正,23,2,21,1,7.78
"20240312","1783","9614","9600",富邦-基隆,0,15,15,-1,5.56
"20240312","1783","1480","1480",美商高盛,14,0,14,1,5.19
"20240312","1783","8150","8150",台新證券,0,14,14,-1,5.19
"20240312","1783","7000","7000",兆豐證券,13,0,13,1,4.81
"20240312","1783","8848","8840",玉山-嘉義,0,6,6,-1,2.22
"20240312","1783","003500390032006f","5920",元富-新興,10,0,10,1,3.70
"20240312","1783","6164","6160",中國信託-文心,0,5,5,-1,1.85
"20240312","1783","0031003200360069","1260",宏遠-光隆,8,0,8,1,2.96
"20240312","1783","003700300030004e","7000",兆豐-埔墘,0,5,5,-1,1.85
"20240312","1783","8562","8560",新光-高雄,8,1,7,1,2.59
"20240312","1783","9604","9600",富邦-陽明,0,5,5,-1,1.85
"20240312","1783","003500380035004d","5850",統一-士林,6,0,6,1,2.22
"20240312","1783","9255","9200",凱基-和平,0,4,4,-1,1.48
"20240312","1783","0035003900320062","5920",元富-板橋,5,0,5,1,1.85
"20240312","1783","003500320036004b","5260",美好-富順,0,3,3,-1,1.11
"20240312","1783","6161","6160",中國信託-三重,5,0,5,1,1.85
"20240312","1783","8561","8560",新光-台中,0,3,3,-1,1.11
"20240312","1783","0038003800340043","8840",玉山-南京東路,3,0,3,1,1.11
"20240312","1783","9136","9100",群益金鼎-西松,2,5,3,-1,1.11
"20240312","1783","0039003800390051","9800",元大-汐止,3,0,3,1,1.11
"20240312","1783","0039003100380044","9100",群益金鼎-東門,0,3,3,-1,1.11
"20240313","1783","003500390032006f","5920",元富-新興,10,0,10,1,4.27
"20240313","1783","8888","8880",國泰-敦南,0,30,30,-1,12.82
"20240313","1783","8151","8150",台新-建北,10,0,10,1,4.27
"20240313","1783","1440","1440",美林,2,26,24,-1,10.26
"20240313","1783","003900410039004a","9A00",永豐金-板新,11,1,10,1,4.27
"20240313","1783","1650","1650",新加坡商瑞銀,0,22,22,-1,9.40
"20240313","1783","0039004100390055","9A00",永豐金-中正,10,0,10,1,4.27
"20240313","1783","0039003800310043","9800",元大-路竹,0,14,14,-1,5.98
"20240313","1783","8560","8560",新光,9,0,9,1,3.85
"20240313","1783","7000","7000",兆豐證券,0,8,8,-1,3.42
"20240313","1783","0035003900320062","5920",元富-板橋,7,0,7,1,2.99
"20240313","1783","8440","8440",摩根大通,0,8,8,-1,3.42
"20240313","1783","8561","8560",新光-台中,7,0,7,1,2.99
"20240313","1783","0031003200360069","1260",宏遠-光隆,0,7,7,-1,2.99
"20240313","1783","9268","9200",凱基-台北,27,20,7,1,2.99
"20240313","1783","0039003800330056","9800",元大-竹南,0,5,5,-1,2.14
"20240313","1783","0039003100380043","9100",群益金鼎-古亭,6,0,6,1,2.56
"20240313","1783","1480","1480",美商高盛,2,5,3,-1,1.28
"20240313","1783","5321","5320",高橋-龍潭,5,0,5,1,2.14
"20240313","1783","003900380030004b","9800",元大-竹科,0,2,2,-1,0.85
"20240313","1783","1033","1030",土銀-高雄,5,0,5,1,2.14
"20240313","1783","003700300030006a","7000",兆豐-大安,0,2,2,-1,0.85
"20240313","1783","8840","8840",玉山證券,5,0,5,1,2.14
"20240313","1783","003800340035004a","8450",康和-高雄,0,2,2,-1,0.85
"20240313","1783","9831","9800",元大-四維,4,0,4,1,1.71
"20240313","1783","9202","9200",凱基-中港,0,2,2,-1,0.85
"20240313","1783","0039004100390064","9A00",永豐金-古亭,4,0,4,1,1.71
"20240313","1783","9859","9800",元大-新竹經國,0,2,2,-1,0.85
"20240314","1783","9268","9200",凱基-台北,35,4,31,1,12.02
"20240314","1783","0039004100390043","9A00",永豐金-員林,0,19,19,-1,7.36
"20240314","1783","9875","9800",元大-土城永寧,16,10,6,1,2.33
"20240314","1783","1650","1650",新加坡商瑞銀,3,19,16,-1,6.20
"20240314","1783","0036003000310064","6010",(牛牛牛)亞-鑫豐,5,0,5,1,1.94
"20240314","1783","0039004100390057","9A00",永豐金-市政,0,15,15,-1,5.81
"20240314","1783","0038003100350041","8150",台新-高雄,5,0,5,1,1.94
"20240314","1783","5321","5320",高橋-龍潭,0,14,14,-1,5.43
"20240314","1783","5380","5380",第一金,4,0,4,1,1.55
"20240314","1783","9614","9600",富邦-基隆,0,10,10,-1,3.88
"20240314","1783","7009","7000",兆豐-景美,2,0,2,1,0.78
"20240314","1783","0039004100390068","9A00",永豐金-台南,0,10,10,-1,3.88
"20240314","1783","0037003000300077","7000",兆豐-新莊,2,0,2,1,0.78
"20240314","1783","8561","8560",新光-台中,0,9,9,-1,3.49
"20240314","1783","8440","8440",摩根大通,10,8,2,1,0.78
"20240314","1783","1440","1440",美林,7,14,7,-1,2.71
"20240314","1783","0038003800340043","8840",玉山-南京東路,2,0,2,1,0.78
"20240314","1783","7000","7000",兆豐證券,0,5,5,-1,1.94
"20240314","1783","9858","9800",元大-龍潭,2,0,2,1,0.78
"20240314","1783","003900380039004a","9800",元大-彰化民生,0,5,5,-1,1.94
"20240314","1783","8841","8840",玉山-雙和,1,0,1,1,0.39
"20240314","1783","1560","1560",港商野村,0,4,4,-1,1.55
"20240314","1783","0031003000330043","1030",土銀-白河,1,0,1,1,0.39
"20240314","1783","5853","5850",統一-中壢,0,4,4,-1,1.55
"20240314","1783","1029","1020",合庫-鳳山,1,0,1,1,0.39
"20240314","1783","8847","8840",玉山-台南,0,4,4,-1,1.55
"20240314","1783","5855","5850",統一-台南,1,0,1,1,0.39
"20240314","1783","0039003600350055","9600",富邦-彰化,0,3,3,-1,1.16
"20240315","1783","9875","9800",元大-土城永寧,5,1,4,1,7.84
"20240315","1783","0039004100390057","9A00",永豐金-市政,0,5,5,-1,9.80
"20240315","1783","9623","9600",富邦-台北,4,0,4,1,7.84
"20240315","1783","0035003300380050","5380",第一金-路竹,0,4,4,-1,7.84
"20240315","1783","6950","6950",福勝,2,0,2,1,3.92
"20240315","1783","0039004100390043","9A00",永豐金-員林,0,4,4,-1,7.84
"20240315","1783","0038003400350041","8450",康和-內湖,2,0,2,1,3.92
"20240315","1783","9300","9300",華南永昌,0,3,3,-1,5.88
"20240315","1783","8841","8840",玉山-雙和,2,0,2,1,3.92
"20240315","1783","1440","1440",美林,0,3,3,-1,5.88
"20240315","1783","0039003200300044","9200",凱基-市府,2,0,2,1,3.92
"20240315","1783","8440","8440",摩根大通,0,3,3,-1,5.88
"20240315","1783","003900320031004a","9200",凱基-土城,2,0,2,1,3.92
"20240315","1783","0035003300380049","5380",第一金-頭份,0,2,2,-1,3.92
"20240315","1783","0039003800330069","9800",元大-大雅,2,0,2,1,3.92
"20240315","1783","0039003100380073","9100",群益金鼎-丹鳳,0,2,2,-1,3.92
"20240315","1783","8888","8880",國泰-敦南,2,0,2,1,3.92
"20240315","1783","9268","9200",凱基-台北,2,4,2,-1,3.92
"20240315","1783","003500390032004d","5920",元富-彰化,1,0,1,1,1.96
"20240315","1783","9627","9600",富邦-內湖,0,2,2,-1,3.92
"20240315","1783","0038003400350045","8450",康和-澎湖,1,0,1,1,1.96
"20240315","1783","0039003800390051","9800",元大-汐止,0,2,2,-1,3.92
"20240315","1783","8886","8880",國泰-新莊,1,0,1,1,1.96
"20240315","1783","0039003800380042","9800",元大-桃園,0,2,2,-1,3.92
"20240315","1783","9189","9100",群益金鼎-桃園,1,0,1,1,1.96
"20240315","1783","0035003800350055","5850",統一-南京,0,1,1,-1,1.96
"20240315","1783","9233","9200",凱基-長庚,1,0,1,1,1.96
"20240315","1783","7750","7750",北城證券,0,1,1,-1,1.96
"20240318","1783","0039003800390043","9800",元大-板橋,10,0,10,1,7.87
"20240318","1783","8440","8440",摩根大通,2,11,9,-1,7.09
"20240318","1783","0037003700390058","7790",國票-中和,5,0,5,1,3.94
"20240318","1783","1650","1650",新加坡商瑞銀,1,9,8,-1,6.30
"20240318","1783","9655","9600",富邦-板橋,5,0,5,1,3.94
"20240318","1783","0039003800390041","9800",元大-北投,0,8,8,-1,6.30
"20240318","1783","8455","8450",康和-台中,4,0,4,1,3.15
"20240318","1783","1440","1440",美林,0,6,6,-1,4.72
"20240318","1783","0039003200300044","9200",凱基-市府,3,0,3,1,2.36
"20240318","1783","003700300030006a","7000",兆豐-大安,0,6,6,-1,4.72
"20240318","1783","0038003800340043","8840",玉山-南京東路,2,0,2,1,1.57
"20240318","1783","9300","9300",華南永昌,0,6,6,-1,4.72
"20240318","1783","9255","9200",凱基-和平,2,0,2,1,1.57
"20240318","1783","003800380038004b","8880",國泰-板橋,0,5,5,-1,3.94
"20240318","1783","0031003000340043","1040",臺銀-高雄,1,0,1,1,0.79
"20240318","1783","9268","9200",凱基-台北,5,8,3,-1,2.36
"20240318","1783","5862","5860",盈溢-楠梓,1,0,1,1,0.79
"20240318","1783","9627","9600",富邦-內湖,0,3,3,-1,2.36
"20240318","1783","6381","6380",光和-溪湖,1,0,1,1,0.79
"20240318","1783","0038003100350041","8150",台新-高雄,0,2,2,-1,1.57
"20240318","1783","9136","9100",群益金鼎-西松,1,0,1,1,0.79
"20240318","1783","8884","8880",國泰-台南,0,2,2,-1,1.57
"20240318","1783","9187","9100",群益金鼎-彰化,1,0,1,1,0.79
"20240318","1783","9888","9800",元大-鑫永和,0,2,2,-1,1.57
"20240318","1783","003900320031004a","9200",凱基-土城,1,0,1,1,0.79
"20240318","1783","1260","1260",宏遠證券,0,1,1,-1,0.79
"20240318","1783","0039003800300044","9800",元大-北府,1,0,1,1,0.79
"20240318","1783","0031003000340041","1040",臺銀-臺中,0,1,1,-1,0.79
"20240319","1783","9814","9800",元大-大益,6,0,6,1,5.61
"20240319","1783","0036003000310064","6010",(牛牛牛)亞-鑫豐,0,17,17,-1,15.89
"20240319","1783","0035003900320062","5920",元富-板橋,5,0,5,1,4.67
"20240319","1783","1650","1650",新加坡商瑞銀,0,6,6,-1,5.61
"20240319","1783","0038003800340048","8840",玉山-新竹,5,0,5,1,4.67
"20240319","1783","0037003700390065","7790",國票-南科,0,6,6,-1,5.61
"20240319","1783","8156","8150",台新-三民,4,0,4,1,3.74
"20240319","1783","9268","9200",凱基-台北,5,10,5,-1,4.67
"20240319","1783","8847","8840",玉山-台南,3,0,3,1,2.80
"20240319","1783","9627","9600",富邦-內湖,0,4,4,-1,3.74
"20240319","1783","0031003000340043","1040",臺銀-高雄,3,0,3,1,2.80
"20240319","1783","8440","8440",摩根大通,2,6,4,-1,3.74
"20240319","1783","5266","5260",美好-中壢,3,0,3,1,2.80
"20240319","1783","0038003100350041","8150",台新-高雄,0,4,4,-1,3.74
"20240319","1783","0038003800340043","8840",玉山-南京東路,3,0,3,1,2.80
"20240319","1783","1440","1440",美林,1,4,3,-1,2.80
"20240319","1783","9332","9300",華南永昌-楠梓,2,0,2,1,1.87
"20240319","1783","1590","1590",花旗環球,0,2,2,-1,1.87
"20240319","1783","8884","8880",國泰-台南,2,0,2,1,1.87
"20240319","1783","0031003000320043","1020",合庫-自強,0,2,2,-1,1.87
"20240319","1783","5856","5850",統一-台中,2,0,2,1,1.87
"20240319","1783","003500390032006c","5920",元富-大裕,0,2,2,-1,1.87
"20240319","1783","7750","7750",北城證券,2,0,2,1,1.87
"20240319","1783","6160","6160",中國信託,0,2,2,-1,1.87
"20240319","1783","9136","9100",群益金鼎-西松,2,0,2,1,1.87
"20240319","1783","8150","8150",台新證券,0,2,2,-1,1.87
"20240319","1783","9302","9300",華南永昌-台中,2,0,2,1,1.87
"20240319","1783","8881","8880",國泰-高雄,0,2,2,-1,1.87
"20240320","1783","8440","8440",摩根大通,15,2,13,1,7.78
"20240320","1783","0036003000310064","6010",(牛牛牛)亞-鑫豐,0,12,12,-1,7.19
"20240320","1783","9268","9200",凱基-台北,32,23,9,1,5.39
"20240320","1783","0037003700390065","7790",國票-南科,0,11,11,-1,6.59
"20240320","1783","0031003200360069","1260",宏遠-光隆,5,0,5,1,2.99
"20240320","1783","0039003800390041","9800",元大-北投,0,11,11,-1,6.59
"20240320","1783","6161","6160",中國信託-三重,5,0,5,1,2.99
"20240320","1783","8150","8150",台新證券,0,8,8,-1,4.79
"20240320","1783","8561","8560",新光-台中,5,0,5,1,2.99
"20240320","1783","1590","1590",花旗環球,0,5,5,-1,2.99
"20240320","1783","9831","9800",元大-四維,5,0,5,1,2.99
"20240320","1783","7750","7750",北城證券,0,5,5,-1,2.99
"20240320","1783","0039004100390058","9A00",永豐金-竹科,5,0,5,1,2.99
"20240320","1783","0038003100350042","8150",台新-台中,0,5,5,-1,2.99
"20240320","1783","1440","1440",美林,9,5,4,1,2.40
"20240320","1783","9229","9200",凱基-中山,0,5,5,-1,2.99
"20240320","1783","0038003400350045","8450",康和-澎湖,3,0,3,1,1.80
"20240320","1783","1650","1650",新加坡商瑞銀,2,6,4,-1,2.40
"20240320","1783","9134","9100",群益金鼎-開元,3,0,3,1,1.80
"20240320","1783","003900410039004b","9A00",永豐金-三重,0,2,2,-1,1.20
"20240320","1783","9647","9600",富邦-新竹,3,0,3,1,1.80
"20240320","1783","5856","5850",統一-台中,0,2,2,-1,1.20
"20240320","1783","9815","9800",元大-大灣,3,0,3,1,1.80
"20240320","1783","1480","1480",美商高盛,0,2,2,-1,1.20
"20240320","1783","1042","1040",臺銀-臺南,2,0,2,1,1.20
"20240320","1783","7792","7790",國票-北投,0,2,2,-1,1.20
"20240320","1783","0039003100330059","9100",群益金鼎-館前,2,0,2,1,1.20
"20240320","1783","9202","9200",凱基-中港,0,2,2,-1,1.20
"20240321","1783","9672","9600",富邦-員林,10,0,10,1,6.90
"20240321","1783","0039003800390041","9800",元大-北投,0,16,16,-1,11.03
"20240321","1783","6161","6160",中國信託-三重,5,0,5,1,3.45
"20240321","1783","0036003000310064","6010",(牛牛牛)亞-鑫豐,0,15,15,-1,10.34
"20240321","1783","9339","9300",華南永昌-竹北,5,0,5,1,3.45
"20240321","1783","0039004100390055","9A00",永豐金-中正,1,10,9,-1,6.21
"20240321","1783","003900410039006a","9A00",永豐金-嘉義,5,0,5,1,3.45
"20240321","1783","1440","1440",美林,0,5,5,-1,3.45
"20240321","1783","003500390032006f","5920",元富-新興,4,0,4,1,2.76
"20240321","1783","0039003200300048","9200",凱基-基隆,0,4,4,-1,2.76
"20240321","1783","9202","9200",凱基-中港,4,0,4,1,2.76
"20240321","1783","0031003000330041","1030",土銀-建國,0,3,3,-1,2.07
"20240321","1783","0037003000300052","7000",兆豐-小港,3,0,3,1,2.07
"20240321","1783","1650","1650",新加坡商瑞銀,0,3,3,-1,2.07
"20240321","1783","8886","8880",國泰-新莊,2,0,2,1,1.38
"20240321","1783","9834","9800",元大-中壢,0,3,3,-1,2.07
"20240321","1783","5268","5260",美好-台南,2,0,2,1,1.38
"20240321","1783","9188","9100",群益金鼎-三民,0,2,2,-1,1.38
"20240321","1783","0037003700390072","7790",國票-桃園,2,0,2,1,1.38
"20240321","1783","9255","9200",凱基-和平,0,2,2,-1,1.38
"20240321","1783","0037003700390076","7790",國票-台中,2,0,2,1,1.38
"20240321","1783","9647","9600",富邦-新竹,3,5,2,-1,1.38
"20240321","1783","8561","8560",新光-台中,2,0,2,1,1.38
"20240321","1783","0039004100390043","9A00",永豐金-員林,0,2,2,-1,1.38
"20240321","1783","0039003100380041","9100",群益金鼎-中壢,2,0,2,1,1.38
"20240321","1783","8455","8450",康和-台中,0,1,1,-1,0.69
"20240321","1783","003900380039006a","9800",元大-樹林,2,0,2,1,1.38
"20240321","1783","9322","9300",華南永昌-基隆,0,1,1,-1,0.69
"20240322","1783","0039004100390047","9A00",永豐金-天母,20,0,20,1,13.33
"20240322","1783","0039003100380043","9100",群益金鼎-古亭,0,15,15,-1,10.00
"20240322","1783","9268","9200",凱基-台北,16,0,16,1,10.67
"20240322","1783","1650","1650",新加坡商瑞銀,1,14,13,-1,8.67
"20240322","1783","0039003800390055","9800",元大-大甲,11,0,11,1,7.33
"20240322","1783","0037003000300056","7000",兆豐-新竹,0,10,10,-1,6.67
"20240322","1783","9676","9600",富邦-仁愛,6,0,6,1,4.00
"20240322","1783","9875","9800",元大-土城永寧,2,12,10,-1,6.67
"20240322","1783","9857","9800",元大-蘆洲,5,0,5,1,3.33
"20240322","1783","0031003200360069","1260",宏遠-光隆,0,7,7,-1,4.67
"20240322","1783","0038003400350045","8450",康和-澎湖,4,0,4,1,2.67
"20240322","1783","7032","7030",致和-佳里,0,5,5,-1,3.33
"20240322","1783","7009","7000",兆豐-景美,2,0,2,1,1.33
"20240322","1783","8561","8560",新光-台中,0,5,5,-1,3.33
"20240322","1783","8156","8150",台新-三民,2,0,2,1,1.33
"20240322","1783","9339","9300",華南永昌-竹北,0,5,5,-1,3.33
"20240322","1783","9207","9200",凱基-永和,2,0,2,1,1.33
"20240322","1783","003900380031005a","9800",元大-潮州,0,5,5,-1,3.33
"20240322","1783","9257","9200",凱基-林口,2,0,2,1,1.33
"20240322","1783","003700300030005a","7000",兆豐-高雄,0,4,4,-1,2.67
"20240322","1783","9672","9600",富邦-員林,2,0,2,1,1.33
"20240322","1783","0039003800390050","9800",元大-敦南,0,4,4,-1,2.67
"20240322","1783","9816","9800",元大-新竹,2,0,2,1,1.33
"20240322","1783","9309","9300",華南永昌-古亭,0,3,3,-1,2.00
"20240322","1783","0031003000330042","1030",土銀-彰化,1,0,1,1,0.67
"20240322","1783","5268","5260",美好-台南,0,2,2,-1,1.33
"20240322","1783","0035003300380044","5380",第一金-忠孝,1,0,1,1,0.67
"20240322","1783","1440","1440",美林,2,4,2,-1,1.33
"20240325","1783","1650","1650",新加坡商瑞銀,20,2,18,1,13.95
"20240325","1783","0036003000310064","6010",(牛牛牛)亞-鑫豐,0,5,5,-1,3.88
"20240325","1783","9278","9200",凱基-永康,10,0,10,1,7.75
"20240325","1783","9208","9200",凱基-桃園,0,5,5,-1,3.88
"20240325","1783","1440","1440",美林,10,3,7,1,5.43
"20240325","1783","9268","9200",凱基-台北,3,8,5,-1,3.88
"20240325","1783","003500380035004d","5850",統一-士林,5,0,5,1,3.88
"20240325","1783","9878","9800",元大-金華,0,5,5,-1,3.88
"20240325","1783","1039","1030",土銀-士林,5,0,5,1,3.88
"20240325","1783","8560","8560",新光,0,5,5,-1,3.88
"20240325","1783","6464","6460",大昌-新店,3,0,3,1,2.33
"20240325","1783","8846","8840",玉山-板橋,0,3,3,-1,2.33
"20240325","1783","6461","6460",大昌-樹林,2,0,2,1,1.55
"20240325","1783","6163","6160",中國信託-永康,0,3,3,-1,2.33
"20240325","1783","7750","7750",北城證券,2,0,2,1,1.55
"20240325","1783","0037003000300052","7000",兆豐-小港,0,3,3,-1,2.33
"20240325","1783","7797","7790",國票-中正,2,0,2,1,1.55
"20240325","1783","8884","8880",國泰-台南,0,2,2,-1,1.55
"20240325","1783","8159","8150",台新-台南,2,0,2,1,1.55
"20240325","1783","1560","1560",港商野村,1,3,2,-1,1.55
"20240325","1783","0039003100380043","9100",群益金鼎-古亭,2,0,2,1,1.55
"20240325","1783","8156","8150",台新-三民,0,2,2,-1,1.55
"20240325","1783","0039003800310079","9800",元大-善化,2,0,2,1,1.55
"20240325","1783","9255","9200",凱基-和平,0,2,2,-1,1.55
"20240325","1783","003900380039006d","9800",元大-信義,2,0,2,1,1.55
"20240325","1783","003900380031004e","9800",元大-金門,0,2,2,-1,1.55
"20240325","1783","9215","9200",凱基-高美館,2,0,2,1,1.55
"20240325","1783","9874","9800",元大-雙和,0,2,2,-1,1.55
"20240326","1783","0038003400350045","8450",康和-澎湖,12,0,12,1,9.68
"20240326","1783","9672","9600",富邦-員林,0,10,10,-1,8.06
"20240326","1783","1650","1650",新加坡商瑞銀,7,1,6,1,4.84
"20240326","1783","9627","9600",富邦-內湖,0,6,6,-1,4.84
"20240326","1783","003900380031006e","9800",元大-旗山,5,0,5,1,4.03
"20240326","1783","8440","8440",摩根大通,10,16,6,-1,4.84
"20240326","1783","1043","1040",臺銀-民權,4,0,4,1,3.23
"20240326","1783","9897","9800",元大-土城,0,5,5,-1,4.03
"20240326","1783","1440","1440",美林,11,8,3,1,2.42
"20240326","1783","9692","9600",富邦-嘉義,0,5,5,-1,4.03
"20240326","1783","9217","9200",凱基-松山,3,0,3,1,2.42
"20240326","1783","0039004100390055","9A00",永豐金-中正,0,4,4,-1,3.23
"20240326","1783","003900360031005a","9600",富邦-永康,3,0,3,1,2.42
"20240326","1783","9229","9200",凱基-中山,0,4,4,-1,3.23
"20240326","1783","5927","5920",元富-林園,2,0,2,1,1.61
"20240326","1783","0039004100390057","9A00",永豐金-市政,0,4,4,-1,3.23
"20240326","1783","0039003100330049","9100",群益金鼎-萬華,3,1,2,1,1.61
"20240326","1783","9874","9800",元大-雙和,0,3,3,-1,2.42
"20240326","1783","003900410039004a","9A00",永豐金-板新,1,0,1,1,0.81
"20240326","1783","003500390032006f","5920",元富-新興,2,4,2,-1,1.61
"20240326","1783","6620","6620",口袋證券,1,0,1,1,0.81
"20240326","1783","9136","9100",群益金鼎-西松,0,2,2,-1,1.61
"20240326","1783","8884","8880",國泰-台南,1,0,1,1,0.81
"20240326","1783","0039003800300065","9800",元大-清水,0,2,2,-1,1.61
"20240326","1783","1480","1480",美商高盛,2,1,1,1,0.81
"20240326","1783","9898","9800",元大-新莊,0,2,2,-1,1.61
"20240326","1783","0035003900320041","5920",元富-緯城,1,0,1,1,0.81
"20240326","1783","0039003800390050","9800",元大-敦南,0,2,2,-1,1.61
"20240327","1783","1440","1440",美林,8,1,7,1,11.48
"20240327","1783","9667","9600",富邦-台南,0,6,6,-1,9.84
"20240327","1783","9268","9200",凱基-台北,6,1,5,1,8.20
"20240327","1783","9655","9600",富邦-板橋,0,5,5,-1,8.20
"20240327","1783","1260","1260",宏遠證券,4,0,4,1,6.56
"20240327","1783","9136","9100",群益金鼎-西松,0,3,3,-1,4.92
"20240327","1783","003900360031004e","9600",富邦-西壢,3,0,3,1,4.92
"20240327","1783","003900360031005a","9600",富邦-永康,0,3,3,-1,4.92
"20240327","1783","0035003900320051","5920",元富-敦南,2,0,2,1,3.28
"20240327","1783","9815","9800",元大-大灣,0,3,3,-1,4.92
"20240327","1783","003700300030004c","7000",兆豐-天母,2,0,2,1,3.28
"20240327","1783","9206","9200",凱基-高雄,0,2,2,-1,3.28
"20240327","1783","8440","8440",摩根大通,8,6,2,1,3.28
"20240327","1783","0039003800390050","9800",元大-敦南,0,2,2,-1,3.28
"20240327","1783","8882","8880",國泰-台中,1,0,1,1,1.64
"20240327","1783","0038003100350042","8150",台新-台中,0,2,2,-1,3.28
"20240327","1783","9215","9200",凱基-高美館,1,0,1,1,1.64
"20240327","1783","2185","2180",亞東-台南,0,1,1,-1,1.64
"20240327","1783","0039004100390068","9A00",永豐金-台南,1,0,1,1,1.64
"20240327","1783","0035003900320075","5920",元富-世貿,0,1,1,-1,1.64
"20240327","1783","003700300030004b","7000",兆豐-新營,1,0,1,1,1.64
"20240327","1783","1650","1650",新加坡商瑞銀,0,1,1,-1,1.64
"20240327","1783","003700300030005a","7000",兆豐-高雄,1,0,1,1,1.64
"20240327","1783","6460","6460",大昌,0,1,1,-1,1.64
"20240327","1783","7797","7790",國票-中正,1,0,1,1,1.64
"20240327","1783","6620","6620",口袋證券,0,1,1,-1,1.64
"20240327","1783","0039003600320044","9600",富邦-新莊,1,0,1,1,1.64
"20240327","1783","0037003700390063","7790",國票-敦北法人,0,1,1,-1,1.64
"20240328","1783","9268","9200",凱基-台北,12,2,10,1,10.75
"20240328","1783","003900410039004a","9A00",永豐金-板新,0,12,12,-1,12.90
"20240328","1783","9278","9200",凱基-永康,6,0,6,1,6.45
"20240328","1783","9614","9600",富邦-基隆,0,10,10,-1,10.75
"20240328","1783","8150","8150",台新證券,3,0,3,1,3.23
"20240328","1783","8440","8440",摩根大通,6,10,4,-1,4.30
"20240328","1783","0038003100350041","8150",台新-高雄,3,0,3,1,3.23
"20240328","1783","9801","9800",元大-城東,0,4,4,-1,4.30
"20240328","1783","9134","9100",群益金鼎-開元,3,0,3,1,3.23
"20240328","1783","8888","8880",國泰-敦南,0,3,3,-1,3.23
"20240328","1783","9215","9200",凱基-高美館,3,0,3,1,3.23
"20240328","1783","0031003200360069","1260",宏遠-光隆,0,3,3,-1,3.23
"20240328","1783","9854","9800",元大-文心興安,3,0,3,1,3.23
"20240328","1783","1650","1650",新加坡商瑞銀,0,2,2,-1,2.15
"20240328","1783","003500320036004b","5260",美好-富順,2,0,2,1,2.15
"20240328","1783","0037003700390072","7790",國票-桃園,0,2,2,-1,2.15
"20240328","1783","6451","6450",永全-南崁,2,0,2,1,2.15
"20240328","1783","9300","9300",華南永昌,0,2,2,-1,2.15
"20240328","1783","9136","9100",群益金鼎-西松,2,0,2,1,2.15
"20240328","1783","0039003800390042","9800",元大-台中中港,0,2,2,-1,2.15
"20240328","1783","9188","9100",群益金鼎-三民,2,0,2,1,2.15
"20240328","1783","2185","2180",亞東-台南,0,1,1,-1,1.08
"20240328","1783","9205","9200",凱基-三重,2,0,2,1,2.15
"20240328","1783","0031003000340044","1040",臺銀-金山,0,1,1,-1,1.08
"20240328","1783","9608","9600",富邦-台東,2,0,2,1,2.15
"20240328","1783","7006","7000",兆豐-台南,0,1,1,-1,1.08
"20240328","1783","9672","9600",富邦-員林,2,0,2,1,2.15
"20240328","1783","9187","9100",群益金鼎-彰化,0,1,1,-1,1.08
"20240329","1783","003900380033004b","9800",元大-學甲,4,0,4,1,7.27
"20240329","1783","0037003000300072","7000",兆豐-寶成,0,4,4,-1,7.27
"20240329","1783","0039003800310051","9800",元大-太平,3,0,3,1,5.45
"20240329","1783","8440","8440",摩根大通,2,6,4,-1,7.27
"20240329","1783","9854","9800",元大-文心興安,3,0,3,1,5.45
"20240329","1783","0037003700390050","7790",國票-九鼎,0,3,3,-1,5.45
"20240329","1783","9663","9600",富邦-敦南,2,0,2,1,3.64
"20240329","1783","9268","9200",凱基-台北,1,4,3,-1,5.45
"20240329","1783","5862","5860",盈溢-楠梓,2,0,2,1,3.64
"20240329","1783","9692","9600",富邦-嘉義,0,3,3,-1,5.45
"20240329","1783","9636","9600",富邦-中壢,2,0,2,1,3.64
"20240329","1783","1110","1110",台灣企銀,0,2,2,-1,3.64
"20240329","1783","003900360035004b","9600",富邦-台中,2,0,2,1,3.64
"20240329","1783","6160","6160",中國信託,0,2,2,-1,3.64
"20240329","1783","8888","8880",國泰-敦南,1,0,1,1,1.82
"20240329","1783","9257","9200",凱基-林口,0,2,2,-1,3.64
"20240329","1783","003500390032006c","5920",元富-大裕,1,0,1,1,1.82
"20240329","1783","9352","9300",華南永昌-桃園,0,2,2,-1,3.64
"20240329","1783","003500390032004d","5920",元富-彰化,1,0,1,1,1.82
"20240329","1783","0039003800330056","9800",元大-竹南,0,2,2,-1,3.64
"20240329","1783","1043","1040",臺銀-民權,1,0,1,1,1.82
"20240329","1783","003500320036004b","5260",美好-富順,0,2,2,-1,3.64
"20240329","1783","0035003300380057","5380",第一金-華江,1,0,1,1,1.82
"20240329","1783","8560","8560",新光,0,2,2,-1,3.64
"20240329","1783","0035003900320051","5920",元富-敦南,1,0,1,1,1.82
"20240329","1783","1470","1470",台灣摩根士丹利,0,1,1,-1,1.82
"20240329","1783","0037003000300068","7000",兆豐-三民,1,0,1,1,1.82
"20240329","1783","5852","5850",統一-敦南,0,1,1,-1,1.82
"20240401","1783","9268","9200",凱基-台北,22,1,21,1,9.17
"20240401","1783","0039003800310046","9800",元大-福營,0,10,10,-1,4.37
"20240401","1783","0039003600310050","9600",富邦-和美,10,0,10,1,4.37
"20240401","1783","8565","8560",新光-桃園,0,10,10,-1,4.37
"20240401","1783","0039004100390031","9A00",永豐金-松山,14,4,10,1,4.37
"20240401","1783","0039003800390050","9800",元大-敦南,0,9,9,-1,3.93
"20240401","1783","1650","1650",新加坡商瑞銀,7,0,7,1,3.06
"20240401","1783","9136","9100",群益金鼎-西松,0,6,6,-1,2.62
"20240401","1783","003700300030004c","7000",兆豐-天母,5,0,5,1,2.18
"20240401","1783","1440","1440",美林,0,5,5,-1,2.18
"20240401","1783","0039003100330059","9100",群益金鼎-館前,5,0,5,1,2.18
"20240401","1783","8560","8560",新光,2,7,5,-1,2.18
"20240401","1783","5386","5380",第一金-彰化,4,0,4,1,1.75
"20240401","1783","9303","9300",華南永昌-高雄,0,5,5,-1,2.18
"20240401","1783","0037003000300072","7000",兆豐-寶成,4,0,4,1,1.75
"20240401","1783","003900380031006e","9800",元大-旗山,0,5,5,-1,2.18
"20240401","1783","003900310038004a","9100",群益金鼎-永和,4,0,4,1,1.75
"20240401","1783","003900410039006a","9A00",永豐金-嘉義,0,5,5,-1,2.18
"20240401","1783","9854","9800",元大-文心興安,3,0,3,1,1.31
"20240401","1783","9202","9200",凱基-中港,0,4,4,-1,1.75
"20240401","1783","1260","1260",宏遠證券,10,7,3,1,1.31
"20240401","1783","0039003800390042","9800",元大-台中中港,0,4,4,-1,1.75
"20240401","1783","0035003800350051","5850",統一-三多,5,2,3,1,1.31
"20240401","1783","0039004100370039","9A00",永豐金-埔里,0,4,4,-1,1.75
"20240401","1783","9667","9600",富邦-台南,3,0,3,1,1.31
"20240401","1783","7003","7000",兆豐-台中,0,4,4,-1,1.75
"20240401","1783","5920","5920",元富,2,0,2,1,0.87
"20240401","1783","0039003800300065","9800",元大-清水,0,3,3,-1,1.31
"20240402","1783","9268","9200",凱基-台北,13,4,9,1,4.11
"20240402","1783","003500380035004d","5850",統一-士林,0,11,11,-1,5.02
"20240402","1783","0035003900320062","5920",元富-板橋,8,0,8,1,3.65
"20240402","1783","0039004100390031","9A00",永豐金-松山,0,10,10,-1,4.57
"20240402","1783","8158","8150",台新-松江,8,0,8,1,3.65
"20240402","1783","9343","9300",華南永昌-頭份,0,8,8,-1,3.65
"20240402","1783","5389","5380",第一金-中山,7,0,7,1,3.20
"20240402","1783","0039003600320050","9600",富邦-頭份,0,8,8,-1,3.65
"20240402","1783","5058","5050",大展-台南,5,0,5,1,2.28
"20240402","1783","9857","9800",元大-蘆洲,1,6,5,-1,2.28
"20240402","1783","9215","9200",凱基-高美館,5,0,5,1,2.28
"20240402","1783","0037003000300072","7000",兆豐-寶成,0,4,4,-1,1.83
"20240402","1783","1029","1020",合庫-鳳山,4,0,4,1,1.83
"20240402","1783","0035003800350051","5850",統一-三多,0,3,3,-1,1.37
"20240402","1783","0035003900320051","5920",元富-敦南,4,1,3,1,1.37
"20240402","1783","9627","9600",富邦-內湖,0,3,3,-1,1.37
"20240402","1783","7009","7000",兆豐-景美,3,0,3,1,1.37
"20240402","1783","1260","1260",宏遠證券,0,3,3,-1,1.37
"20240402","1783","9854","9800",元大-文心興安,3,0,3,1,1.37
"20240402","1783","0031003000320043","1020",合庫-自強,0,2,2,-1,0.91
"20240402","1783","0039004100390063","9A00",永豐金-永康,2,0,2,1,0.91
"20240402","1783","1650","1650",新加坡商瑞銀,0,2,2,-1,0.91
"20240402","1783","0035003800350055","5850",統一-南京,2,0,2,1,0.91
"20240402","1783","0035003900320075","5920",元富-世貿,1,3,2,-1,0.91
"20240402","1783","0037003700390065","7790",國票-南科,2,0,2,1,0.91
"20240402","1783","7750","7750",北城證券,0,2,2,-1,0.91
"20240402","1783","0038003800340044","8840",玉山-左營,7,5,2,1,0.91
"20240402","1783","9309","9300",華南永昌-古亭,0,2,2,-1,0.91
"20240403","1783","9604","9600",富邦-陽明,6,0,6,1,6.98
"20240403","1783","9874","9800",元大-雙和,0,19,19,-1,22.09
"20240403","1783","8882","8880",國泰-台中,5,0,5,1,5.81
"20240403","1783","003700300030004c","7000",兆豐-天母,0,7,7,-1,8.14
"20240403","1783","9875","9800",元大-土城永寧,6,2,4,1,4.65
"20240403","1783","003900310038004d","9100",群益金鼎-嘉義,0,3,3,-1,3.49
"20240403","1783","0039004100390055","9A00",永豐金-中正,3,0,3,1,3.49
"20240403","1783","9268","9200",凱基-台北,0,3,3,-1,3.49
"20240403","1783","9636","9600",富邦-中壢,3,0,3,1,3.49
"20240403","1783","9672","9600",富邦-員林,0,3,3,-1,3.49
"20240403","1783","8440","8440",摩根大通,5,2,3,1,3.49
"20240403","1783","1440","1440",美林,1,3,2,-1,2.33
"20240403","1783","0038003800340044","8840",玉山-左營,3,0,3,1,3.49
"20240403","1783","9893","9800",元大-大天母,0,2,2,-1,2.33
"20240403","1783","0039003200300044","9200",凱基-市府,3,0,3,1,3.49
"20240403","1783","9868","9800",元大-文心,0,2,2,-1,2.33
"20240403","1783","9666","9600",富邦-南屯,3,0,3,1,3.49
"20240403","1783","5058","5050",大展-台南,0,1,1,-1,1.16
"20240403","1783","0038003100350042","8150",台新-台中,2,0,2,1,2.33
"20240403","1783","1020","1020",合庫證券,0,1,1,-1,1.16
"20240403","1783","9834","9800",元大-中壢,2,0,2,1,2.33
"20240403","1783","1480","1480",美商高盛,0,1,1,-1,1.16
"20240403","1783","0031003000340041","1040",臺銀-臺中,2,0,2,1,2.33
"20240403","1783","003600310036004b","6160",中國信託-高雄,0,1,1,-1,1.16
"20240403","1783","1042","1040",臺銀-臺南,2,0,2,1,2.33
"20240403","1783","0039003100330067","9100",群益金鼎-三重,0,1,1,-1,1.16
"20240403","1783","0035003800350046","5850",統一-彰化,2,0,2,1,2.33
"20240403","1783","0039003100380069","9100",群益金鼎-竹南,0,1,1,-1,1.16
"20240408","1783","0031003000320041","1020",合庫-新竹,10,0,10,1,3.89
"20240408","1783","9874","9800",元大-雙和,0,26,26,-1,10.12
"20240408","1783","9339","9300",華南永昌-竹北,10,0,10,1,3.89
"20240408","1783","0039003800320041","9800",元大-羅東,0,18,18,-1,7.00
"20240408","1783","9875","9800",元大-土城永寧,10,0,10,1,3.89
"20240408","1783","6464","6460",大昌-新店,0,16,16,-1,6.23
"20240408","1783","0039003800300051","9800",元大-南崁,9,0,9,1,3.50
"20240408","1783","9655","9600",富邦-板橋,0,14,14,-1,5.45
"20240408","1783","0039003800320042","9800",元大-博愛,10,2,8,1,3.11
"20240408","1783","0039003600310050","9600",富邦-和美,0,10,10,-1,3.89
"20240408","1783","1440","1440",美林,8,1,7,1,2.72
"20240408","1783","9268","9200",凱基-台北,0,10,10,-1,3.89
"20240408","1783","0035003900320072","5920",元富-城東,7,1,6,1,2.33
"20240408","1783","0037003700390050","7790",國票-九鼎,0,7,7,-1,2.72
"20240408","1783","9134","9100",群益金鼎-開元,6,0,6,1,2.33
"20240408","1783","8159","8150",台新-台南,0,5,5,-1,1.95
"20240408","1783","003900380033004b","9800",元大-學甲,6,0,6,1,2.33
"20240408","1783","8380","8380",安泰,0,5,5,-1,1.95
"20240408","1783","6012","6010",(牛牛牛)亞-網路,5,0,5,1,1.95
"20240408","1783","9636","9600",富邦-中壢,3,8,5,-1,1.95
"20240408","1783","6452","6450",永全-八德,5,0,5,1,1.95
"20240408","1783","9229","9200",凱基-中山,0,4,4,-1,1.56
"20240408","1783","9857","9800",元大-蘆洲,5,0,5,1,1.95
"20240408","1783","9319","9300",華南永昌-鶯歌,0,4,4,-1,1.56
"20240408","1783","003900410039006a","9A00",永豐金-嘉義,5,0,5,1,1.95
"20240408","1783","9661","9600",富邦-新店,0,4,4,-1,1.56
"20240408","1783","1650","1650",新加坡商瑞銀,5,1,4,1,1.56
"20240408","1783","0035003900320045","5920",元富-城中,0,3,3,-1,1.17
"20240409","1783","1650","1650",新加坡商瑞銀,13,0,13,1,10.92
"20240409","1783","003900380039004a","9800",元大-彰化民生,0,10,10,-1,8.40
"20240409","1783","1440","1440",美林,10,2,8,1,6.72
"20240409","1783","0039003100380044","9100",群益金鼎-東門,0,8,8,-1,6.72
"20240409","1783","8440","8440",摩根大通,7,2,5,1,4.20
"20240409","1783","0031003000320046","1020",合庫-西台中,0,8,8,-1,6.72
"20240409","1783","0039004100390038","9A00",永豐金-大園,5,0,5,1,4.20
"20240409","1783","0039003200300046","9200",凱基-站前,0,7,7,-1,5.88
"20240409","1783","8882","8880",國泰-台中,4,0,4,1,3.36
"20240409","1783","5923","5920",元富-三重,0,6,6,-1,5.04
"20240409","1783","8560","8560",新光,4,0,4,1,3.36
"20240409","1783","0039003600320050","9600",富邦-頭份,0,5,5,-1,4.20
"20240409","1783","6114","6110",台中銀-員林,3,0,3,1,2.52
"20240409","1783","9136","9100",群益金鼎-西松,0,5,5,-1,4.20
"20240409","1783","9854","9800",元大-文心興安,3,0,3,1,2.52
"20240409","1783","0039003100330059","9100",群益金鼎-館前,0,5,5,-1,4.20
"20240409","1783","9858","9800",元大-龍潭,3,0,3,1,2.52
"20240409","1783","003900380039004e","9800",元大-內湖,0,5,5,-1,4.20
"20240409","1783","8888","8880",國泰-敦南,2,0,2,1,1.68
"20240409","1783","6164","6160",中國信託-文心,0,4,4,-1,3.36
"20240409","1783","8561","8560",新光-台中,2,0,2,1,1.68
"20240409","1783","0031003000340041","1040",臺銀-臺中,0,3,3,-1,2.52
"20240409","1783","9871","9800",元大-忠孝,2,0,2,1,1.68
"20240409","1783","9352","9300",華南永昌-桃園,0,3,3,-1,2.52
"20240409","1783","0039003800390051","9800",元大-汐止,2,0,2,1,1.68
"20240409","1783","9896","9800",元大-台南,0,3,3,-1,2.52
"20240409","1783","0037003000300068","7000",兆豐-三民,2,0,2,1,1.68
"20240409","1783","9223","9200",凱基-豐中,0,2,2,-1,1.68
"20240410","1783","8440","8440",摩根大通,28,2,26,1,14.61
"20240410","1783","9136","9100",群益金鼎-西松,0,10,10,-1,5.62
"20240410","1783","1650","1650",新加坡商瑞銀,9,2,7,1,3.93
"20240410","1783","9268","9200",凱基-台北,3,13,10,-1,5.62
"20240410","1783","1560","1560",港商野村,6,0,6,1,3.37
"20240410","1783","9339","9300",華南永昌-竹北,0,10,10,-1,5.62
"20240410","1783","1042","1040",臺銀-臺南,5,0,5,1,2.81
"20240410","1783","0039003800330056","9800",元大-竹南,0,9,9,-1,5.06
"20240410","1783","003700300030004c","7000",兆豐-天母,5,0,5,1,2.81
"20240410","1783","9326","9300",華南永昌-南京,0,8,8,-1,4.49
"20240410","1783","1440","1440",美林,12,7,5,1,2.81
"20240410","1783","0039003600320050","9600",富邦-頭份,0,8,8,-1,4.49
"20240410","1783","9208","9200",凱基-桃園,5,0,5,1,2.81
"20240410","1783","8848","8840",玉山-嘉義,0,5,5,-1,2.81
"20240410","1783","9239","9200",凱基-市政,3,0,3,1,1.69
"20240410","1783","9229","9200",凱基-中山,0,5,5,-1,2.81
"20240410","1783","5856","5850",統一-台中,3,0,3,1,1.69
"20240410","1783","9878","9800",元大-金華,0,5,5,-1,2.81
"20240410","1783","0035003800350049","5850",統一-員林,3,0,3,1,1.69
"20240410","1783","0039004100390038","9A00",永豐金-大園,0,5,5,-1,2.81
"20240410","1783","003500390032006d","5920",元富-成功,3,0,3,1,1.69
"20240410","1783","9604","9600",富邦-陽明,2,5,3,-1,1.69
"20240410","1783","0035003900320072","5920",元富-城東,3,0,3,1,1.69
"20240410","1783","5380","5380",第一金,0,3,3,-1,1.69
"20240410","1783","9875","9800",元大-土城永寧,3,0,3,1,1.69
"20240410","1783","9634","9600",富邦-羅東,0,3,3,-1,1.69
"20240410","1783","6464","6460",大昌-新店,2,0,2,1,1.12
"20240410","1783","9894","9800",元大-桃興,0,3,3,-1,1.69
"20240411","1783","1038","1030",土銀-和平,10,0,10,1,7.69
"20240411","1783","003700300030004c","7000",兆豐-天母,0,8,8,-1,6.15
"20240411","1783","1560","1560",港商野村,9,0,9,1,6.92
"20240411","1783","1650","1650",新加坡商瑞銀,0,7,7,-1,5.38
"20240411","1783","003500390032006d","5920",元富-成功,8,0,8,1,6.15
"20240411","1783","9326","9300",華南永昌-南京,0,6,6,-1,4.62
"20240411","1783","5855","5850",統一-台南,5,0,5,1,3.85
"20240411","1783","0035003900320072","5920",元富-城東,0,6,6,-1,4.62
"20240411","1783","003900380031007a","9800",元大-大統,5,0,5,1,3.85
"20240411","1783","003900410039006a","9A00",永豐金-嘉義,0,5,5,-1,3.85
"20240411","1783","0039003800310072","9800",元大-屏南,4,0,4,1,3.08
"20240411","1783","9208","9200",凱基-桃園,1,5,4,-1,3.08
"20240411","1783","0039003600310048","9600",富邦-新板,3,0,3,1,2.31
"20240411","1783","5320","5320",高橋,0,3,3,-1,2.31
"20240411","1783","9854","9800",元大-文心興安,3,0,3,1,2.31
"20240411","1783","0035003800350049","5850",統一-員林,0,3,3,-1,2.31
"20240411","1783","9352","9300",華南永昌-桃園,3,0,3,1,2.31
"20240411","1783","6451","6450",永全-南崁,1,4,3,-1,2.31
"20240411","1783","8560","8560",新光,4,1,3,1,2.31
"20240411","1783","0039003200300056","9200",凱基-新店,0,3,3,-1,2.31
"20240411","1783","003900360031005a","9600",富邦-永康,2,0,2,1,1.54
"20240411","1783","9226","9200",凱基-汐止,0,3,3,-1,2.31
"20240411","1783","9825","9800",元大-新營,2,0,2,1,1.54
"20240411","1783","9236","9200",凱基-虎尾,0,3,3,-1,2.31
"20240411","1783","8561","8560",新光-台中,2,0,2,1,1.54
"20240411","1783","9268","9200",凱基-台北,4,7,3,-1,2.31
"20240411","1783","8888","8880",國泰-敦南,2,0,2,1,1.54
"20240411","1783","9627","9600",富邦-內湖,0,2,2,-1,1.54
"20240412","1783","003900380030006c","9800",元大-虎尾,5,0,5,1,8.93
"20240412","1783","8458","8450",康和-台南,0,6,6,-1,10.71
"20240412","1783","0038003800340043","8840",玉山-南京東路,3,0,3,1,5.36
"20240412","1783","8159","8150",台新-台南,0,4,4,-1,7.14
"20240412","1783","0039003100330059","9100",群益金鼎-館前,3,0,3,1,5.36
"20240412","1783","9229","9200",凱基-中山,0,4,4,-1,7.14
"20240412","1783","003500390032006d","5920",元富-成功,2,0,2,1,3.57
"20240412","1783","9627","9600",富邦-內湖,0,3,3,-1,5.36
"20240412","1783","1440","1440",美林,6,4,2,1,3.57
"20240412","1783","9834","9800",元大-中壢,0,2,2,-1,3.57
"20240412","1783","7797","7790",國票-中正,2,0,2,1,3.57
"20240412","1783","0039004100300030","9A00",永豐金證券,0,1,1,-1,1.79
"20240412","1783","8561","8560",新光-台中,2,0,2,1,3.57
"20240412","1783","0031003200360055","1260",宏遠-館前,0,1,1,-1,1.79
"20240412","1783","0039003800310067","9800",元大-大里,2,0,2,1,3.57
"20240412","1783","5322","5320",高橋-中壢,0,1,1,-1,1.79
"20240412","1783","003900380031005a","9800",元大-潮州,2,0,2,1,3.57
"20240412","1783","7005","7000",兆豐-台中港,0,1,1,-1,1.79
"20240412","1783","0039004100390073","9A00",永豐金-彰化,3,1,2,1,3.57
"20240412","1783","7034","7030",致和-金華,0,1,1,-1,1.79
"20240412","1783","1042","1040",臺銀-臺南,1,0,1,1,1.79
"20240412","1783","0037003700390048","7790",國票-嘉義,0,1,1,-1,1.79
"20240412","1783","0035003900320077","5920",元富-佳里,1,0,1,1,1.79
"20240412","1783","8440","8440",摩根大通,0,1,1,-1,1.79
"20240412","1783","0035003900320072","5920",元富-城東,1,0,1,1,1.79
"20240412","1783","8840","8840",玉山證券,0,1,1,-1,1.79
"20240412","1783","0035003900320050","5920",元富-同大,1,0,1,1,1.79
"20240412","1783","9136","9100",群益金鼎-西松,0,1,1,-1,1.79
"20240415","1783","0039004100390072","9A00",永豐金-北高雄,13,0,13,1,6.40
"20240415","1783","8440","8440",摩根大通,0,19,19,-1,9.36
"20240415","1783","0039003800300051","9800",元大-南崁,11,1,10,1,4.93
"20240415","1783","003500390032006d","5920",元富-成功,0,12,12,-1,5.91
"20240415","1783","9623","9600",富邦-台北,10,0,10,1,4.93
"20240415","1783","9285","9200",凱基-中壢,0,12,12,-1,5.91
"20240415","1783","9875","9800",元大-土城永寧,8,1,7,1,3.45
"20240415","1783","0039004100390055","9A00",永豐金-中正,0,12,12,-1,5.91
"20240415","1783","9205","9200",凱基-三重,5,0,5,1,2.46
"20240415","1783","5928","5920",元富-新莊,0,11,11,-1,5.42
"20240415","1783","003900380031006e","9800",元大-旗山,5,0,5,1,2.46
"20240415","1783","8150","8150",台新證券,4,14,10,-1,4.93
"20240415","1783","9898","9800",元大-新莊,5,0,5,1,2.46
"20240415","1783","9215","9200",凱基-高美館,0,8,8,-1,3.94
"20240415","1783","003900410039006a","9A00",永豐金-嘉義,5,0,5,1,2.46
"20240415","1783","9268","9200",凱基-台北,0,7,7,-1,3.45
"20240415","1783","8581","8580",聯邦-高雄,4,0,4,1,1.97
"20240415","1783","9627","9600",富邦-內湖,0,5,5,-1,2.46
"20240415","1783","0039003200300045","9200",凱基-東門,4,0,4,1,1.97
"20240415","1783","9308","9300",華南永昌-麻豆,0,4,4,-1,1.97
"20240415","1783","0039003100380067","9100",群益金鼎-大甲,3,0,3,1,1.48
"20240415","1783","0039003800330056","9800",元大-竹南,0,4,4,-1,1.97
"20240415","1783","1650","1650",新加坡商瑞銀,7,4,3,1,1.48
"20240415","1783","8888","8880",國泰-敦南,1,5,4,-1,1.97
"20240415","1783","8840","8840",玉山證券,3,0,3,1,1.48
"20240415","1783","1119","1110",台灣企銀-岡山,0,3,3,-1,1.48
"20240415","1783","8841","8840",玉山-雙和,3,0,3,1,1.48
"20240415","1783","5856","5850",統一-台中,0,3,3,-1,1.48
"20240416","1783","9623","9600",富邦-台北,14,0,14,1,5.74
"20240416","1783","1650","1650",新加坡商瑞銀,1,22,21,-1,8.61
"20240416","1783","8886","8880",國泰-新莊,13,0,13,1,5.33
"20240416","1783","8150","8150",台新證券,0,16,16,-1,6.56
"20240416","1783","6161","6160",中國信託-三重,10,0,10,1,4.10
"20240416","1783","9329","9300",華南永昌-朴子,0,15,15,-1,6.15
"20240416","1783","9636","9600",富邦-中壢,10,0,10,1,4.10
"20240416","1783","9352","9300",華南永昌-桃園,0,11,11,-1,4.51
"20240416","1783","003900380031006e","9800",元大-旗山,10,0,10,1,4.10
"20240416","1783","0037003700390065","7790",國票-南科,0,11,11,-1,4.51
"20240416","1783","7006","7000",兆豐-台南,6,0,6,1,2.46
"20240416","1783","9268","9200",凱基-台北,15,25,10,-1,4.10
"20240416","1783","1022","1020",合庫-台南,5,0,5,1,2.05
"20240416","1783","0039003800310051","9800",元大-太平,0,10,10,-1,4.10
"20240416","1783","7750","7750",北城證券,5,0,5,1,2.05
"20240416","1783","9692","9600",富邦-嘉義,0,9,9,-1,3.69
"20240416","1783","0039003100380045","9100",群益金鼎-南京,5,0,5,1,2.05
"20240416","1783","003900380031007a","9800",元大-大統,0,5,5,-1,2.05
"20240416","1783","9857","9800",元大-蘆洲,5,1,4,1,1.64
"20240416","1783","9215","9200",凱基-高美館,0,5,5,-1,2.05
"20240416","1783","0039003800310067","9800",元大-大里,4,0,4,1,1.64
"20240416","1783","5321","5320",高橋-龍潭,0,5,5,-1,2.05
"20240416","1783","0039003800390042","9800",元大-台中中港,4,0,4,1,1.64
"20240416","1783","1440","1440",美林,2,6,4,-1,1.64
"20240416","1783","9604","9600",富邦-陽明,3,0,3,1,1.23
"20240416","1783","1480","1480",美商高盛,0,3,3,-1,1.23
"20240416","1783","0035003800350044","5850",統一-新台中,4,1,3,1,1.23
"20240416","1783","8883","8880",國泰-松江,0,3,3,-1,1.23
"20240417","1783","7006","7000",兆豐-台南,19,0,19,1,15.45
"20240417","1783","5262","5260",美好-楊梅,0,7,7,-1,5.69
"20240417","1783","8440","8440",摩根大通,15,4,11,1,8.94
"20240417","1783","0039003800320042","9800",元大-博愛,0,7,7,-1,5.69
"20240417","1783","0035003900320041","5920",元富-緯城,5,0,5,1,4.07
"20240417","1783","9319","9300",華南永昌-鶯歌,0,6,6,-1,4.88
"20240417","1783","003500380035004d","5850",統一-士林,5,0,5,1,4.07
"20240417","1783","0038003800380041","8880",國泰-館前,0,5,5,-1,4.07
"20240417","1783","1440","1440",美林,4,1,3,1,2.44
"20240417","1783","6012","6010",(牛牛牛)亞-網路,0,5,5,-1,4.07
"20240417","1783","9136","9100",群益金鼎-西松,3,0,3,1,2.44
"20240417","1783","9627","9600",富邦-內湖,0,5,5,-1,4.07
"20240417","1783","0031003000340043","1040",臺銀-高雄,2,0,2,1,1.63
"20240417","1783","8563","8560",新光-新竹,0,4,4,-1,3.25
"20240417","1783","8560","8560",新光,2,0,2,1,1.63
"20240417","1783","8847","8840",玉山-台南,0,4,4,-1,3.25
"20240417","1783","8561","8560",新光-台中,2,0,2,1,1.63
"20240417","1783","8888","8880",國泰-敦南,2,6,4,-1,3.25
"20240417","1783","0038003800340044","8840",玉山-左營,2,0,2,1,1.63
"20240417","1783","0039004100390057","9A00",永豐金-市政,0,4,4,-1,3.25
"20240417","1783","003900310038004b","9100",群益金鼎-東湖,2,0,2,1,1.63
"20240417","1783","1022","1020",合庫-台南,0,3,3,-1,2.44
"20240417","1783","003900380031006a","9800",元大-士林,2,0,2,1,1.63
"20240417","1783","9215","9200",凱基-高美館,0,3,3,-1,2.44
"20240417","1783","0039003800310051","9800",元大-太平,2,0,2,1,1.63
"20240417","1783","9268","9200",凱基-台北,3,6,3,-1,2.44
"20240417","1783","003900380033005a","9800",元大-鳳山,2,0,2,1,1.63
"20240417","1783","9692","9600",富邦-嘉義,0,3,3,-1,2.44
"20240418","1783","9326","9300",華南永昌-南京,6,0,6,1,7.32
"20240418","1783","9693","9600",富邦-新營,0,5,5,-1,6.10
"20240418","1783","9672","9600",富邦-員林,5,0,5,1,6.10
"20240418","1783","8561","8560",新光-台中,0,3,3,-1,3.66
"20240418","1783","1440","1440",美林,7,4,3,1,3.66
"20240418","1783","8847","8840",玉山-台南,0,2,2,-1,2.44
"20240418","1783","1560","1560",港商野村,3,0,3,1,3.66
"20240418","1783","8888","8880",國泰-敦南,0,2,2,-1,2.44
"20240418","1783","0037003000300063","7000",兆豐-民生,3,0,3,1,3.66
"20240418","1783","003900310038004b","9100",群益金鼎-東湖,0,2,2,-1,2.44
"20240418","1783","003900410039004c","9A00",永豐金-台中,3,0,3,1,3.66
"20240418","1783","0039003800310051","9800",元大-太平,0,1,1,-1,1.22
"20240418","1783","7032","7030",致和-佳里,2,0,2,1,2.44
"20240418","1783","0031003200360069","1260",宏遠-光隆,0,1,1,-1,1.22
"20240418","1783","7797","7790",國票-中正,2,0,2,1,2.44
"20240418","1783","0031003100310047","1110",台灣企銀-埔墘,0,1,1,-1,1.22
"20240418","1783","0037003700390065","7790",國票-南科,2,0,2,1,2.44
"20240418","1783","1022","1020",合庫-台南,0,1,1,-1,1.22
"20240418","1783","8150","8150",台新證券,2,0,2,1,2.44
"20240418","1783","1020","1020",合庫證券,0,1,1,-1,1.22
"20240418","1783","8560","8560",新光,3,1,2,1,2.44
"20240418","1783","003500390032006e","5920",元富-西松,0,1,1,-1,1.22
"20240418","1783","003900360031005a","9600",富邦-永康,1,0,1,1,1.22
"20240418","1783","0038003100350042","8150",台新-台中,0,1,1,-1,1.22
"20240418","1783","1650","1650",新加坡商瑞銀,5,4,1,1,1.22
"20240418","1783","003900310038004c","9100",群益金鼎-建成,0,1,1,-1,1.22
"20240418","1783","0035003800350044","5850",統一-新台中,1,0,1,1,1.22
"20240418","1783","9317","9300",華南永昌-林口,0,1,1,-1,1.22
"20240419","1783","0037003700390058","7790",國票-中和,25,0,25,1,6.81
"20240419","1783","0031003000320043","1020",合庫-自強,1,42,41,-1,11.17
"20240419","1783","7006","7000",兆豐-台南,20,0,20,1,5.45
"20240419","1783","5855","5850",統一-台南,12,51,39,-1,10.63
"20240419","1783","6161","6160",中國信託-三重,15,0,15,1,4.09
"20240419","1783","8440","8440",摩根大通,13,36,23,-1,6.27
"20240419","1783","003900380031006e","9800",元大-旗山,15,0,15,1,4.09
"20240419","1783","9255","9200",凱基-和平,0,18,18,-1,4.90
"20240419","1783","003900310038004d","9100",群益金鼎-嘉義,10,0,10,1,2.72
"20240419","1783","8711","8710",陽信-石牌,0,14,14,-1,3.81
"20240419","1783","0039003800390044","9800",元大-左營,10,0,10,1,2.72
"20240419","1783","0035003300380050","5380",第一金-路竹,0,13,13,-1,3.54
"20240419","1783","8560","8560",新光,10,2,8,1,2.18
"20240419","1783","9103","9100",群益金鼎-松山,0,10,10,-1,2.72
"20240419","1783","1440","1440",美林,12,5,7,1,1.91
"20240419","1783","1650","1650",新加坡商瑞銀,9,16,7,-1,1.91
"20240419","1783","9659","9600",富邦-高雄,6,0,6,1,1.63
"20240419","1783","0039004100390042","9A00",永豐金-中和,0,5,5,-1,1.36
"20240419","1783","5321","5320",高橋-龍潭,5,0,5,1,1.36
"20240419","1783","0039004100390057","9A00",永豐金-市政,1,6,5,-1,1.36
"20240419","1783","9322","9300",華南永昌-基隆,5,0,5,1,1.36
"20240419","1783","003800380034004a","8840",玉山-大里,0,4,4,-1,1.09
"20240419","1783","0039003800310069","9800",元大-西螺,5,0,5,1,1.36
"20240419","1783","0039003200300043","9200",凱基-雙和,0,4,4,-1,1.09
"20240419","1783","0039004100360031","9A00",永豐金-鳳山,5,0,5,1,1.36
"20240419","1783","9235","9200",凱基-永華,0,4,4,-1,1.09
"20240419","1783","0038003100350041","8150",台新-高雄,4,0,4,1,1.09
"20240419","1783","0039003800310045","9800",元大-發財,0,4,4,-1,1.09
"20240422","1783","0039003800310043","9800",元大-路竹,10,0,10,1,8.06
"20240422","1783","003900410039004c","9A00",永豐金-台中,0,7,7,-1,5.65
"20240422","1783","1440","1440",美林,16,7,9,1,7.26
"20240422","1783","9235","9200",凱基-永華,0,6,6,-1,4.84
"20240422","1783","9800","9800",元大證券,7,1,6,1,4.84
"20240422","1783","0035003800350059","5850",統一-土城,0,5,5,-1,4.03
"20240422","1783","5920","5920",元富,3,0,3,1,2.42
"20240422","1783","1043","1040",臺銀-民權,0,5,5,-1,4.03
"20240422","1783","9634","9600",富邦-羅東,3,0,3,1,2.42
"20240422","1783","0037003700390065","7790",國票-南科,0,5,5,-1,4.03
"20240422","1783","0039004100390037","9A00",永豐金-新竹,3,0,3,1,2.42
"20240422","1783","0037003000300063","7000",兆豐-民生,0,3,3,-1,2.42
"20240422","1783","9898","9800",元大-新莊,3,0,3,1,2.42
"20240422","1783","9136","9100",群益金鼎-西松,0,3,3,-1,2.42
"20240422","1783","1042","1040",臺銀-臺南,2,0,2,1,1.61
"20240422","1783","1470","1470",台灣摩根士丹利,0,2,2,-1,1.61
"20240422","1783","1030","1030",土銀,2,0,2,1,1.61
"20240422","1783","003900320031004d","9200",凱基-八德,0,2,2,-1,1.61
"20240422","1783","9871","9800",元大-忠孝,1,0,1,1,0.81
"20240422","1783","9813","9800",元大-八德,0,2,2,-1,1.61
"20240422","1783","6110","6110",台中銀,1,0,1,1,0.81
"20240422","1783","9834","9800",元大-中壢,0,2,2,-1,1.61
"20240422","1783","1650","1650",新加坡商瑞銀,5,4,1,1,0.81
"20240422","1783","003900380033005a","9800",元大-鳳山,0,2,2,-1,1.61
"20240422","1783","003800340035004a","8450",康和-高雄,1,0,1,1,0.81
"20240422","1783","9859","9800",元大-新竹經國,0,2,2,-1,1.61
"20240422","1783","8882","8880",國泰-台中,1,0,1,1,0.81
"20240422","1783","0039003800390051","9800",元大-汐止,0,2,2,-1,1.61
"20240423","1783","9898","9800",元大-新莊,7,0,7,1,8.43
"20240423","1783","003900360031004e","9600",富邦-西壢,0,7,7,-1,8.43
"20240423","1783","1440","1440",美林,8,1,7,1,8.43
"20240423","1783","1650","1650",新加坡商瑞銀,4,9,5,-1,6.02
"20240423","1783","0037003000300066","7000",兆豐-鹿港,6,0,6,1,7.23
"20240423","1783","8560","8560",新光,0,5,5,-1,6.02
"20240423","1783","0038003100350041","8150",台新-高雄,5,0,5,1,6.02
"20240423","1783","5855","5850",統一-台南,0,4,4,-1,4.82
"20240423","1783","9319","9300",華南永昌-鶯歌,5,0,5,1,6.02
"20240423","1783","9229","9200",凱基-中山,0,4,4,-1,4.82
"20240423","1783","9800","9800",元大證券,3,0,3,1,3.61
"20240423","1783","1560","1560",港商野村,0,3,3,-1,3.61
"20240423","1783","8440","8440",摩根大通,4,1,3,1,3.61
"20240423","1783","1040","1040",臺銀,0,3,3,-1,3.61
"20240423","1783","8561","8560",新光-台中,4,1,3,1,3.61
"20240423","1783","7009","7000",兆豐-景美,0,3,3,-1,3.61
"20240423","1783","003700370039005a","7790",國票-安和,2,0,2,1,2.41
"20240423","1783","9801","9800",元大-城東,0,3,3,-1,3.61
"20240423","1783","003500390032006f","5920",元富-新興,2,0,2,1,2.41
"20240423","1783","9834","9800",元大-中壢,0,3,3,-1,3.61
"20240423","1783","0039003800310067","9800",元大-大里,2,0,2,1,2.41
"20240423","1783","0037003000300052","7000",兆豐-小港,0,2,2,-1,2.41
"20240423","1783","9647","9600",富邦-新竹,1,0,1,1,1.20
"20240423","1783","0039004100390057","9A00",永豐金-市政,0,2,2,-1,2.41
"20240423","1783","1470","1470",台灣摩根士丹利,1,0,1,1,1.20
"20240423","1783","9363","9300",華南永昌-彰化,1,2,1,-1,1.20
"20240423","1783","9297","9200",凱基-文心,1,0,1,1,1.20
"20240423","1783","7032","7030",致和-佳里,0,1,1,-1,1.20
"20240424","1783","1042","1040",臺銀-臺南,3,0,3,1,8.82
"20240424","1783","6382","6380",光和-田中,0,2,2,-1,5.88
"20240424","1783","003900380031004e","9800",元大-金門,3,0,3,1,8.82
"20240424","1783","6168","6160",中國信託-嘉義,0,2,2,-1,5.88
"20240424","1783","003500390032006f","5920",元富-新興,2,0,2,1,5.88
"20240424","1783","2187","2180",亞東-台中,0,2,2,-1,5.88
"20240424","1783","1650","1650",新加坡商瑞銀,2,0,2,1,5.88
"20240424","1783","8158","8150",台新-松江,0,2,2,-1,5.88
"20240424","1783","8159","8150",台新-台南,2,0,2,1,5.88
"20240424","1783","1037","1030",土銀-花蓮,0,1,1,-1,2.94
"20240424","1783","9854","9800",元大-文心興安,2,0,2,1,5.88
"20240424","1783","0031003000320043","1020",合庫-自強,0,1,1,-1,2.94
"20240424","1783","0031003000340044","1040",臺銀-金山,1,0,1,1,2.94
"20240424","1783","0037003700390048","7790",國票-嘉義,0,1,1,-1,2.94
"20240424","1783","1560","1560",港商野村,1,0,1,1,2.94
"20240424","1783","0038003100350041","8150",台新-高雄,0,1,1,-1,2.94
"20240424","1783","0038003100350048","8150",台新-屏東,1,0,1,1,2.94
"20240424","1783","8440","8440",摩根大通,0,1,1,-1,2.94
"20240424","1783","8561","8560",新光-台中,1,0,1,1,2.94
"20240424","1783","0038003400350044","8450",康和-板橋,0,1,1,-1,2.94
"20240424","1783","0039003800300043","9800",元大-斗六,1,0,1,1,2.94
"20240424","1783","8562","8560",新光-高雄,0,1,1,-1,2.94
"20240424","1783","0039003800310049","9800",元大-天母,1,0,1,1,2.94
"20240424","1783","0038003800340045","8840",玉山-城中,0,1,1,-1,2.94
"20240424","1783","0039004100390038","9A00",永豐金-大園,1,0,1,1,2.94
"20240424","1783","9136","9100",群益金鼎-西松,0,1,1,-1,2.94
"20240424","1783","9326","9300",華南永昌-南京,1,0,1,1,2.94
"20240424","1783","9268","9200",凱基-台北,0,1,1,-1,2.94
"20240425","1783","9268","9200",凱基-台北,6,2,4,1,10.26
"20240425","1783","9319","9300",華南永昌-鶯歌,0,5,5,-1,12.82
"20240425","1783","6452","6450",永全-八德,3,0,3,1,7.69
"20240425","1783","0039003600320050","9600",富邦-頭份,0,4,4,-1,10.26
"20240425","1783","1480","1480",美商高盛,3,0,3,1,7.69
"20240425","1783","9229","9200",凱基-中山,0,3,3,-1,7.69
"20240425","1783","5381","5380",第一金-員林,3,0,3,1,7.69
"20240425","1783","8848","8840",玉山-嘉義,0,2,2,-1,5.13
"20240425","1783","9854","9800",元大-文心興安,2,0,2,1,5.13
"20240425","1783","9226","9200",凱基-汐止,0,2,2,-1,5.13
"20240425","1783","0038003100350041","8150",台新-高雄,1,0,1,1,2.56
"20240425","1783","9686","9600",富邦-宜蘭,0,2,2,-1,5.13
"20240425","1783","1029","1020",合庫-鳳山,1,0,1,1,2.56
"20240425","1783","0039003800310058","9800",元大-新生,0,2,2,-1,5.13
"20240425","1783","9131","9100",群益金鼎-民權,1,0,1,1,2.56
"20240425","1783","1650","1650",新加坡商瑞銀,0,1,1,-1,2.56
"20240425","1783","0039003200310047","9200",凱基-五股,1,0,1,1,2.56
"20240425","1783","8440","8440",摩根大通,0,1,1,-1,2.56
"20240425","1783","0039003600310052","9600",富邦-南員林,1,0,1,1,2.56
"20240425","1783","9208","9200",凱基-桃園,0,1,1,-1,2.56
"20240425","1783","9634","9600",富邦-羅東,1,0,1,1,2.56
"20240425","1783","9627","9600",富邦-內湖,0,1,1,-1,2.56
"20240425","1783","9655","9600",富邦-板橋,1,0,1,1,2.56
"20240425","1783","0039003800300051","9800",元大-南崁,0,1,1,-1,2.56
"20240425","1783","0039003600350055","9600",富邦-彰化,1,0,1,1,2.56
"20240425","1783","9661","9600",富邦-新店,1,0,1,1,2.56
"20240426","1783","0037003700390065","7790",國票-南科,5,0,5,1,4.85
"20240426","1783","9268","9200",凱基-台北,0,19,19,-1,18.45
"20240426","1783","0039003100380067","9100",群益金鼎-大甲,4,0,4,1,3.88
"20240426","1783","9692","9600",富邦-嘉義,0,6,6,-1,5.83
"20240426","1783","1041","1040",臺銀-鳳山,3,0,3,1,2.91
"20240426","1783","0037003000300053","7000",兆豐-大同,0,5,5,-1,4.85
"20240426","1783","9136","9100",群益金鼎-西松,3,0,3,1,2.91
"20240426","1783","9208","9200",凱基-桃園,0,5,5,-1,4.85
"20240426","1783","0039003600310058","9600",富邦-大墩(停),3,0,3,1,2.91
"20240426","1783","9852","9800",元大-永春,0,5,5,-1,4.85
"20240426","1783","0031003200360055","1260",宏遠-館前,2,0,2,1,1.94
"20240426","1783","5920","5920",元富,4,8,4,-1,3.88
"20240426","1783","0035003900320050","5920",元富-同大,2,0,2,1,1.94
"20240426","1783","8440","8440",摩根大通,0,3,3,-1,2.91
"20240426","1783","8150","8150",台新證券,2,0,2,1,1.94
"20240426","1783","003500390032006d","5920",元富-成功,0,2,2,-1,1.94
"20240426","1783","0038003800380041","8880",國泰-館前,2,0,2,1,1.94
"20240426","1783","5384","5380",第一金-台南,0,2,2,-1,1.94
"20240426","1783","9205","9200",凱基-三重,2,0,2,1,1.94
"20240426","1783","8562","8560",新光-高雄,0,2,2,-1,1.94
"20240426","1783","9206","9200",凱基-高雄,2,0,2,1,1.94
"20240426","1783","9101","9100",群益金鼎-敦南,1,3,2,-1,1.94
"20240426","1783","0039003200300048","9200",凱基-基隆,2,0,2,1,1.94
"20240426","1783","9604","9600",富邦-陽明,0,2,2,-1,1.94
"20240426","1783","0039003800310070","9800",元大-松山,2,0,2,1,1.94
"20240426","1783","9300","9300",華南永昌,0,1,1,-1,0.97
"20240426","1783","9898","9800",元大-新莊,2,0,2,1,1.94
"20240426","1783","0035003800350055","5850",統一-南京,0,1,1,-1,0.97
"20240429","1783","8440","8440",摩根大通,14,0,14,1,11.97
"20240429","1783","1260","1260",宏遠證券,0,20,20,-1,17.09
"20240429","1783","0039003100380067","9100",群益金鼎-大甲,6,0,6,1,5.13
"20240429","1783","9655","9600",富邦-板橋,0,8,8,-1,6.84
"20240429","1783","1440","1440",美林,5,0,5,1,4.27
"20240429","1783","0039003800390058","9800",元大-民生三民,0,7,7,-1,5.98
"20240429","1783","0037003000300071","7000",兆豐-內湖,5,0,5,1,4.27
"20240429","1783","8158","8150",台新-松江,0,7,7,-1,5.98
"20240429","1783","8561","8560",新光-台中,6,1,5,1,4.27
"20240429","1783","9208","9200",凱基-桃園,0,6,6,-1,5.13
"20240429","1783","1480","1480",美商高盛,4,0,4,1,3.42
"20240429","1783","9136","9100",群益金鼎-西松,0,4,4,-1,3.42
"20240429","1783","1043","1040",臺銀-民權,3,0,3,1,2.56
"20240429","1783","1470","1470",台灣摩根士丹利,0,3,3,-1,2.56
"20240429","1783","1650","1650",新加坡商瑞銀,3,0,3,1,2.56
"20240429","1783","9692","9600",富邦-嘉義,0,2,2,-1,1.71
"20240429","1783","8560","8560",新光,4,1,3,1,2.56
"20240429","1783","1030","1030",土銀,0,2,2,-1,1.71
"20240429","1783","0039004100360031","9A00",永豐金-鳳山,3,0,3,1,2.56
"20240429","1783","0039003100380045","9100",群益金鼎-南京,0,2,2,-1,1.71
"20240429","1783","1560","1560",港商野村,2,0,2,1,1.71
"20240429","1783","0039003200300048","9200",凱基-基隆,0,2,2,-1,1.71
"20240429","1783","9289","9200",凱基-興隆,2,0,2,1,1.71
"20240429","1783","0039004100380039","9A00",永豐金-敦北,1,3,2,-1,1.71
"20240429","1783","9879","9800",元大-板橋三民,2,0,2,1,1.71
"20240429","1783","0039004100390047","9A00",永豐金-天母,0,2,2,-1,1.71
"20240429","1783","9303","9300",華南永昌-高雄,2,0,2,1,1.71
"20240429","1783","5266","5260",美好-中壢,0,1,1,-1,0.85
"20240430","1783","1650","1650",新加坡商瑞銀,11,0,11,1,17.46
"20240430","1783","9208","9200",凱基-桃園,0,6,6,-1,9.52
"20240430","1783","1440","1440",美林,6,0,6,1,9.52
"20240430","1783","5321","5320",高橋-龍潭,0,4,4,-1,6.35
"20240430","1783","8440","8440",摩根大通,7,3,4,1,6.35
"20240430","1783","1480","1480",美商高盛,0,4,4,-1,6.35
"20240430","1783","003900380031004b","9800",元大-林園,4,0,4,1,6.35
"20240430","1783","0031003100310047","1110",台灣企銀-埔墘,0,2,2,-1,3.17
"20240430","1783","1590","1590",花旗環球,2,0,2,1,3.17
"20240430","1783","9136","9100",群益金鼎-西松,0,2,2,-1,3.17
"20240430","1783","0038003400350046","8450",康和-仁愛,2,0,2,1,3.17
"20240430","1783","0039003600310046","9600",富邦-公益,1,3,2,-1,3.17
"20240430","1783","2181","2180",亞東-板橋,1,0,1,1,1.59
"20240430","1783","9634","9600",富邦-羅東,0,2,2,-1,3.17
"20240430","1783","0035003800350059","5850",統一-土城,1,0,1,1,1.59
"20240430","1783","1028","1020",合庫-彰化,0,1,1,-1,1.59
"20240430","1783","8882","8880",國泰-台中,1,0,1,1,1.59
"20240430","1783","5383","5380",第一金-高雄,0,1,1,-1,1.59
"20240430","1783","0039003100380067","9100",群益金鼎-大甲,1,0,1,1,1.59
"20240430","1783","0038003100350041","8150",台新-高雄,0,1,1,-1,1.59
"20240430","1783","9268","9200",凱基-台北,2,1,1,1,1.59
"20240430","1783","8841","8840",玉山-雙和,0,1,1,-1,1.59
"20240430","1783","9289","9200",凱基-興隆,1,0,1,1,1.59
"20240430","1783","0039003100380047","9100",群益金鼎-新莊,0,1,1,-1,1.59
"20240430","1783","9800","9800",元大證券,1,0,1,1,1.59
"20240430","1783","003900310038004a","9100",群益金鼎-永和,0,1,1,-1,1.59
"20240430","1783","003900380039006a","9800",元大-樹林,2,1,1,1,1.59
"20240430","1783","9814","9800",元大-大益,0,1,1,-1,1.59
"20240502","1783","8440","8440",摩根大通,10,0,10,1,8.85
"20240502","1783","8561","8560",新光-台中,0,12,12,-1,10.62
"20240502","1783","0039003600310059","9600",富邦-屏東,10,0,10,1,8.85
"20240502","1783","9137","9100",群益金鼎-士林,0,9,9,-1,7.96
"20240502","1783","1650","1650",新加坡商瑞銀,10,3,7,1,6.19
"20240502","1783","1480","1480",美商高盛,0,5,5,-1,4.42
"20240502","1783","0039003800300043","9800",元大-斗六,7,0,7,1,6.19
"20240502","1783","0039003800330056","9800",元大-竹南,0,5,5,-1,4.42
"20240502","1783","1440","1440",美林,7,1,6,1,5.31
"20240502","1783","0039003800390049","9800",元大-蘆洲中正,0,5,5,-1,4.42
"20240502","1783","9898","9800",元大-新莊,6,0,6,1,5.31
"20240502","1783","9856","9800",元大-花蓮,0,4,4,-1,3.54
"20240502","1783","8840","8840",玉山證券,4,0,4,1,3.54
"20240502","1783","1560","1560",港商野村,0,3,3,-1,2.65
"20240502","1783","9268","9200",凱基-台北,7,3,4,1,3.54
"20240502","1783","0039003100380043","9100",群益金鼎-古亭,0,3,3,-1,2.65
"20240502","1783","9661","9600",富邦-新店,4,0,4,1,3.54
"20240502","1783","9208","9200",凱基-桃園,1,4,3,-1,2.65
"20240502","1783","9872","9800",元大-復北,4,0,4,1,3.54
"20240502","1783","9229","9200",凱基-中山,0,3,3,-1,2.65
"20240502","1783","9801","9800",元大-城東,3,0,3,1,2.65
"20240502","1783","9834","9800",元大-中壢,0,3,3,-1,2.65
"20240502","1783","6162","6160",中國信託-忠孝,2,0,2,1,1.77
"20240502","1783","8560","8560",新光,0,2,2,-1,1.77
"20240502","1783","9302","9300",華南永昌-台中,2,0,2,1,1.77
"20240502","1783","0039003800320042","9800",元大-博愛,0,2,2,-1,1.77
"20240502","1783","003900380033004b","9800",元大-學甲,2,0,2,1,1.77
"20240502","1783","9692","9600",富邦-嘉義,0,2,2,-1,1.77
"20240503","1783","003900380039004a","9800",元大-彰化民生,15,0,15,1,13.04
"20240503","1783","9326","9300",華南永昌-南京,0,12,12,-1,10.43
"20240503","1783","9238","9200",凱基-士林,10,0,10,1,8.70
"20240503","1783","0039003800390066","9800",元大-東港,0,11,11,-1,9.57
"20240503","1783","9875","9800",元大-土城永寧,5,0,5,1,4.35
"20240503","1783","1480","1480",美商高盛,1,9,8,-1,6.96
"20240503","1783","0039004100390055","9A00",永豐金-中正,5,1,4,1,3.48
"20240503","1783","1650","1650",新加坡商瑞銀,1,8,7,-1,6.09
"20240503","1783","0039003600310046","9600",富邦-公益,4,1,3,1,2.61
"20240503","1783","0037003000300071","7000",兆豐-內湖,0,5,5,-1,4.35
"20240503","1783","003900380033005a","9800",元大-鳳山,3,0,3,1,2.61
"20240503","1783","1560","1560",港商野村,0,4,4,-1,3.48
"20240503","1783","0039004100300030","9A00",永豐金證券,3,0,3,1,2.61
"20240503","1783","1440","1440",美林,2,4,2,-1,1.74
"20240503","1783","0038003100350042","8150",台新-台中,2,0,2,1,1.74
"20240503","1783","0035003800350062","5850",統一-內湖,0,2,2,-1,1.74
"20240503","1783","8888","8880",國泰-敦南,2,0,2,1,1.74
"20240503","1783","003500390032006f","5920",元富-新興,1,3,2,-1,1.74
"20240503","1783","5266","5260",美好-中壢,2,0,2,1,1.74
"20240503","1783","8440","8440",摩根大通,1,3,2,-1,1.74
"20240503","1783","0035003300380046","5380",第一金-大稻埕,2,0,2,1,1.74
"20240503","1783","9217","9200",凱基-松山,0,2,2,-1,1.74
"20240503","1783","5961","5960",日茂-埔里,2,0,2,1,1.74
"20240503","1783","9661","9600",富邦-新店,0,2,2,-1,1.74
"20240503","1783","6163","6160",中國信託-永康,2,0,2,1,1.74
"20240503","1783","9676","9600",富邦-仁愛,0,2,2,-1,1.74
"20240503","1783","8884","8880",國泰-台南,2,0,2,1,1.74
"20240503","1783","0035003900320043","5920",元富-潮州,0,1,1,-1,0.87
"20240506","1783","0039003200300048","9200",凱基-基隆,7,1,6,1,5.71
"20240506","1783","5850","5850",統一,0,10,10,-1,9.52
"20240506","1783","0038003400350046","8450",康和-仁愛,5,0,5,1,4.76
"20240506","1783","0039004100390061","9A00",永豐金-苓雅,0,10,10,-1,9.52
"20240506","1783","8560","8560",新光,6,1,5,1,4.76
"20240506","1783","8440","8440",摩根大通,3,11,8,-1,7.62
"20240506","1783","1440","1440",美林,4,0,4,1,3.81
"20240506","1783","0039004100390057","9A00",永豐金-市政,0,7,7,-1,6.67
"20240506","1783","1590","1590",花旗環球,4,0,4,1,3.81
"20240506","1783","0037003700390065","7790",國票-南科,0,5,5,-1,4.76
"20240506","1783","1650","1650",新加坡商瑞銀,5,2,3,1,2.86
"20240506","1783","9105","9100",群益金鼎-高盛,0,3,3,-1,2.86
"20240506","1783","9655","9600",富邦-板橋,3,0,3,1,2.86
"20240506","1783","0039003800330066","9800",元大-竹東,1,4,3,-1,2.86
"20240506","1783","0039003800300068","9800",元大-台北,3,0,3,1,2.86
"20240506","1783","9868","9800",元大-文心,0,3,3,-1,2.86
"20240506","1783","9816","9800",元大-新竹,3,0,3,1,2.86
"20240506","1783","6382","6380",光和-田中,0,2,2,-1,1.90
"20240506","1783","0039003800320042","9800",元大-博愛,3,0,3,1,2.86
"20240506","1783","9208","9200",凱基-桃園,0,2,2,-1,1.90
"20240506","1783","1480","1480",美商高盛,2,0,2,1,1.90
"20240506","1783","0039003600310046","9600",富邦-公益,0,2,2,-1,1.90
"20240506","1783","003700300030004c","7000",兆豐-天母,2,0,2,1,1.90
"20240506","1783","9663","9600",富邦-敦南,0,2,2,-1,1.90
"20240506","1783","9205","9200",凱基-三重,2,0,2,1,1.90
"20240506","1783","9303","9300",華南永昌-高雄,4,6,2,-1,1.90
"20240506","1783","9800","9800",元大證券,2,0,2,1,1.90
"20240506","1783","9614","9600",富邦-基隆,0,1,1,-1,0.95
"20240507","1783","1650","1650",新加坡商瑞銀,8,0,8,1,8.33
"20240507","1783","003900380030004b","9800",元大-竹科,0,10,10,-1,10.42
"20240507","1783","1440","1440",美林,7,0,7,1,7.29
"20240507","1783","6464","6460",大昌-新店,0,8,8,-1,8.33
"20240507","1783","9875","9800",元大-土城永寧,7,1,6,1,6.25
"20240507","1783","8440","8440",摩根大通,0,8,8,-1,8.33
"20240507","1783","1480","1480",美商高盛,6,1,5,1,5.21
"20240507","1783","8847","8840",玉山-台南,0,6,6,-1,6.25
"20240507","1783","0037003000300063","7000",兆豐-民生,5,0,5,1,5.21
"20240507","1783","9661","9600",富邦-新店,0,6,6,-1,6.25
"20240507","1783","6110","6110",台中銀,3,0,3,1,3.13
"20240507","1783","8455","8450",康和-台中,0,5,5,-1,5.21
"20240507","1783","003500390032004c","5920",元富-中壢,3,0,3,1,3.13
"20240507","1783","9289","9200",凱基-興隆,0,3,3,-1,3.13
"20240507","1783","0039003100380067","9100",群益金鼎-大甲,3,0,3,1,3.13
"20240507","1783","003900360031004e","9600",富邦-西壢,0,3,3,-1,3.13
"20240507","1783","1560","1560",港商野村,2,0,2,1,2.08
"20240507","1783","0035003900320057","5920",元富-吉利,0,2,2,-1,2.08
"20240507","1783","003500390032006f","5920",元富-新興,6,4,2,1,2.08
"20240507","1783","0031003000340044","1040",臺銀-金山,0,2,2,-1,2.08
"20240507","1783","5961","5960",日茂-埔里,2,0,2,1,2.08
"20240507","1783","003700300030004c","7000",兆豐-天母,0,2,2,-1,2.08
"20240507","1783","9634","9600",富邦-羅東,2,0,2,1,2.08
"20240507","1783","0039003100380043","9100",群益金鼎-古亭,0,2,2,-1,2.08
"20240507","1783","9854","9800",元大-文心興安,2,0,2,1,2.08
"20240507","1783","9869","9800",元大-新盛,0,2,2,-1,2.08
"20240507","1783","9898","9800",元大-新莊,2,0,2,1,2.08
"20240507","1783","8560","8560",新光,0,2,2,-1,2.08
"20240508","1783","1440","1440",美林,5,0,5,1,6.85
"20240508","1783","9692","9600",富邦-嘉義,0,8,8,-1,10.96
"20240508","1783","9831","9800",元大-四維,5,0,5,1,6.85
"20240508","1783","1111","1110",台灣企銀-台中,0,6,6,-1,8.22
"20240508","1783","9875","9800",元大-土城永寧,5,1,4,1,5.48
"20240508","1783","0039003200300048","9200",凱基-基隆,4,10,6,-1,8.22
"20240508","1783","8560","8560",新光,3,0,3,1,4.11
"20240508","1783","0035003900320057","5920",元富-吉利,0,5,5,-1,6.85
"20240508","1783","9205","9200",凱基-三重,3,0,3,1,4.11
"20240508","1783","0035003900320062","5920",元富-板橋,0,4,4,-1,5.48
"20240508","1783","5961","5960",日茂-埔里,2,0,2,1,2.74
"20240508","1783","0039004100390057","9A00",永豐金-市政,0,4,4,-1,5.48
"20240508","1783","1650","1650",新加坡商瑞銀,2,0,2,1,2.74
"20240508","1783","9634","9600",富邦-羅東,0,3,3,-1,4.11
"20240508","1783","1480","1480",美商高盛,2,0,2,1,2.74
"20240508","1783","003500390032006f","5920",元富-新興,0,2,2,-1,2.74
"20240508","1783","8840","8840",玉山證券,2,0,2,1,2.74
"20240508","1783","0039003600310046","9600",富邦-公益,0,2,2,-1,2.74
"20240508","1783","9816","9800",元大-新竹,2,0,2,1,2.74
"20240508","1783","0039003600320045","9600",富邦-樹林,0,2,2,-1,2.74
"20240508","1783","1031","1030",土銀-台中,1,0,1,1,1.37
"20240508","1783","8888","8880",國泰-敦南,0,2,2,-1,2.74
"20240508","1783","7000","7000",兆豐證券,1,0,1,1,1.37
"20240508","1783","6210","6210",新百王,0,1,1,-1,1.37
"20240508","1783","8440","8440",摩根大通,1,0,1,1,1.37
"20240508","1783","1590","1590",花旗環球,0,1,1,-1,1.37
"20240508","1783","0039003200300044","9200",凱基-市府,1,0,1,1,1.37
"20240508","1783","5660","5660",日進,0,1,1,-1,1.37
"20240509","1783","0039004100300030","9A00",永豐金證券,8,0,8,1,12.50
"20240509","1783","6452","6450",永全-八德,0,10,10,-1,15.63
"20240509","1783","1650","1650",新加坡商瑞銀,8,2,6,1,9.38
"20240509","1783","8440","8440",摩根大通,0,9,9,-1,14.06
"20240509","1783","1440","1440",美林,5,1,4,1,6.25
"20240509","1783","9268","9200",凱基-台北,0,7,7,-1,10.94
"20240509","1783","0039003200300048","9200",凱基-基隆,4,0,4,1,6.25
"20240509","1783","5386","5380",第一金-彰化,0,3,3,-1,4.69
"20240509","1783","9623","9600",富邦-台北,4,0,4,1,6.25
"20240509","1783","0039003100330049","9100",群益金鼎-萬華,0,3,3,-1,4.69
"20240509","1783","6461","6460",大昌-樹林,3,0,3,1,4.69
"20240509","1783","9600","9600",富邦證券,0,3,3,-1,4.69
"20240509","1783","0039003800300043","9800",元大-斗六,3,0,3,1,4.69
"20240509","1783","9327","9300",華南永昌-斗六,0,2,2,-1,3.13
"20240509","1783","1480","1480",美商高盛,2,0,2,1,3.13
"20240509","1783","5961","5960",日茂-埔里,0,2,2,-1,3.13
"20240509","1783","003500390032006f","5920",元富-新興,2,0,2,1,3.13
"20240509","1783","003900380039004c","9800",元大-成功,0,2,2,-1,3.13
"20240509","1783","0039003200300045","9200",凱基-東門,2,0,2,1,3.13
"20240509","1783","1031","1030",土銀-台中,0,1,1,-1,1.56
"20240509","1783","9898","9800",元大-新莊,2,0,2,1,3.13
"20240509","1783","8562","8560",新光-高雄,0,1,1,-1,1.56
"20240509","1783","0035003900320057","5920",元富-吉利,1,0,1,1,1.56
"20240509","1783","9834","9800",元大-中壢,0,1,1,-1,1.56
"20240509","1783","0038003800340042","8840",玉山-台中,1,0,1,1,1.56
"20240509","1783","0039003800380042","9800",元大-桃園,0,1,1,-1,1.56
"20240509","1783","8887","8880",國泰-忠孝,1,0,1,1,1.56
"20240509","1783","0039003800390043","9800",元大-板橋,0,1,1,-1,1.56
"20240510","1783","0039003200310047","9200",凱基-五股,20,0,20,1,8.85
"20240510","1783","0039003100380043","9100",群益金鼎-古亭,0,10,10,-1,4.42
"20240510","1783","1480","1480",美商高盛,10,0,10,1,4.42
"20240510","1783","0039003800300043","9800",元大-斗六,0,10,10,-1,4.42
"20240510","1783","0035003800350051","5850",統一-三多,10,0,10,1,4.42
"20240510","1783","0039003100380067","9100",群益金鼎-大甲,0,9,9,-1,3.98
"20240510","1783","8158","8150",台新-松江,8,0,8,1,3.54
"20240510","1783","6380","6380",光和,0,9,9,-1,3.98
"20240510","1783","8883","8880",國泰-松江,8,0,8,1,3.54
"20240510","1783","1650","1650",新加坡商瑞銀,7,15,8,-1,3.54
"20240510","1783","1440","1440",美林,7,0,7,1,3.10
"20240510","1783","0039003200300048","9200",凱基-基隆,3,11,8,-1,3.54
"20240510","1783","6461","6460",大昌-樹林,7,0,7,1,3.10
"20240510","1783","1021","1020",合庫-台中,0,7,7,-1,3.10
"20240510","1783","8150","8150",台新證券,4,0,4,1,1.77
"20240510","1783","0037003000300063","7000",兆豐-民生,0,5,5,-1,2.21
"20240510","1783","9136","9100",群益金鼎-西松,4,0,4,1,1.77
"20240510","1783","0037003700390065","7790",國票-南科,0,5,5,-1,2.21
"20240510","1783","003900380039006a","9800",元大-樹林,4,0,4,1,1.77
"20240510","1783","003900360031004b","9600",富邦-七賢,0,5,5,-1,2.21
"20240510","1783","9854","9800",元大-文心興安,3,0,3,1,1.33
"20240510","1783","9816","9800",元大-新竹,0,5,5,-1,2.21
"20240510","1783","003900380039006d","9800",元大-信義,3,0,3,1,1.33
"20240510","1783","9875","9800",元大-土城永寧,0,5,5,-1,2.21
"20240510","1783","8563","8560",新光-新竹,2,0,2,1,0.88
"20240510","1783","5603","5600",永興-台中,0,4,4,-1,1.77
"20240510","1783","003800380038004b","8880",國泰-板橋,2,0,2,1,0.88
"20240510","1783","8440","8440",摩根大通,5,8,3,-1,1.33
"20240513","1783","003900360031004e","9600",富邦-西壢,7,0,7,1,8.33
"20240513","1783","8888","8880",國泰-敦南,0,7,7,-1,8.33
"20240513","1783","1440","1440",美林,9,3,6,1,7.14
"20240513","1783","9226","9200",凱基-汐止,0,5,5,-1,5.95
"20240513","1783","9875","9800",元大-土城永寧,7,3,4,1,4.76
"20240513","1783","0039003200300048","9200",凱基-基隆,2,6,4,-1,4.76
"20240513","1783","1650","1650",新加坡商瑞銀,6,3,3,1,3.57
"20240513","1783","1560","1560",港商野村,0,2,2,-1,2.38
"20240513","1783","1480","1480",美商高盛,3,0,3,1,3.57
"20240513","1783","6452","6450",永全-八德,0,2,2,-1,2.38
"20240513","1783","9654","9600",富邦-永和,2,0,2,1,2.38
"20240513","1783","8440","8440",摩根大通,0,2,2,-1,2.38
"20240513","1783","8560","8560",新光,2,1,1,1,1.19
"20240513","1783","0039003100380044","9100",群益金鼎-東門,0,2,2,-1,2.38
"20240513","1783","5320","5320",高橋,1,0,1,1,1.19
"20240513","1783","9329","9300",華南永昌-朴子,0,2,2,-1,2.38
"20240513","1783","0035003800350048","5850",統一-桃園,1,0,1,1,1.19
"20240513","1783","9859","9800",元大-新竹經國,0,2,2,-1,2.38
"20240513","1783","003500390032006e","5920",元富-西松,1,0,1,1,1.19
"20240513","1783","0039004100380039","9A00",永豐金-敦北,0,2,2,-1,2.38
"20240513","1783","0035003900320051","5920",元富-敦南,1,0,1,1,1.19
"20240513","1783","1024","1020",合庫-嘉義,0,1,1,-1,1.19
"20240513","1783","0038003800340045","8840",玉山-城中,1,0,1,1,1.19
"20240513","1783","1022","1020",合庫-台南,0,1,1,-1,1.19
"20240513","1783","9136","9100",群益金鼎-西松,1,0,1,1,1.19
"20240513","1783","1042","1040",臺銀-臺南,0,1,1,-1,1.19
"20240513","1783","9268","9200",凱基-台北,2,1,1,1,1.19
"20240513","1783","003500390032006f","5920",元富-新興,0,1,1,-1,1.19
"20240514","1783","1440","1440",美林,4,0,4,1,5.26
"20240514","1783","9308","9300",華南永昌-麻豆,0,10,10,-1,13.16
"20240514","1783","003500390032006f","5920",元富-新興,4,0,4,1,5.26
"20240514","1783","1480","1480",美商高盛,1,8,7,-1,9.21
"20240514","1783","0037003700390058","7790",國票-中和,4,0,4,1,5.26
"20240514","1783","0039004100390048","9A00",永豐金-新莊,0,4,4,-1,5.26
"20240514","1783","9108","9100",群益金鼎-海山,4,0,4,1,5.26
"20240514","1783","5386","5380",第一金-彰化,0,3,3,-1,3.95
"20240514","1783","0039003200300048","9200",凱基-基隆,4,0,4,1,5.26
"20240514","1783","7008","7000",兆豐-三重,0,3,3,-1,3.95
"20240514","1783","9654","9600",富邦-永和,4,0,4,1,5.26
"20240514","1783","9614","9600",富邦-基隆,0,2,2,-1,2.63
"20240514","1783","0035003300380046","5380",第一金-大稻埕,3,0,3,1,3.95
"20240514","1783","1042","1040",臺銀-臺南,0,2,2,-1,2.63
"20240514","1783","8563","8560",新光-新竹,3,0,3,1,3.95
"20240514","1783","9185","9100",群益金鼎-台南,0,2,2,-1,2.63
"20240514","1783","8880","8880",國泰證券,3,0,3,1,3.95
"20240514","1783","0039003600310043","9600",富邦-南京,0,2,2,-1,2.63
"20240514","1783","0039003600310046","9600",富邦-公益,6,3,3,1,3.95
"20240514","1783","0039003600320042","9600",富邦-二林,0,2,2,-1,2.63
"20240514","1783","1650","1650",新加坡商瑞銀,2,0,2,1,2.63
"20240514","1783","9862","9800",元大-南京,0,2,2,-1,2.63
"20240514","1783","1021","1020",合庫-台中,2,0,2,1,2.63
"20240514","1783","9872","9800",元大-復北,0,2,2,-1,2.63
"20240514","1783","6110","6110",台中銀,2,0,2,1,2.63
"20240514","1783","0039003800390045","9800",元大-草屯,0,1,1,-1,1.32
"20240514","1783","0037003000300052","7000",兆豐-小港,2,0,2,1,2.63
"20240514","1783","9268","9200",凱基-台北,0,1,1,-1,1.32
"20240515","1783","1590","1590",花旗環球,10,0,10,1,10.75
"20240515","1783","9268","9200",凱基-台北,1,12,11,-1,11.83
"20240515","1783","0039003200300048","9200",凱基-基隆,12,5,7,1,7.53
"20240515","1783","6950","6950",福勝,0,5,5,-1,5.38
"20240515","1783","9800","9800",元大證券,3,0,3,1,3.23
"20240515","1783","9285","9200",凱基-中壢,0,5,5,-1,5.38
"20240515","1783","1440","1440",美林,6,3,3,1,3.23
"20240515","1783","9333","9300",華南永昌-長虹,0,5,5,-1,5.38
"20240515","1783","1650","1650",新加坡商瑞銀,2,0,2,1,2.15
"20240515","1783","003900380031004b","9800",元大-林園,0,4,4,-1,4.30
"20240515","1783","8840","8840",玉山證券,2,0,2,1,2.15
"20240515","1783","1560","1560",港商野村,0,3,3,-1,3.23
"20240515","1783","9200","9200",凱基,2,0,2,1,2.15
"20240515","1783","0039003800330056","9800",元大-竹南,0,3,3,-1,3.23
"20240515","1783","9217","9200",凱基-松山,2,0,2,1,2.15
"20240515","1783","003900380039006a","9800",元大-樹林,0,3,3,-1,3.23
"20240515","1783","003900380031006a","9800",元大-士林,2,0,2,1,2.15
"20240515","1783","9208","9200",凱基-桃園,0,2,2,-1,2.15
"20240515","1783","8560","8560",新光,1,0,1,1,1.08
"20240515","1783","9625","9600",富邦-竹東,0,2,2,-1,2.15
"20240515","1783","8561","8560",新光-台中,1,0,1,1,1.08
"20240515","1783","0039003800390067","9800",元大-嘉義,0,2,2,-1,2.15
"20240515","1783","003800380038004b","8880",國泰-板橋,1,0,1,1,1.08
"20240515","1783","8888","8880",國泰-敦南,1,2,1,-1,1.08
"20240515","1783","1480","1480",美商高盛,1,0,1,1,1.08
"20240515","1783","6160","6160",中國信託,0,1,1,-1,1.08
"20240515","1783","0035003900320041","5920",元富-緯城,1,0,1,1,1.08
"20240515","1783","1032","1030",土銀-台南,0,1,1,-1,1.08
"20240516","1783","9238","9200",凱基-士林,7,0,7,1,9.21
"20240516","1783","0037003000300044","7000",兆豐-西螺,0,5,5,-1,6.58
"20240516","1783","8561","8560",新光-台中,5,0,5,1,6.58
"20240516","1783","9636","9600",富邦-中壢,0,5,5,-1,6.58
"20240516","1783","9331","9300",華南永昌-鳳山,4,0,4,1,5.26
"20240516","1783","003700300030004b","7000",兆豐-新營,0,4,4,-1,5.26
"20240516","1783","8888","8880",國泰-敦南,3,0,3,1,3.95
"20240516","1783","0036003300380044","6380",光和-高雄,0,3,3,-1,3.95
"20240516","1783","1590","1590",花旗環球,3,0,3,1,3.95
"20240516","1783","8459","8450",康和-嘉義,0,2,2,-1,2.63
"20240516","1783","1440","1440",美林,3,0,3,1,3.95
"20240516","1783","1560","1560",港商野村,0,2,2,-1,2.63
"20240516","1783","0031003100310047","1110",台灣企銀-埔墘,2,0,2,1,2.63
"20240516","1783","1480","1480",美商高盛,0,2,2,-1,2.63
"20240516","1783","6110","6110",台中銀,2,0,2,1,2.63
"20240516","1783","5320","5320",高橋,0,2,2,-1,2.63
"20240516","1783","8440","8440",摩根大通,2,0,2,1,2.63
"20240516","1783","9268","9200",凱基-台北,2,4,2,-1,2.63
"20240516","1783","003900360031004e","9600",富邦-西壢,2,0,2,1,2.63
"20240516","1783","9608","9600",富邦-台東,0,2,2,-1,2.63
"20240516","1783","003900380033004b","9800",元大-學甲,2,0,2,1,2.63
"20240516","1783","9672","9600",富邦-員林,0,2,2,-1,2.63
"20240516","1783","9871","9800",元大-忠孝,2,0,2,1,2.63
"20240516","1783","5383","5380",第一金-高雄,0,1,1,-1,1.32
"20240516","1783","1032","1030",土銀-台南,1,0,1,1,1.32
"20240516","1783","0037003000300061","7000",兆豐-忠孝,0,1,1,-1,1.32
"20240516","1783","1020","1020",合庫證券,1,0,1,1,1.32
"20240516","1783","8381","8380",安泰-大發,0,1,1,-1,1.32
"20240517","1783","0035003900320062","5920",元富-板橋,20,0,20,1,10.81
"20240517","1783","9856","9800",元大-花蓮,0,12,12,-1,6.49
"20240517","1783","9268","9200",凱基-台北,18,1,17,1,9.19
"20240517","1783","9875","9800",元大-土城永寧,0,11,11,-1,5.95
"20240517","1783","8440","8440",摩根大通,16,1,15,1,8.11
"20240517","1783","0039003200300048","9200",凱基-基隆,9,19,10,-1,5.41
"20240517","1783","1650","1650",新加坡商瑞銀,12,0,12,1,6.49
"20240517","1783","003900310038004d","9100",群益金鼎-嘉義,0,7,7,-1,3.78
"20240517","1783","0035003800350051","5850",統一-三多,10,0,10,1,5.41
"20240517","1783","003900410039004b","9A00",永豐金-三重,0,5,5,-1,2.70
"20240517","1783","9884","9800",元大-斗信,10,0,10,1,5.41
"20240517","1783","8150","8150",台新證券,0,5,5,-1,2.70
"20240517","1783","1440","1440",美林,5,0,5,1,2.70
"20240517","1783","9331","9300",華南永昌-鳳山,0,4,4,-1,2.16
"20240517","1783","1560","1560",港商野村,4,0,4,1,2.16
"20240517","1783","9657","9600",富邦-苗栗,0,4,4,-1,2.16
"20240517","1783","0035003800350045","5850",統一-新營,4,0,4,1,2.16
"20240517","1783","6380","6380",光和,0,3,3,-1,1.62
"20240517","1783","1590","1590",花旗環球,3,0,3,1,1.62
"20240517","1783","0031003000320043","1020",合庫-自強,0,3,3,-1,1.62
"20240517","1783","0035003300380049","5380",第一金-頭份,3,0,3,1,1.62
"20240517","1783","1030","1030",土銀,0,3,3,-1,1.62
"20240517","1783","9661","9600",富邦-新店,3,0,3,1,1.62
"20240517","1783","5262","5260",美好-楊梅,0,3,3,-1,1.62
"20240517","1783","7750","7750",北城證券,3,0,3,1,1.62
"20240517","1783","5389","5380",第一金-中山,0,3,3,-1,1.62
"20240517","1783","9332","9300",華南永昌-楠梓,3,0,3,1,1.62
"20240517","1783","0039003600310046","9600",富邦-公益,1,4,3,-1,1.62
"20240520","1783","8440","8440",摩根大通,13,1,12,1,8.96
"20240520","1783","9658","9600",富邦-建國,0,20,20,-1,14.93
"20240520","1783","0035003900320062","5920",元富-板橋,10,0,10,1,7.46
"20240520","1783","1020","1020",合庫證券,0,9,9,-1,6.72
"20240520","1783","1480","1480",美商高盛,10,1,9,1,6.72
"20240520","1783","7792","7790",國票-北投,0,4,4,-1,2.99
"20240520","1783","0035003900320044","5920",元富-大昌,5,0,5,1,3.73
"20240520","1783","0038003800340042","8840",玉山-台中,0,4,4,-1,2.99
"20240520","1783","1650","1650",新加坡商瑞銀,12,8,4,1,2.99
"20240520","1783","9655","9600",富邦-板橋,0,4,4,-1,2.99
"20240520","1783","003900380039006a","9800",元大-樹林,4,0,4,1,2.99
"20240520","1783","0035003900320077","5920",元富-佳里,0,2,2,-1,1.49
"20240520","1783","1590","1590",花旗環球,3,0,3,1,2.24
"20240520","1783","5961","5960",日茂-埔里,0,2,2,-1,1.49
"20240520","1783","1440","1440",美林,7,4,3,1,2.24
"20240520","1783","9205","9200",凱基-三重,0,2,2,-1,1.49
"20240520","1783","5856","5850",統一-台中,3,0,3,1,2.24
"20240520","1783","0039004100390073","9A00",永豐金-彰化,0,2,2,-1,1.49
"20240520","1783","9800","9800",元大證券,3,1,2,1,1.49
"20240520","1783","9647","9600",富邦-新竹,0,1,1,-1,0.75
"20240520","1783","5853","5850",統一-中壢,2,0,2,1,1.49
"20240520","1783","9661","9600",富邦-新店,0,1,1,-1,0.75
"20240520","1783","0035003300380049","5380",第一金-頭份,2,0,2,1,1.49
"20240520","1783","6110","6110",台中銀,0,1,1,-1,0.75
"20240520","1783","0037003700390044","7790",國票-台南,2,0,2,1,1.49
"20240520","1783","7006","7000",兆豐-台南,0,1,1,-1,0.75
"20240520","1783","003900360032004a","9600",富邦-三峽,2,0,2,1,1.49
"20240520","1783","8560","8560",新光,0,1,1,-1,0.75
"20240521","1783","9884","9800",元大-斗信,10,0,10,1,12.50
"20240521","1783","9268","9200",凱基-台北,0,14,14,-1,17.50
"20240521","1783","1560","1560",港商野村,9,0,9,1,11.25
"20240521","1783","9608","9600",富邦-台東,0,9,9,-1,11.25
"20240521","1783","003500390032006f","5920",元富-新興,4,0,4,1,5.00
"20240521","1783","1480","1480",美商高盛,0,6,6,-1,7.50
"20240521","1783","0039003100380047","9100",群益金鼎-新莊,4,0,4,1,5.00
"20240521","1783","8561","8560",新光-台中,0,5,5,-1,6.25
"20240521","1783","0039003600310052","9600",富邦-南員林,3,0,3,1,3.75
"20240521","1783","1650","1650",新加坡商瑞銀,1,5,4,-1,5.00
"20240521","1783","9654","9600",富邦-永和,3,0,3,1,3.75
"20240521","1783","9101","9100",群益金鼎-敦南,0,3,3,-1,3.75
"20240521","1783","9655","9600",富邦-板橋,3,0,3,1,3.75
"20240521","1783","8440","8440",摩根大通,0,2,2,-1,2.50
"20240521","1783","9816","9800",元大-新竹,3,0,3,1,3.75
"20240521","1783","1440","1440",美林,0,1,1,-1,1.25
"20240521","1783","9854","9800",元大-文心興安,2,0,2,1,2.50
"20240521","1783","0038003100350059","8150",台新-新營,0,1,1,-1,1.25
"20240521","1783","5856","5850",統一-台中,3,1,2,1,2.50
"20240521","1783","0039003200310053","9200",凱基-新莊,0,1,1,-1,1.25
"20240521","1783","6160","6160",中國信託,2,0,2,1,2.50
"20240521","1783","0039003600310048","9600",富邦-新板,0,1,1,-1,1.25
"20240521","1783","0039003200300048","9200",凱基-基隆,2,0,2,1,2.50
"20240521","1783","0039003800300061","9800",元大-承德,0,1,1,-1,1.25
"20240521","1783","0039003600310046","9600",富邦-公益,3,1,2,1,2.50
"20240521","1783","0039003800310069","9800",元大-西螺,0,1,1,-1,1.25
"20240521","1783","8888","8880",國泰-敦南,1,0,1,1,1.25
"20240521","1783","0039003800390049","9800",元大-蘆洲中正,0,1,1,-1,1.25
"20240522","1783","0039003800300043","9800",元大-斗六,10,0,10,1,11.90
"20240522","1783","5923","5920",元富-三重,0,6,6,-1,7.14
"20240522","1783","1480","1480",美商高盛,9,0,9,1,10.71
"20240522","1783","0036003300380044","6380",光和-高雄,0,5,5,-1,5.95
"20240522","1783","0039003800300065","9800",元大-清水,10,1,9,1,10.71
"20240522","1783","003900360031004d","9600",富邦-木柵,0,5,5,-1,5.95
"20240522","1783","0035003900320062","5920",元富-板橋,5,0,5,1,5.95
"20240522","1783","9672","9600",富邦-員林,0,4,4,-1,4.76
"20240522","1783","6160","6160",中國信託,2,0,2,1,2.38
"20240522","1783","1440","1440",美林,1,4,3,-1,3.57
"20240522","1783","003500390032006f","5920",元富-新興,2,0,2,1,2.38
"20240522","1783","0039004100390037","9A00",永豐金-新竹,0,3,3,-1,3.57
"20240522","1783","1650","1650",新加坡商瑞銀,5,3,2,1,2.38
"20240522","1783","0039003800330056","9800",元大-竹南,0,2,2,-1,2.38
"20240522","1783","0039003200300048","9200",凱基-基隆,4,2,2,1,2.38
"20240522","1783","9889","9800",元大-員林,0,2,2,-1,2.38
"20240522","1783","0035003800350055","5850",統一-南京,1,0,1,1,1.19
"20240522","1783","003900380039006a","9800",元大-樹林,0,2,2,-1,2.38
"20240522","1783","7007","7000",兆豐-竹北,1,0,1,1,1.19
"20240522","1783","0039003800310069","9800",元大-西螺,0,1,1,-1,1.19
"20240522","1783","0035003900320044","5920",元富-大昌,1,0,1,1,1.19
"20240522","1783","0035003800350067","5850",統一-平鎮,0,1,1,-1,1.19
"20240522","1783","7792","7790",國票-北投,1,0,1,1,1.19
"20240522","1783","0039003100380069","9100",群益金鼎-竹南,0,1,1,-1,1.19
"20240522","1783","8440","8440",摩根大通,2,1,1,1,1.19
"20240522","1783","9268","9200",凱基-台北,0,1,1,-1,1.19
"20240522","1783","0038003800340042","8840",玉山-台中,1,0,1,1,1.19
"20240522","1783","9300","9300",華南永昌,0,1,1,-1,1.19
"20240523","1783","9614","9600",富邦-基隆,10,0,10,1,5.21
"20240523","1783","8843","8840",玉山-高雄,0,20,20,-1,10.42
"20240523","1783","0039003600310043","9600",富邦-南京,10,0,10,1,5.21
"20240523","1783","8440","8440",摩根大通,2,21,19,-1,9.90
"20240523","1783","9875","9800",元大-土城永寧,9,0,9,1,4.69
"20240523","1783","1650","1650",新加坡商瑞銀,14,31,17,-1,8.85
"20240523","1783","0039003100380067","9100",群益金鼎-大甲,7,0,7,1,3.65
"20240523","1783","0037003700390065","7790",國票-南科,0,10,10,-1,5.21
"20240523","1783","9136","9100",群益金鼎-西松,6,0,6,1,3.13
"20240523","1783","1560","1560",港商野村,0,8,8,-1,4.17
"20240523","1783","9816","9800",元大-新竹,6,0,6,1,3.13
"20240523","1783","003700300030004b","7000",兆豐-新營,0,8,8,-1,4.17
"20240523","1783","0039003800300043","9800",元大-斗六,5,0,5,1,2.60
"20240523","1783","8158","8150",台新-松江,0,8,8,-1,4.17
"20240523","1783","003500390032004c","5920",元富-中壢,4,0,4,1,2.08
"20240523","1783","5856","5850",統一-台中,0,6,6,-1,3.13
"20240523","1783","5961","5960",日茂-埔里,4,0,4,1,2.08
"20240523","1783","0039004100390041","9A00",永豐金-羅東,0,6,6,-1,3.13
"20240523","1783","8560","8560",新光,4,0,4,1,2.08
"20240523","1783","6161","6160",中國信託-三重,0,4,4,-1,2.08
"20240523","1783","0039003200300048","9200",凱基-基隆,6,2,4,1,2.08
"20240523","1783","9874","9800",元大-雙和,0,4,4,-1,2.08
"20240523","1783","9657","9600",富邦-苗栗,4,0,4,1,2.08
"20240523","1783","9800","9800",元大證券,0,3,3,-1,1.56
"20240523","1783","8561","8560",新光-台中,4,0,4,1,2.08
"20240523","1783","0037003000300077","7000",兆豐-新莊,0,3,3,-1,1.56
"20240523","1783","5262","5260",美好-楊梅,3,0,3,1,1.56
"20240523","1783","0039003600310052","9600",富邦-南員林,0,3,3,-1,1.56
"20240524","1783","8560","8560",新光,10,0,10,1,6.41
"20240524","1783","0039003800390059","9800",元大-基隆,0,20,20,-1,12.82
"20240524","1783","1650","1650",新加坡商瑞銀,8,0,8,1,5.13
"20240524","1783","8440","8440",摩根大通,0,11,11,-1,7.05
"20240524","1783","9268","9200",凱基-台北,13,5,8,1,5.13
"20240524","1783","0039003800330056","9800",元大-竹南,0,8,8,-1,5.13
"20240524","1783","0039004100390042","9A00",永豐金-中和,8,0,8,1,5.13
"20240524","1783","8561","8560",新光-台中,0,6,6,-1,3.85
"20240524","1783","1022","1020",合庫-台南,6,0,6,1,3.85
"20240524","1783","9663","9600",富邦-敦南,0,3,3,-1,1.92
"20240524","1783","6160","6160",中國信託,6,0,6,1,3.85
"20240524","1783","003900360032004a","9600",富邦-三峽,0,2,2,-1,1.28
"20240524","1783","1020","1020",合庫證券,5,0,5,1,3.21
"20240524","1783","9604","9600",富邦-陽明,0,1,1,-1,0.64
"20240524","1783","9898","9800",元大-新莊,5,0,5,1,3.21
"20240524","1783","8843","8840",玉山-高雄,0,1,1,-1,0.64
"20240524","1783","1480","1480",美商高盛,4,0,4,1,2.56
"20240524","1783","1470","1470",台灣摩根士丹利,0,1,1,-1,0.64
"20240524","1783","1440","1440",美林,4,1,3,1,1.92
"20240524","1783","1040","1040",臺銀,0,1,1,-1,0.64
"20240524","1783","003900380033005a","9800",元大-鳳山,3,0,3,1,1.92
"20240524","1783","1031","1030",土銀-台中,0,1,1,-1,0.64
"20240524","1783","1560","1560",港商野村,2,0,2,1,1.28
"20240524","1783","8849","8840",玉山-景美,0,1,1,-1,0.64
"20240524","1783","6110","6110",台中銀,2,0,2,1,1.28
"20240524","1783","9101","9100",群益金鼎-敦南,0,1,1,-1,0.64
"20240524","1783","0038003100350042","8150",台新-台中,2,0,2,1,1.28
"20240524","1783","9189","9100",群益金鼎-桃園,0,1,1,-1,0.64
"20240527","1783","1560","1560",港商野村,23,0,23,1,6.42
"20240527","1783","8882","8880",國泰-台中,0,80,80,-1,22.35
"20240527","1783","9268","9200",凱基-台北,21,5,16,1,4.47
"20240527","1783","5058","5050",大展-台南,0,53,53,-1,14.80
"20240527","1783","8157","8150",台新-左楠,10,0,10,1,2.79
"20240527","1783","9872","9800",元大-復北,0,13,13,-1,3.63
"20240527","1783","1480","1480",美商高盛,10,0,10,1,2.79
"20240527","1783","9813","9800",元大-八德,1,10,9,-1,2.51
"20240527","1783","0035003900320062","5920",元富-板橋,10,0,10,1,2.79
"20240527","1783","0037003700390056","7790",國票-天祥,0,7,7,-1,1.96
"20240527","1783","0037003700390058","7790",國票-中和,5,0,5,1,1.40
"20240527","1783","5321","5320",高橋-龍潭,0,5,5,-1,1.40
"20240527","1783","8150","8150",台新證券,5,0,5,1,1.40
"20240527","1783","0037003000300061","7000",兆豐-忠孝,0,5,5,-1,1.40
"20240527","1783","003900360031004d","9600",富邦-木柵,5,0,5,1,1.40
"20240527","1783","1042","1040",臺銀-臺南,0,4,4,-1,1.12
"20240527","1783","0039003800390065","9800",元大-中和,5,0,5,1,1.40
"20240527","1783","9658","9600",富邦-建國,0,4,4,-1,1.12
"20240527","1783","0039003100380067","9100",群益金鼎-大甲,4,0,4,1,1.12
"20240527","1783","5265","5260",美好-苗栗,0,3,3,-1,0.84
"20240527","1783","9655","9600",富邦-板橋,4,0,4,1,1.12
"20240527","1783","8382","8380",安泰-楠梓,0,3,3,-1,0.84
"20240527","1783","0039003600350055","9600",富邦-彰化,4,0,4,1,1.12
"20240527","1783","003800380034004a","8840",玉山-大里,0,2,2,-1,0.56
"20240527","1783","9816","9800",元大-新竹,4,0,4,1,1.12
"20240527","1783","0039003100380063","9100",群益金鼎-鳳山,0,1,1,-1,0.28
"20240527","1783","8888","8880",國泰-敦南,4,1,3,1,0.84
"20240527","1783","9800","9800",元大證券,5,6,1,-1,0.28
"20240528","1783","1440","1440",美林,23,0,23,1,11.50
"20240528","1783","0035003900320045","5920",元富-城中,0,30,30,-1,15.00
"20240528","1783","9268","9200",凱基-台北,22,1,21,1,10.50
"20240528","1783","5323","5320",高橋-內壢,0,10,10,-1,5.00
"20240528","1783","8440","8440",摩根大通,21,3,18,1,9.00
"20240528","1783","9208","9200",凱基-桃園,1,10,9,-1,4.50
"20240528","1783","1560","1560",港商野村,13,0,13,1,6.50
"20240528","1783","003900410039004d","9A00",永豐金-南投,0,6,6,-1,3.00
"20240528","1783","8711","8710",陽信-石牌,10,0,10,1,5.00
"20240528","1783","8888","8880",國泰-敦南,2,7,5,-1,2.50
"20240528","1783","1480","1480",美商高盛,9,0,9,1,4.50
"20240528","1783","0039003200300048","9200",凱基-基隆,0,5,5,-1,2.50
"20240528","1783","003700300030004d","7000",兆豐-桃園,6,0,6,1,3.00
"20240528","1783","0039003200310045","9200",凱基-三峽,0,5,5,-1,2.50
"20240528","1783","8150","8150",台新證券,6,0,6,1,3.00
"20240528","1783","9867","9800",元大-內湖民權,0,5,5,-1,2.50
"20240528","1783","9138","9100",群益金鼎-中港,4,0,4,1,2.00
"20240528","1783","0039003600310046","9600",富邦-公益,2,6,4,-1,2.00
"20240528","1783","1590","1590",花旗環球,3,0,3,1,1.50
"20240528","1783","8560","8560",新光,0,4,4,-1,2.00
"20240528","1783","6461","6460",大昌-樹林,3,0,3,1,1.50
"20240528","1783","5922","5920",元富-新店,0,3,3,-1,1.50
"20240528","1783","9215","9200",凱基-高美館,3,0,3,1,1.50
"20240528","1783","0039003800390051","9800",元大-汐止,0,3,3,-1,1.50
"20240528","1783","0035003900320072","5920",元富-城東,2,0,2,1,1.00
"20240528","1783","9661","9600",富邦-新店,0,3,3,-1,1.50
"20240528","1783","0036003000310064","6010",(牛牛牛)亞-鑫豐,2,0,2,1,1.00
"20240528","1783","003500330038006a","5380",第一金-安和,0,2,2,-1,1.00
"20240529","1783","9238","9200",凱基-士林,8,0,8,1,8.00
"20240529","1783","0035003900320045","5920",元富-城中,0,10,10,-1,10.00
"20240529","1783","1560","1560",港商野村,5,0,5,1,5.00
"20240529","1783","0039003200300048","9200",凱基-基隆,0,5,5,-1,5.00
"20240529","1783","0035003900320062","5920",元富-板橋,5,0,5,1,5.00
"20240529","1783","9825","9800",元大-新營,0,4,4,-1,4.00
"20240529","1783","9268","9200",凱基-台北,8,3,5,1,5.00
"20240529","1783","9856","9800",元大-花蓮,0,4,4,-1,4.00
"20240529","1783","0036003000310064","6010",(牛牛牛)亞-鑫豐,4,0,4,1,4.00
"20240529","1783","8561","8560",新光-台中,0,3,3,-1,3.00
"20240529","1783","1440","1440",美林,6,2,4,1,4.00
"20240529","1783","9208","9200",凱基-桃園,0,2,2,-1,2.00
"20240529","1783","003700300030004e","7000",兆豐-埔墘,4,0,4,1,4.00
"20240529","1783","0039003600350055","9600",富邦-彰化,0,2,2,-1,2.00
"20240529","1783","0039003200300041","9200",凱基-板橋,3,0,3,1,3.00
"20240529","1783","9862","9800",元大-南京,0,2,2,-1,2.00
"20240529","1783","0039003200300043","9200",凱基-雙和,3,0,3,1,3.00
"20240529","1783","5262","5260",美好-楊梅,0,1,1,-1,1.00
"20240529","1783","0039003800390045","9800",元大-草屯,3,0,3,1,3.00
"20240529","1783","9131","9100",群益金鼎-民權,0,1,1,-1,1.00
"20240529","1783","1480","1480",美商高盛,2,0,2,1,2.00
"20240529","1783","8150","8150",台新證券,1,2,1,-1,1.00
"20240529","1783","9189","9100",群益金鼎-桃園,2,0,2,1,2.00
"20240529","1783","5928","5920",元富-新莊,0,1,1,-1,1.00
"20240529","1783","0039003100380067","9100",群益金鼎-大甲,2,0,2,1,2.00
"20240529","1783","6110","6110",台中銀,0,1,1,-1,1.00
"20240529","1783","9226","9200",凱基-汐止,2,0,2,1,2.00
"20240529","1783","0037003000300049","7000",兆豐-北高雄,0,1,1,-1,1.00
"20240530","1783","0039003800310051","9800",元大-太平,10,0,10,1,7.41
"20240530","1783","9268","9200",凱基-台北,1,14,13,-1,9.63
"20240530","1783","0039003200300048","9200",凱基-基隆,9,3,6,1,4.44
"20240530","1783","5323","5320",高橋-內壢,0,11,11,-1,8.15
"20240530","1783","0035003900320062","5920",元富-板橋,5,0,5,1,3.70
"20240530","1783","9349","9300",華南永昌-板橋,0,10,10,-1,7.41
"20240530","1783","0039003100380067","9100",群益金鼎-大甲,5,0,5,1,3.70
"20240530","1783","9200","9200",凱基,0,9,9,-1,6.67
"20240530","1783","9227","9200",凱基-城中,5,0,5,1,3.70
"20240530","1783","9136","9100",群益金鼎-西松,0,4,4,-1,2.96
"20240530","1783","1440","1440",美林,5,1,4,1,2.96
"20240530","1783","1650","1650",新加坡商瑞銀,5,8,3,-1,2.22
"20240530","1783","9188","9100",群益金鼎-三民,5,1,4,1,2.96
"20240530","1783","8564","8560",新光-台南,0,2,2,-1,1.48
"20240530","1783","003900380039006a","9800",元大-樹林,4,0,4,1,2.96
"20240530","1783","0037003700390050","7790",國票-九鼎,0,2,2,-1,1.48
"20240530","1783","8381","8380",安泰-大發,3,0,3,1,2.22
"20240530","1783","003700370039005a","7790",國票-安和,0,2,2,-1,1.48
"20240530","1783","0038003800340042","8840",玉山-台中,6,3,3,1,2.22
"20240530","1783","8440","8440",摩根大通,3,5,2,-1,1.48
"20240530","1783","1470","1470",台灣摩根士丹利,2,0,2,1,1.48
"20240530","1783","0039003800310067","9800",元大-大里,0,2,2,-1,1.48
"20240530","1783","0038003100350042","8150",台新-台中,2,0,2,1,1.48
"20240530","1783","9859","9800",元大-新竹經國,0,2,2,-1,1.48
"20240530","1783","8455","8450",康和-台中,2,0,2,1,1.48
"20240530","1783","0039003800390051","9800",元大-汐止,0,2,2,-1,1.48
"20240530","1783","9875","9800",元大-土城永寧,4,2,2,1,1.48
"20240530","1783","2187","2180",亞東-台中,0,1,1,-1,0.74
"20240531","1783","1440","1440",美林,26,5,21,1,11.93
"20240531","1783","0035003900320045","5920",元富-城中,0,30,30,-1,17.05
"20240531","1783","1650","1650",新加坡商瑞銀,17,0,17,1,9.66
"20240531","1783","6160","6160",中國信託,0,15,15,-1,8.52
"20240531","1783","1560","1560",港商野村,11,0,11,1,6.25
"20240531","1783","8150","8150",台新證券,1,15,14,-1,7.95
"20240531","1783","1480","1480",美商高盛,9,0,9,1,5.11
"20240531","1783","0039003200300048","9200",凱基-基隆,2,7,5,-1,2.84
"20240531","1783","9268","9200",凱基-台北,8,1,7,1,3.98
"20240531","1783","003500390032006f","5920",元富-新興,4,8,4,-1,2.27
"20240531","1783","8561","8560",新光-台中,6,0,6,1,3.41
"20240531","1783","5386","5380",第一金-彰化,0,4,4,-1,2.27
"20240531","1783","9287","9200",凱基-內湖,5,0,5,1,2.84
"20240531","1783","9188","9100",群益金鼎-三民,0,4,4,-1,2.27
"20240531","1783","003900360031004d","9600",富邦-木柵,5,0,5,1,2.84
"20240531","1783","0039003200300041","9200",凱基-板橋,0,3,3,-1,1.70
"20240531","1783","0038003100350042","8150",台新-台中,5,0,5,1,2.84
"20240531","1783","9879","9800",元大-板橋三民,0,3,3,-1,1.70
"20240531","1783","7006","7000",兆豐-台南,4,0,4,1,2.27
"20240531","1783","9302","9300",華南永昌-台中,0,2,2,-1,1.14
"20240531","1783","0039003100330059","9100",群益金鼎-館前,3,0,3,1,1.70
"20240531","1783","1470","1470",台灣摩根士丹利,0,2,2,-1,1.14
"20240531","1783","0036003300380041","6380",光和-嘉義,3,0,3,1,1.70
"20240531","1783","8560","8560",新光,0,2,2,-1,1.14
"20240531","1783","9655","9600",富邦-板橋,2,0,2,1,1.14
"20240531","1783","9300","9300",華南永昌,0,2,2,-1,1.14
"20240531","1783","6620","6620",口袋證券,2,0,2,1,1.14
"20240531","1783","9187","9100",群益金鼎-彰化,0,1,1,-1,0.57
"20240603","1783","1650","1650",新加坡商瑞銀,12,1,11,1,11.22
"20240603","1783","6160","6160",中國信託,0,7,7,-1,7.14
"20240603","1783","9103","9100",群益金鼎-松山,10,0,10,1,10.20
"20240603","1783","8880","8880",國泰證券,0,5,5,-1,5.10
"20240603","1783","9268","9200",凱基-台北,11,4,7,1,7.14
"20240603","1783","8842","8840",玉山-新莊,0,4,4,-1,4.08
"20240603","1783","1560","1560",港商野村,4,0,4,1,4.08
"20240603","1783","003900380033004b","9800",元大-學甲,0,4,4,-1,4.08
"20240603","1783","0039003800310043","9800",元大-路竹,4,0,4,1,4.08
"20240603","1783","0036003300380041","6380",光和-嘉義,0,3,3,-1,3.06
"20240603","1783","1480","1480",美商高盛,3,0,3,1,3.06
"20240603","1783","6620","6620",口袋證券,0,3,3,-1,3.06
"20240603","1783","1440","1440",美林,4,1,3,1,3.06
"20240603","1783","8560","8560",新光,0,3,3,-1,3.06
"20240603","1783","0039003800310044","9800",元大-南投,4,1,3,1,3.06
"20240603","1783","8888","8880",國泰-敦南,0,2,2,-1,2.04
"20240603","1783","0039003800390041","9800",元大-北投,3,0,3,1,3.06
"20240603","1783","9211","9200",凱基-台南,0,2,2,-1,2.04
"20240603","1783","003900410039006a","9A00",永豐金-嘉義,3,0,3,1,3.06
"20240603","1783","0038003100350042","8150",台新-台中,0,2,2,-1,2.04
"20240603","1783","9215","9200",凱基-高美館,2,0,2,1,2.04
"20240603","1783","8561","8560",新光-台中,2,4,2,-1,2.04
"20240603","1783","9636","9600",富邦-中壢,2,0,2,1,2.04
"20240603","1783","9101","9100",群益金鼎-敦南,0,2,2,-1,2.04
"20240603","1783","1021","1020",合庫-台中,1,0,1,1,1.02
"20240603","1783","003900310033004e","9100",群益金鼎-土城,0,2,2,-1,2.04
"20240603","1783","0036003000310064","6010",(牛牛牛)亞-鑫豐,1,0,1,1,1.02
"20240603","1783","0039003200300048","9200",凱基-基隆,0,2,2,-1,2.04
"20240604","1783","9697","9600",富邦-虎尾,20,0,20,1,2.21
"20240604","1783","0039003100380067","9100",群益金鼎-大甲,2,32,30,-1,3.31
"20240604","1783","9871","9800",元大-忠孝,15,0,15,1,1.66
"20240604","1783","9898","9800",元大-新莊,7,34,27,-1,2.98
"20240604","1783","9634","9600",富邦-羅東,17,4,13,1,1.44
"20240604","1783","1560","1560",港商野村,1,20,19,-1,2.10
"20240604","1783","1040","1040",臺銀,14,2,12,1,1.33
"20240604","1783","0039003100380047","9100",群益金鼎-新莊,0,19,19,-1,2.10
"20240604","1783","9223","9200",凱基-豐中,12,0,12,1,1.33
"20240604","1783","0039003800300043","9800",元大-斗六,1,16,15,-1,1.66
"20240604","1783","0039003800310065","9800",元大-佳里,14,2,12,1,1.33
"20240604","1783","1480","1480",美商高盛,1,15,14,-1,1.55
"20240604","1783","5386","5380",第一金-彰化,11,0,11,1,1.22
"20240604","1783","9658","9600",富邦-建國,0,12,12,-1,1.33
"20240604","1783","0035003900320079","5920",元富-花蓮,11,0,11,1,1.22
"20240604","1783","1440","1440",美林,10,21,11,-1,1.22
"20240604","1783","9186","9100",群益金鼎-新竹,12,2,10,1,1.10
"20240604","1783","9816","9800",元大-新竹,0,11,11,-1,1.22
"20240604","1783","0039003100380057","9100",群益金鼎-忠孝,20,10,10,1,1.10
"20240604","1783","0039004100300030","9A00",永豐金證券,0,9,9,-1,0.99
"20240604","1783","0039004100390038","9A00",永豐金-大園,10,0,10,1,1.10
"20240604","1783","0039003200300048","9200",凱基-基隆,0,9,9,-1,0.99
"20240604","1783","003900380031006a","9800",元大-士林,21,11,10,1,1.10
"20240604","1783","0035003800350055","5850",統一-南京,0,9,9,-1,0.99
"20240604","1783","8847","8840",玉山-台南,8,0,8,1,0.88
"20240604","1783","0035003900320045","5920",元富-城中,0,8,8,-1,0.88
"20240604","1783","9872","9800",元大-復北,8,0,8,1,0.88
"20240604","1783","9647","9600",富邦-新竹,1,7,6,-1,0.66
"20240605","1783","1440","1440",美林,27,9,18,1,4.26
"20240605","1783","9658","9600",富邦-建國,1,23,22,-1,5.20
"20240605","1783","0031003000340043","1040",臺銀-高雄,15,0,15,1,3.55
"20240605","1783","0035003800350051","5850",統一-三多,0,20,20,-1,4.73
"20240605","1783","6168","6160",中國信託-嘉義,15,0,15,1,3.55
"20240605","1783","9208","9200",凱基-桃園,0,12,12,-1,2.84
"20240605","1783","8440","8440",摩根大通,31,17,14,1,3.31
"20240605","1783","5386","5380",第一金-彰化,0,11,11,-1,2.60
"20240605","1783","8563","8560",新光-新竹,12,1,11,1,2.60
"20240605","1783","1650","1650",新加坡商瑞銀,5,15,10,-1,2.36
"20240605","1783","5850","5850",統一,10,0,10,1,2.36
"20240605","1783","0039003100380057","9100",群益金鼎-忠孝,0,10,10,-1,2.36
"20240605","1783","0035003900320062","5920",元富-板橋,10,0,10,1,2.36
"20240605","1783","5603","5600",永興-台中,0,8,8,-1,1.89
"20240605","1783","0038003100350041","8150",台新-高雄,10,0,10,1,2.36
"20240605","1783","8157","8150",台新-左楠,0,7,7,-1,1.65
"20240605","1783","1560","1560",港商野村,12,4,8,1,1.89
"20240605","1783","1480","1480",美商高盛,0,6,6,-1,1.42
"20240605","1783","0035003800350045","5850",統一-新營,6,0,6,1,1.42
"20240605","1783","8561","8560",新光-台中,0,6,6,-1,1.42
"20240605","1783","8150","8150",台新證券,6,0,6,1,1.42
"20240605","1783","9138","9100",群益金鼎-中港,0,6,6,-1,1.42
"20240605","1783","8888","8880",國泰-敦南,6,1,5,1,1.18
"20240605","1783","9101","9100",群益金鼎-敦南,0,4,4,-1,0.95
"20240605","1783","9105","9100",群益金鼎-高盛,5,0,5,1,1.18
"20240605","1783","9647","9600",富邦-新竹,0,4,4,-1,0.95
"20240605","1783","0039003100330045","9100",群益金鼎-基隆,5,0,5,1,1.18
"20240605","1783","9817","9800",元大-東泰,0,4,4,-1,0.95
"20240606","1783","0038003100350041","8150",台新-高雄,30,0,30,1,12.77
"20240606","1783","1650","1650",新加坡商瑞銀,3,26,23,-1,9.79
"20240606","1783","1440","1440",美林,18,4,14,1,5.96
"20240606","1783","9268","9200",凱基-台北,0,18,18,-1,7.66
"20240606","1783","0035003900320072","5920",元富-城東,10,0,10,1,4.26
"20240606","1783","8440","8440",摩根大通,2,19,17,-1,7.23
"20240606","1783","0037003700390058","7790",國票-中和,10,0,10,1,4.26
"20240606","1783","1480","1480",美商高盛,0,10,10,-1,4.26
"20240606","1783","1470","1470",台灣摩根士丹利,9,0,9,1,3.83
"20240606","1783","9875","9800",元大-土城永寧,0,9,9,-1,3.83
"20240606","1783","003500390032006f","5920",元富-新興,10,2,8,1,3.40
"20240606","1783","9217","9200",凱基-松山,0,7,7,-1,2.98
"20240606","1783","0035003900320062","5920",元富-板橋,5,0,5,1,2.13
"20240606","1783","0039003100330045","9100",群益金鼎-基隆,3,8,5,-1,2.13
"20240606","1783","9105","9100",群益金鼎-高盛,5,0,5,1,2.13
"20240606","1783","1560","1560",港商野村,0,3,3,-1,1.28
"20240606","1783","0039003800310043","9800",元大-路竹,5,0,5,1,2.13
"20240606","1783","1032","1030",土銀-台南,0,3,3,-1,1.28
"20240606","1783","5850","5850",統一,4,0,4,1,1.70
"20240606","1783","0039003100330059","9100",群益金鼎-館前,0,3,3,-1,1.28
"20240606","1783","6461","6460",大昌-樹林,4,0,4,1,1.70
"20240606","1783","9183","9100",群益金鼎-高雄,0,3,3,-1,1.28
"20240606","1783","8156","8150",台新-三民,4,0,4,1,1.70
"20240606","1783","0039003100380067","9100",群益金鼎-大甲,0,3,3,-1,1.28
"20240606","1783","0039003100380045","9100",群益金鼎-南京,4,0,4,1,1.70
"20240606","1783","0039003800310069","9800",元大-西螺,0,3,3,-1,1.28
"20240606","1783","9655","9600",富邦-板橋,3,0,3,1,1.28
"20240606","1783","0039003800390061","9800",元大-苑裡,0,3,3,-1,1.28
"20240607","1783","8440","8440",摩根大通,27,0,27,1,8.21
"20240607","1783","9208","9200",凱基-桃園,0,10,10,-1,3.04
"20240607","1783","1117","1110",台灣企銀-竹北,20,0,20,1,6.08
"20240607","1783","9658","9600",富邦-建國,0,10,10,-1,3.04
"20240607","1783","1440","1440",美林,18,0,18,1,5.47
"20240607","1783","003900380031006a","9800",元大-士林,0,10,10,-1,3.04
"20240607","1783","1560","1560",港商野村,17,0,17,1,5.17
"20240607","1783","7032","7030",致和-佳里,0,9,9,-1,2.74
"20240607","1783","9268","9200",凱基-台北,20,4,16,1,4.86
"20240607","1783","9136","9100",群益金鼎-西松,0,9,9,-1,2.74
"20240607","1783","6163","6160",中國信託-永康,14,0,14,1,4.26
"20240607","1783","0039004100300030","9A00",永豐金證券,0,8,8,-1,2.43
"20240607","1783","5850","5850",統一,10,0,10,1,3.04
"20240607","1783","9623","9600",富邦-台北,0,8,8,-1,2.43
"20240607","1783","9624","9600",富邦-竹北,10,0,10,1,3.04
"20240607","1783","1650","1650",新加坡商瑞銀,3,10,7,-1,2.13
"20240607","1783","5264","5260",美好-高雄,9,0,9,1,2.74
"20240607","1783","0035003300380049","5380",第一金-頭份,0,7,7,-1,2.13
"20240607","1783","003900410039004c","9A00",永豐金-台中,9,0,9,1,2.74
"20240607","1783","6380","6380",光和,0,7,7,-1,2.13
"20240607","1783","0038003100350041","8150",台新-高雄,8,0,8,1,2.43
"20240607","1783","003500390032006f","5920",元富-新興,0,6,6,-1,1.82
"20240607","1783","0039003100330045","9100",群益金鼎-基隆,7,0,7,1,2.13
"20240607","1783","7750","7750",北城證券,0,6,6,-1,1.82
"20240607","1783","0039003800310069","9800",元大-西螺,6,0,6,1,1.82
"20240607","1783","003900310038004d","9100",群益金鼎-嘉義,0,6,6,-1,1.82
"20240607","1783","9306","9300",華南永昌-台南,5,0,5,1,1.52
"20240607","1783","9319","9300",華南永昌-鶯歌,0,6,6,-1,1.82
"20240611","1783","1650","1650",新加坡商瑞銀,35,24,11,1,3.09
"20240611","1783","9875","9800",元大-土城永寧,7,20,13,-1,3.65
"20240611","1783","0035003200360041","5260",美好-中和,10,0,10,1,2.81
"20240611","1783","0039004100390038","9A00",永豐金-大園,0,11,11,-1,3.09
"20240611","1783","0035003800350041","5850",統一-基隆,10,0,10,1,2.81
"20240611","1783","9268","9200",凱基-台北,4,15,11,-1,3.09
"20240611","1783","0035003800350051","5850",統一-三多,10,0,10,1,2.81
"20240611","1783","9105","9100",群益金鼎-高盛,0,10,10,-1,2.81
"20240611","1783","0035003900320062","5920",元富-板橋,10,0,10,1,2.81
"20240611","1783","9857","9800",元大-蘆洲,0,10,10,-1,2.81
"20240611","1783","0037003700390058","7790",國票-中和,10,0,10,1,2.81
"20240611","1783","5389","5380",第一金-中山,0,7,7,-1,1.97
"20240611","1783","0035003300380057","5380",第一金-華江,9,0,9,1,2.53
"20240611","1783","9226","9200",凱基-汐止,0,7,7,-1,1.97
"20240611","1783","9303","9300",華南永昌-高雄,9,0,9,1,2.53
"20240611","1783","0039003800310046","9800",元大-福營,0,7,7,-1,1.97
"20240611","1783","1440","1440",美林,12,4,8,1,2.25
"20240611","1783","8560","8560",新光,4,9,5,-1,1.40
"20240611","1783","1560","1560",港商野村,10,3,7,1,1.97
"20240611","1783","0039003800300065","9800",元大-清水,0,5,5,-1,1.40
"20240611","1783","8440","8440",摩根大通,10,3,7,1,1.97
"20240611","1783","1030","1030",土銀,0,4,4,-1,1.12
"20240611","1783","8459","8450",康和-嘉義,7,1,6,1,1.69
"20240611","1783","5323","5320",高橋-內壢,0,4,4,-1,1.12
"20240611","1783","0038003100350042","8150",台新-台中,6,0,6,1,1.69
"20240611","1783","9208","9200",凱基-桃園,0,4,4,-1,1.12
"20240611","1783","9136","9100",群益金鼎-西松,6,0,6,1,1.69
"20240611","1783","5322","5320",高橋-中壢,0,3,3,-1,0.84
"20240612","1783","9136","9100",群益金鼎-西松,12,0,12,1,5.45
"20240612","1783","0031003000340043","1040",臺銀-高雄,0,15,15,-1,6.82
"20240612","1783","1117","1110",台灣企銀-竹北,10,0,10,1,4.55
"20240612","1783","8440","8440",摩根大通,2,17,15,-1,6.82
"20240612","1783","5852","5850",統一-敦南,10,0,10,1,4.55
"20240612","1783","5323","5320",高橋-內壢,0,10,10,-1,4.55
"20240612","1783","0039003100380067","9100",群益金鼎-大甲,10,0,10,1,4.55
"20240612","1783","0035003300380057","5380",第一金-華江,0,9,9,-1,4.09
"20240612","1783","9875","9800",元大-土城永寧,20,10,10,1,4.55
"20240612","1783","0038003100350053","8150",台新-中壢,0,7,7,-1,3.18
"20240612","1783","003800380038004b","8880",國泰-板橋,8,0,8,1,3.64
"20240612","1783","0039003100330045","9100",群益金鼎-基隆,3,10,7,-1,3.18
"20240612","1783","1480","1480",美商高盛,12,6,6,1,2.73
"20240612","1783","9268","9200",凱基-台北,3,9,6,-1,2.73
"20240612","1783","0039003800310069","9800",元大-西螺,6,0,6,1,2.73
"20240612","1783","1042","1040",臺銀-臺南,0,5,5,-1,2.27
"20240612","1783","0035003900320077","5920",元富-佳里,5,0,5,1,2.27
"20240612","1783","8887","8880",國泰-忠孝,0,5,5,-1,2.27
"20240612","1783","5850","5850",統一,4,0,4,1,1.82
"20240612","1783","9283","9200",凱基-北門,0,5,5,-1,2.27
"20240612","1783","8150","8150",台新證券,5,1,4,1,1.82
"20240612","1783","9608","9600",富邦-台東,0,5,5,-1,2.27
"20240612","1783","0039003800310079","9800",元大-善化,3,0,3,1,1.36
"20240612","1783","1440","1440",美林,7,10,3,-1,1.36
"20240612","1783","003500390032006f","5920",元富-新興,2,0,2,1,0.91
"20240612","1783","8882","8880",國泰-台中,0,2,2,-1,0.91
"20240612","1783","8159","8150",台新-台南,2,0,2,1,0.91
"20240612","1783","1650","1650",新加坡商瑞銀,21,23,2,-1,0.91
"20240613","1783","1480","1480",美商高盛,6,0,6,1,4.62
"20240613","1783","9835","9800",元大-員林中山,0,15,15,-1,11.54
"20240613","1783","8848","8840",玉山-嘉義,6,0,6,1,4.62
"20240613","1783","9268","9200",凱基-台北,2,12,10,-1,7.69
"20240613","1783","9138","9100",群益金鼎-中港,10,4,6,1,4.62
"20240613","1783","1042","1040",臺銀-臺南,1,6,5,-1,3.85
"20240613","1783","9655","9600",富邦-板橋,5,0,5,1,3.85
"20240613","1783","0036003000310064","6010",(牛牛牛)亞-鑫豐,1,6,5,-1,3.85
"20240613","1783","9875","9800",元大-土城永寧,8,3,5,1,3.85
"20240613","1783","8150","8150",台新證券,1,6,5,-1,3.85
"20240613","1783","0035003900320077","5920",元富-佳里,4,0,4,1,3.08
"20240613","1783","9857","9800",元大-蘆洲,0,4,4,-1,3.08
"20240613","1783","9834","9800",元大-中壢,4,0,4,1,3.08
"20240613","1783","0035003900320044","5920",元富-大昌,0,3,3,-1,2.31
"20240613","1783","1440","1440",美林,5,2,3,1,2.31
"20240613","1783","8882","8880",國泰-台中,0,3,3,-1,2.31
"20240613","1783","8156","8150",台新-三民,3,0,3,1,2.31
"20240613","1783","9349","9300",華南永昌-板橋,0,3,3,-1,2.31
"20240613","1783","8440","8440",摩根大通,5,2,3,1,2.31
"20240613","1783","9893","9800",元大-大天母,0,3,3,-1,2.31
"20240613","1783","0039003100330059","9100",群益金鼎-館前,3,0,3,1,2.31
"20240613","1783","9800","9800",元大證券,0,2,2,-1,1.54
"20240613","1783","0039004100390071","9A00",永豐金-潮州,3,0,3,1,2.31
"20240613","1783","1043","1040",臺銀-民權,0,2,2,-1,1.54
"20240613","1783","8840","8840",玉山證券,2,0,2,1,1.54
"20240613","1783","003800380038004b","8880",國泰-板橋,0,2,2,-1,1.54
"20240613","1783","5262","5260",美好-楊梅,2,0,2,1,1.54
"20240613","1783","9322","9300",華南永昌-基隆,0,2,2,-1,1.54
"20240614","1783","8150","8150",台新證券,6,1,5,1,7.04
"20240614","1783","9268","9200",凱基-台北,0,7,7,-1,9.86
"20240614","1783","0038003100350059","8150",台新-新營,5,0,5,1,7.04
"20240614","1783","0038003100350041","8150",台新-高雄,0,7,7,-1,9.86
"20240614","1783","0035003900320077","5920",元富-佳里,3,0,3,1,4.23
"20240614","1783","9658","9600",富邦-建國,0,6,6,-1,8.45
"20240614","1783","9183","9100",群益金鼎-高雄,3,0,3,1,4.23
"20240614","1783","9215","9200",凱基-高美館,0,3,3,-1,4.23
"20240614","1783","9329","9300",華南永昌-朴子,3,0,3,1,4.23
"20240614","1783","9897","9800",元大-土城,0,2,2,-1,2.82
"20240614","1783","9647","9600",富邦-新竹,3,0,3,1,4.23
"20240614","1783","8440","8440",摩根大通,2,4,2,-1,2.82
"20240614","1783","6620","6620",口袋證券,2,0,2,1,2.82
"20240614","1783","9305","9300",華南永昌-新莊,0,2,2,-1,2.82
"20240614","1783","5850","5850",統一,2,0,2,1,2.82
"20240614","1783","9319","9300",華南永昌-鶯歌,0,2,2,-1,2.82
"20240614","1783","8159","8150",台新-台南,2,0,2,1,2.82
"20240614","1783","9623","9600",富邦-台北,0,2,2,-1,2.82
"20240614","1783","0038003100350042","8150",台新-台中,2,0,2,1,2.82
"20240614","1783","9893","9800",元大-大天母,0,2,2,-1,2.82
"20240614","1783","8849","8840",玉山-景美,2,0,2,1,2.82
"20240614","1783","9898","9800",元大-新莊,0,2,2,-1,2.82
"20240614","1783","8888","8880",國泰-敦南,2,0,2,1,2.82
"20240614","1783","1041","1040",臺銀-鳳山,0,1,1,-1,1.41
"20240614","1783","0039003800300044","9800",元大-北府,2,0,2,1,2.82
"20240614","1783","003700300030005a","7000",兆豐-高雄,0,1,1,-1,1.41
"20240614","1783","003900380033004b","9800",元大-學甲,2,0,2,1,2.82
"20240614","1783","6160","6160",中國信託,0,1,1,-1,1.41
"20240617","1783","1650","1650",新加坡商瑞銀,24,1,23,1,10.90
"20240617","1783","0035003900320079","5920",元富-花蓮,0,10,10,-1,4.74
"20240617","1783","8440","8440",摩根大通,12,0,12,1,5.69
"20240617","1783","003900380039004a","9800",元大-彰化民生,0,10,10,-1,4.74
"20240617","1783","1440","1440",美林,12,1,11,1,5.21
"20240617","1783","5853","5850",統一-中壢,0,9,9,-1,4.27
"20240617","1783","003700300030006a","7000",兆豐-大安,11,0,11,1,5.21
"20240617","1783","9183","9100",群益金鼎-高雄,1,7,6,-1,2.84
"20240617","1783","0037003000300055","7000",兆豐-桃鶯,10,0,10,1,4.74
"20240617","1783","9227","9200",凱基-城中,0,6,6,-1,2.84
"20240617","1783","1480","1480",美商高盛,8,0,8,1,3.79
"20240617","1783","9875","9800",元大-土城永寧,0,6,6,-1,2.84
"20240617","1783","1560","1560",港商野村,6,0,6,1,2.84
"20240617","1783","1042","1040",臺銀-臺南,0,5,5,-1,2.37
"20240617","1783","0039004100390057","9A00",永豐金-市政,6,0,6,1,2.84
"20240617","1783","003500390032006f","5920",元富-新興,3,8,5,-1,2.37
"20240617","1783","0031003000340041","1040",臺銀-臺中,5,0,5,1,2.37
"20240617","1783","9677","9600",富邦-三重,0,5,5,-1,2.37
"20240617","1783","0039003600320044","9600",富邦-新莊,5,0,5,1,2.37
"20240617","1783","9867","9800",元大-內湖民權,0,5,5,-1,2.37
"20240617","1783","0039004100390038","9A00",永豐金-大園,5,0,5,1,2.37
"20240617","1783","9893","9800",元大-大天母,0,5,5,-1,2.37
"20240617","1783","8843","8840",玉山-高雄,5,0,5,1,2.37
"20240617","1783","9363","9300",華南永昌-彰化,0,5,5,-1,2.37
"20240617","1783","1470","1470",台灣摩根士丹利,4,0,4,1,1.90
"20240617","1783","9101","9100",群益金鼎-敦南,0,4,4,-1,1.90
"20240617","1783","9300","9300",華南永昌,4,0,4,1,1.90
"20240617","1783","9834","9800",元大-中壢,0,4,4,-1,1.90
"20240618","1783","8849","8840",玉山-景美,26,3,23,1,4.26
"20240618","1783","9875","9800",元大-土城永寧,0,20,20,-1,3.70
"20240618","1783","1650","1650",新加坡商瑞銀,41,22,19,1,3.52
"20240618","1783","9208","9200",凱基-桃園,1,14,13,-1,2.41
"20240618","1783","6012","6010",(牛牛牛)亞-網路,25,7,18,1,3.33
"20240618","1783","6380","6380",光和,0,12,12,-1,2.22
"20240618","1783","0038003800380041","8880",國泰-館前,17,1,16,1,2.96
"20240618","1783","0039003100380067","9100",群益金鼎-大甲,3,14,11,-1,2.04
"20240618","1783","8880","8880",國泰證券,16,1,15,1,2.78
"20240618","1783","9647","9600",富邦-新竹,0,10,10,-1,1.85
"20240618","1783","9306","9300",華南永昌-台南,13,0,13,1,2.41
"20240618","1783","0039003800300044","9800",元大-北府,0,10,10,-1,1.85
"20240618","1783","0039004100390057","9A00",永豐金-市政,13,0,13,1,2.41
"20240618","1783","0039003800390042","9800",元大-台中中港,0,10,10,-1,1.85
"20240618","1783","9303","9300",華南永昌-高雄,13,0,13,1,2.41
"20240618","1783","0039003100300044","9100",群益金鼎-市府,1,9,8,-1,1.48
"20240618","1783","1480","1480",美商高盛,11,0,11,1,2.04
"20240618","1783","0039003100380045","9100",群益金鼎-南京,0,8,8,-1,1.48
"20240618","1783","1560","1560",港商野村,11,0,11,1,2.04
"20240618","1783","0038003100350042","8150",台新-台中,2,10,8,-1,1.48
"20240618","1783","0039003800380042","9800",元大-桃園,9,0,9,1,1.67
"20240618","1783","0039003800310067","9800",元大-大里,0,7,7,-1,1.30
"20240618","1783","9655","9600",富邦-板橋,8,0,8,1,1.48
"20240618","1783","003900380031006e","9800",元大-旗山,0,7,7,-1,1.30
"20240618","1783","6381","6380",光和-溪湖,7,0,7,1,1.30
"20240618","1783","9831","9800",元大-四維,0,7,7,-1,1.30
"20240618","1783","8440","8440",摩根大通,7,0,7,1,1.30
"20240618","1783","0039004100390037","9A00",永豐金-新竹,0,6,6,-1,1.11
"20240619","1783","0039003800310069","9800",元大-西螺,10,0,10,1,4.88
"20240619","1783","9268","9200",凱基-台北,4,17,13,-1,6.34
"20240619","1783","5850","5850",統一,7,0,7,1,3.41
"20240619","1783","5323","5320",高橋-內壢,0,12,12,-1,5.85
"20240619","1783","1590","1590",花旗環球,5,0,5,1,2.44
"20240619","1783","003900380039004e","9800",元大-內湖,0,10,10,-1,4.88
"20240619","1783","8880","8880",國泰證券,5,0,5,1,2.44
"20240619","1783","9223","9200",凱基-豐中,0,10,10,-1,4.88
"20240619","1783","0038003800380041","8880",國泰-館前,5,0,5,1,2.44
"20240619","1783","1560","1560",港商野村,0,7,7,-1,3.41
"20240619","1783","9257","9200",凱基-林口,5,0,5,1,2.44
"20240619","1783","1650","1650",新加坡商瑞銀,11,18,7,-1,3.41
"20240619","1783","0039004100360031","9A00",永豐金-鳳山,5,0,5,1,2.44
"20240619","1783","9874","9800",元大-雙和,0,5,5,-1,2.44
"20240619","1783","8888","8880",國泰-敦南,7,3,4,1,1.95
"20240619","1783","8560","8560",新光,3,7,4,-1,1.95
"20240619","1783","9235","9200",凱基-永華,4,0,4,1,1.95
"20240619","1783","1038","1030",土銀-和平,0,4,4,-1,1.95
"20240619","1783","9278","9200",凱基-永康,4,0,4,1,1.95
"20240619","1783","6160","6160",中國信託,0,4,4,-1,1.95
"20240619","1783","9834","9800",元大-中壢,4,0,4,1,1.95
"20240619","1783","7036","7030",致和-高雄,0,3,3,-1,1.46
"20240619","1783","0039004100390053","9A00",永豐金-南京,4,0,4,1,1.95
"20240619","1783","0039003100300044","9100",群益金鼎-市府,0,3,3,-1,1.46
"20240619","1783","0039004100390057","9A00",永豐金-市政,5,1,4,1,1.95
"20240619","1783","0039003100330045","9100",群益金鼎-基隆,1,4,3,-1,1.46
"20240619","1783","0031003000340041","1040",臺銀-臺中,3,0,3,1,1.46
"20240619","1783","0039003800390065","9800",元大-中和,0,3,3,-1,1.46
"20240620","1783","5384","5380",第一金-台南,26,0,26,1,9.00
"20240620","1783","9200","9200",凱基,0,40,40,-1,13.84
"20240620","1783","1650","1650",新加坡商瑞銀,36,10,26,1,9.00
"20240620","1783","5852","5850",統一-敦南,0,6,6,-1,2.08
"20240620","1783","8440","8440",摩根大通,20,2,18,1,6.23
"20240620","1783","9816","9800",元大-新竹,0,6,6,-1,2.08
"20240620","1783","1480","1480",美商高盛,15,0,15,1,5.19
"20240620","1783","0037003000300056","7000",兆豐-新竹,0,5,5,-1,1.73
"20240620","1783","1560","1560",港商野村,10,0,10,1,3.46
"20240620","1783","0039003800390043","9800",元大-板橋,0,5,5,-1,1.73
"20240620","1783","1440","1440",美林,20,10,10,1,3.46
"20240620","1783","9101","9100",群益金鼎-敦南,0,4,4,-1,1.38
"20240620","1783","6012","6010",(牛牛牛)亞-網路,6,0,6,1,2.08
"20240620","1783","003900320030004e","9200",凱基-湖口,0,4,4,-1,1.38
"20240620","1783","0039003600310043","9600",富邦-南京,7,1,6,1,2.08
"20240620","1783","003900380031006e","9800",元大-旗山,0,4,4,-1,1.38
"20240620","1783","9218","9200",凱基-大直,5,0,5,1,1.73
"20240620","1783","003900380039004a","9800",元大-彰化民生,0,4,4,-1,1.38
"20240620","1783","9307","9300",華南永昌-大安,5,0,5,1,1.73
"20240620","1783","8560","8560",新光,1,4,3,-1,1.04
"20240620","1783","0039003800310069","9800",元大-西螺,5,0,5,1,1.73
"20240620","1783","0039003800310070","9800",元大-松山,0,3,3,-1,1.04
"20240620","1783","003900380033004b","9800",元大-學甲,5,0,5,1,1.73
"20240620","1783","9377","9300",華南永昌-虎尾,0,2,2,-1,0.69
"20240620","1783","5850","5850",統一,4,0,4,1,1.38
"20240620","1783","9623","9600",富邦-台北,0,2,2,-1,0.69
"20240620","1783","6164","6160",中國信託-文心,4,0,4,1,1.38
"20240620","1783","0039004100300030","9A00",永豐金證券,1,3,2,-1,0.69
"20240621","1783","1440","1440",美林,18,0,18,1,7.83
"20240621","1783","9208","9200",凱基-桃園,0,15,15,-1,6.52
"20240621","1783","003900380031007a","9800",元大-大統,11,0,11,1,4.78
"20240621","1783","9874","9800",元大-雙和,0,14,14,-1,6.09
"20240621","1783","1560","1560",港商野村,10,1,9,1,3.91
"20240621","1783","8440","8440",摩根大通,8,16,8,-1,3.48
"20240621","1783","0037003700390065","7790",國票-南科,9,0,9,1,3.91
"20240621","1783","9875","9800",元大-土城永寧,4,11,7,-1,3.04
"20240621","1783","9278","9200",凱基-永康,9,0,9,1,3.91
"20240621","1783","1118","1110",台灣企銀-豐原,0,5,5,-1,2.17
"20240621","1783","9867","9800",元大-內湖民權,11,2,9,1,3.91
"20240621","1783","9647","9600",富邦-新竹,0,5,5,-1,2.17
"20240621","1783","1480","1480",美商高盛,6,0,6,1,2.61
"20240621","1783","8150","8150",台新證券,0,4,4,-1,1.74
"20240621","1783","9268","9200",凱基-台北,11,6,5,1,2.17
"20240621","1783","0039003600320050","9600",富邦-頭份,0,4,4,-1,1.74
"20240621","1783","9831","9800",元大-四維,5,0,5,1,2.17
"20240621","1783","1042","1040",臺銀-臺南,0,3,3,-1,1.30
"20240621","1783","0039004100300030","9A00",永豐金證券,4,0,4,1,1.74
"20240621","1783","0039003200300047","9200",凱基-彰化,0,3,3,-1,1.30
"20240621","1783","1470","1470",台灣摩根士丹利,3,0,3,1,1.30
"20240621","1783","9329","9300",華南永昌-朴子,0,3,3,-1,1.30
"20240621","1783","0039003600310043","9600",富邦-南京,3,0,3,1,1.30
"20240621","1783","003900380031004b","9800",元大-林園,0,3,3,-1,1.30
"20240621","1783","0039003800310044","9800",元大-南投,3,0,3,1,1.30
"20240621","1783","8560","8560",新光,0,2,2,-1,0.87
"20240621","1783","0038003800340042","8840",玉山-台中,2,0,2,1,0.87
"20240621","1783","5263","5260",美好-泰山,0,2,2,-1,0.87
"20240624","1783","0037003700390065","7790",國票-南科,10,0,10,1,5.71
"20240624","1783","9268","9200",凱基-台北,0,13,13,-1,7.43
"20240624","1783","1560","1560",港商野村,8,0,8,1,4.57
"20240624","1783","0039003600310043","9600",富邦-南京,0,12,12,-1,6.86
"20240624","1783","0039003200300057","9200",凱基-大里,5,0,5,1,2.86
"20240624","1783","0039004100300030","9A00",永豐金證券,0,10,10,-1,5.71
"20240624","1783","0039004100390044","9A00",永豐金-忠孝,5,0,5,1,2.86
"20240624","1783","8888","8880",國泰-敦南,0,8,8,-1,4.57
"20240624","1783","1470","1470",台灣摩根士丹利,4,0,4,1,2.29
"20240624","1783","8440","8440",摩根大通,1,7,6,-1,3.43
"20240624","1783","9216","9200",凱基-信義,4,0,4,1,2.29
"20240624","1783","7750","7750",北城證券,0,5,5,-1,2.86
"20240624","1783","0039003800330056","9800",元大-竹南,3,0,3,1,1.71
"20240624","1783","003900380039004a","9800",元大-彰化民生,0,5,5,-1,2.86
"20240624","1783","0039003800390051","9800",元大-汐止,4,1,3,1,1.71
"20240624","1783","003700300030004d","7000",兆豐-桃園,0,4,4,-1,2.29
"20240624","1783","0035003300380059","5380",第一金-中壢,2,0,2,1,1.14
"20240624","1783","0039003100380045","9100",群益金鼎-南京,0,4,4,-1,2.29
"20240624","1783","1021","1020",合庫-台中,2,0,2,1,1.14
"20240624","1783","9291","9200",凱基-大安,0,4,4,-1,2.29
"20240624","1783","6381","6380",光和-溪湖,3,1,2,1,1.14
"20240624","1783","0039003600320050","9600",富邦-頭份,0,4,4,-1,2.29
"20240624","1783","9215","9200",凱基-高美館,2,0,2,1,1.14
"20240624","1783","0031003000320045","1020",合庫-桃園,0,3,3,-1,1.71
"20240624","1783","9324","9300",華南永昌-岡山,2,0,2,1,1.14
"20240624","1783","1650","1650",新加坡商瑞銀,6,9,3,-1,1.71
"20240624","1783","9666","9600",富邦-南屯,2,0,2,1,1.14
"20240624","1783","9101","9100",群益金鼎-敦南,0,3,3,-1,1.71
"20240625","1783","0035003300380043","5380",第一金-光復,18,0,18,1,12.86
"20240625","1783","6161","6160",中國信託-三重,0,10,10,-1,7.14
"20240625","1783","1590","1590",花旗環球,8,0,8,1,5.71
"20240625","1783","0039003800330047","9800",元大-上新莊,0,10,10,-1,7.14
"20240625","1783","9185","9100",群益金鼎-台南,8,0,8,1,5.71
"20240625","1783","8562","8560",新光-高雄,0,8,8,-1,5.71
"20240625","1783","0037003700390065","7790",國票-南科,6,0,6,1,4.29
"20240625","1783","9874","9800",元大-雙和,0,6,6,-1,4.29
"20240625","1783","8843","8840",玉山-高雄,5,0,5,1,3.57
"20240625","1783","0037003000300049","7000",兆豐-北高雄,0,5,5,-1,3.57
"20240625","1783","1440","1440",美林,7,3,4,1,2.86
"20240625","1783","003900310038007a","9100",群益金鼎-宜蘭,0,5,5,-1,3.57
"20240625","1783","003500390032007a","5920",元富-文心,4,0,4,1,2.86
"20240625","1783","9278","9200",凱基-永康,0,5,5,-1,3.57
"20240625","1783","0038003800380041","8880",國泰-館前,4,0,4,1,2.86
"20240625","1783","0037003000300069","7000",兆豐-松德,0,4,4,-1,2.86
"20240625","1783","1470","1470",台灣摩根士丹利,3,0,3,1,2.14
"20240625","1783","8150","8150",台新證券,0,4,4,-1,2.86
"20240625","1783","8565","8560",新光-桃園,3,0,3,1,2.14
"20240625","1783","9208","9200",凱基-桃園,0,4,4,-1,2.86
"20240625","1783","8560","8560",新光,3,1,2,1,1.43
"20240625","1783","0039003200300047","9200",凱基-彰化,0,3,3,-1,2.14
"20240625","1783","7798","7790",國票-內壢,2,0,2,1,1.43
"20240625","1783","9654","9600",富邦-永和,0,2,2,-1,1.43
"20240625","1783","8887","8880",國泰-忠孝,2,0,2,1,1.43
"20240625","1783","6383","6380",光和-和美,0,2,2,-1,1.43
"20240625","1783","9817","9800",元大-東泰,2,0,2,1,1.43
"20240625","1783","0037003000300046","7000",兆豐-虎尾,0,2,2,-1,1.43
"20240626","1783","0035003300380043","5380",第一金-光復,34,0,34,1,6.26
"20240626","1783","0037003000300066","7000",兆豐-鹿港,0,26,26,-1,4.79
"20240626","1783","1440","1440",美林,31,0,31,1,5.71
"20240626","1783","6161","6160",中國信託-三重,0,17,17,-1,3.13
"20240626","1783","1650","1650",新加坡商瑞銀,40,23,17,1,3.13
"20240626","1783","9134","9100",群益金鼎-開元,0,14,14,-1,2.58
"20240626","1783","9268","9200",凱基-台北,34,18,16,1,2.95
"20240626","1783","9185","9100",群益金鼎-台南,0,13,13,-1,2.39
"20240626","1783","1560","1560",港商野村,14,0,14,1,2.58
"20240626","1783","5852","5850",統一-敦南,0,10,10,-1,1.84
"20240626","1783","1480","1480",美商高盛,12,1,11,1,2.03
"20240626","1783","0035003800350041","5850",統一-基隆,0,10,10,-1,1.84
"20240626","1783","0037003700390058","7790",國票-中和,11,0,11,1,2.03
"20240626","1783","8156","8150",台新-三民,0,10,10,-1,1.84
"20240626","1783","8150","8150",台新證券,16,5,11,1,2.03
"20240626","1783","003900380039004a","9800",元大-彰化民生,0,10,10,-1,1.84
"20240626","1783","9692","9600",富邦-嘉義,10,0,10,1,1.84
"20240626","1783","9215","9200",凱基-高美館,0,8,8,-1,1.47
"20240626","1783","8440","8440",摩根大通,18,9,9,1,1.66
"20240626","1783","9309","9300",華南永昌-古亭,0,8,8,-1,1.47
"20240626","1783","1032","1030",土銀-台南,8,0,8,1,1.47
"20240626","1783","0039003800310072","9800",元大-屏南,0,8,8,-1,1.47
"20240626","1783","1570","1570",港商法國興業,8,0,8,1,1.47
"20240626","1783","8560","8560",新光,0,7,7,-1,1.29
"20240626","1783","0037003700390044","7790",國票-台南,7,0,7,1,1.29
"20240626","1783","8884","8880",國泰-台南,1,6,5,-1,0.92
"20240626","1783","003900380030004b","9800",元大-竹科,7,0,7,1,1.29
"20240626","1783","5389","5380",第一金-中山,0,5,5,-1,0.92
"20240627","1783","0038003800380041","8880",國泰-館前,15,0,15,1,3.45
"20240627","1783","1650","1650",新加坡商瑞銀,12,36,24,-1,5.52
"20240627","1783","9875","9800",元大-土城永寧,7,0,7,1,1.61
"20240627","1783","0031003000340041","1040",臺銀-臺中,0,10,10,-1,2.30
"20240627","1783","0037003700390058","7790",國票-中和,6,0,6,1,1.38
"20240627","1783","0035003900320072","5920",元富-城東,0,10,10,-1,2.30
"20240627","1783","8440","8440",摩根大通,12,6,6,1,1.38
"20240627","1783","1480","1480",美商高盛,0,9,9,-1,2.07
"20240627","1783","0035003300380043","5380",第一金-光復,5,0,5,1,1.15
"20240627","1783","6464","6460",大昌-新店,0,4,4,-1,0.92
"20240627","1783","8150","8150",台新證券,5,0,5,1,1.15
"20240627","1783","9872","9800",元大-復北,0,4,4,-1,0.92
"20240627","1783","8565","8560",新光-桃園,5,0,5,1,1.15
"20240627","1783","0039004100390050","9A00",永豐金-竹北,1,5,4,-1,0.92
"20240627","1783","0039003100330045","9100",群益金鼎-基隆,5,0,5,1,1.15
"20240627","1783","0037003000300050","7000",兆豐-南京,0,3,3,-1,0.69
"20240627","1783","003900380036004b","9800",元大-基隆孝二,5,0,5,1,1.15
"20240627","1783","8882","8880",國泰-台中,2,5,3,-1,0.69
"20240627","1783","0039004100300030","9A00",永豐金證券,5,0,5,1,1.15
"20240627","1783","0039003600310043","9600",富邦-南京,3,6,3,-1,0.69
"20240627","1783","0039004100390044","9A00",永豐金-忠孝,5,0,5,1,1.15
"20240627","1783","1590","1590",花旗環球,0,2,2,-1,0.46
"20240627","1783","5389","5380",第一金-中山,4,0,4,1,0.92
"20240627","1783","6160","6160",中國信託,0,2,2,-1,0.46
"20240627","1783","0038003100350041","8150",台新-高雄,4,0,4,1,0.92
"20240627","1783","6164","6160",中國信託-文心,0,2,2,-1,0.46
"20240627","1783","8880","8880",國泰證券,4,0,4,1,0.92
"20240627","1783","6381","6380",光和-溪湖,1,3,2,-1,0.46
"20240628","1783","003900380039004a","9800",元大-彰化民生,10,0,10,1,6.67
"20240628","1783","003900410039004a","9A00",永豐金-板新,0,14,14,-1,9.33
"20240628","1783","1560","1560",港商野村,9,0,9,1,6.00
"20240628","1783","0037003700390065","7790",國票-南科,0,5,5,-1,3.33
"20240628","1783","1480","1480",美商高盛,7,0,7,1,4.67
"20240628","1783","9287","9200",凱基-內湖,0,5,5,-1,3.33
"20240628","1783","8440","8440",摩根大通,11,5,6,1,4.00
"20240628","1783","003900380030004b","9800",元大-竹科,0,5,5,-1,3.33
"20240628","1783","5850","5850",統一,5,0,5,1,3.33
"20240628","1783","003900380036004b","9800",元大-基隆孝二,0,5,5,-1,3.33
"20240628","1783","1650","1650",新加坡商瑞銀,11,6,5,1,3.33
"20240628","1783","8888","8880",國泰-敦南,0,4,4,-1,2.67
"20240628","1783","8158","8150",台新-松江,5,0,5,1,3.33
"20240628","1783","9604","9600",富邦-陽明,0,4,4,-1,2.67
"20240628","1783","9268","9200",凱基-台北,8,3,5,1,3.33
"20240628","1783","9647","9600",富邦-新竹,0,4,4,-1,2.67
"20240628","1783","1440","1440",美林,7,3,4,1,2.67
"20240628","1783","9856","9800",元大-花蓮,0,4,4,-1,2.67
"20240628","1783","0035003900320062","5920",元富-板橋,4,0,4,1,2.67
"20240628","1783","0035003300380044","5380",第一金-忠孝,0,3,3,-1,2.00
"20240628","1783","9215","9200",凱基-高美館,4,0,4,1,2.67
"20240628","1783","003500390032006e","5920",元富-西松,0,3,3,-1,2.00
"20240628","1783","6110","6110",台中銀,3,0,3,1,2.00
"20240628","1783","6160","6160",中國信託,0,3,3,-1,2.00
"20240628","1783","0037003000300053","7000",兆豐-大同,3,0,3,1,2.00
"20240628","1783","6161","6160",中國信託-三重,0,3,3,-1,2.00
"20240628","1783","9108","9100",群益金鼎-海山,3,0,3,1,2.00
"20240628","1783","8887","8880",國泰-忠孝,0,3,3,-1,2.00
"20240701","1783","0039003100380064","9100",群益金鼎-內湖,103,0,103,1,5.09
"20240701","1783","0038003800380041","8880",國泰-館前,1,49,48,-1,2.37
"20240701","1783","9871","9800",元大-忠孝,118,15,103,1,5.09
"20240701","1783","9875","9800",元大-土城永寧,37,85,48,-1,2.37
"20240701","1783","9893","9800",元大-大天母,72,0,72,1,3.56
"20240701","1783","9211","9200",凱基-台南,3,30,27,-1,1.34
"20240701","1783","003900360031004d","9600",富邦-木柵,60,0,60,1,2.97
"20240701","1783","8842","8840",玉山-新莊,2,25,23,-1,1.14
"20240701","1783","6160","6160",中國信託,59,1,58,1,2.87
"20240701","1783","9831","9800",元大-四維,1,24,23,-1,1.14
"20240701","1783","5384","5380",第一金-台南,51,0,51,1,2.52
"20240701","1783","6161","6160",中國信託-三重,0,20,20,-1,0.99
"20240701","1783","5852","5850",統一-敦南,50,0,50,1,2.47
"20240701","1783","7033","7030",致和-府前,0,20,20,-1,0.99
"20240701","1783","003900310038007a","9100",群益金鼎-宜蘭,45,0,45,1,2.23
"20240701","1783","0039003100380067","9100",群益金鼎-大甲,0,19,19,-1,0.94
"20240701","1783","6012","6010",(牛牛牛)亞-網路,60,23,37,1,1.83
"20240701","1783","8156","8150",台新-三民,2,21,19,-1,0.94
"20240701","1783","9300","9300",華南永昌,28,0,28,1,1.38
"20240701","1783","9215","9200",凱基-高美館,0,19,19,-1,0.94
"20240701","1783","0039003100380073","9100",群益金鼎-丹鳳,23,0,23,1,1.14
"20240701","1783","0039004100390044","9A00",永豐金-忠孝,0,19,19,-1,0.94
"20240701","1783","003900380039004e","9800",元大-內湖,22,0,22,1,1.09
"20240701","1783","9200","9200",凱基,0,18,18,-1,0.89
"20240701","1783","0039003100380065","9100",群益金鼎-大安,22,2,20,1,0.99
"20240701","1783","003700300030005a","7000",兆豐-高雄,0,17,17,-1,0.84
"20240701","1783","9303","9300",華南永昌-高雄,22,5,17,1,0.84
"20240701","1783","003900380031006e","9800",元大-旗山,4,21,17,-1,0.84
"20240702","1783","8888","8880",國泰-敦南,73,29,44,1,1.49
"20240702","1783","003800380034004d","8840",玉山-數位,1,131,130,-1,4.41
"20240702","1783","0039003800310045","9800",元大-發財,43,0,43,1,1.46
"20240702","1783","9871","9800",元大-忠孝,0,118,118,-1,4.00
"20240702","1783","9899","9800",元大-淡水,40,5,35,1,1.19
"20240702","1783","1440","1440",美林,5,108,103,-1,3.49
"20240702","1783","0038003800340041","8840",玉山-士林,34,0,34,1,1.15
"20240702","1783","0039003100380064","9100",群益金鼎-內湖,0,101,101,-1,3.43
"20240702","1783","9303","9300",華南永昌-高雄,30,1,29,1,0.98
"20240702","1783","9268","9200",凱基-台北,82,154,72,-1,2.44
"20240702","1783","0039003600310043","9600",富邦-南京,42,15,27,1,0.92
"20240702","1783","9893","9800",元大-大天母,3,73,70,-1,2.37
"20240702","1783","7795","7790",國票-南港,32,8,24,1,0.81
"20240702","1783","1650","1650",新加坡商瑞銀,90,143,53,-1,1.80
"20240702","1783","9229","9200",凱基-中山,24,0,24,1,0.81
"20240702","1783","8440","8440",摩根大通,18,67,49,-1,1.66
"20240702","1783","0035003900320055","5920",元富-宜蘭,29,7,22,1,0.75
"20240702","1783","9875","9800",元大-土城永寧,1,49,48,-1,1.63
"20240702","1783","9188","9100",群益金鼎-三民,23,1,22,1,0.75
"20240702","1783","5384","5380",第一金-台南,10,53,43,-1,1.46
"20240702","1783","9837","9800",元大-北港,21,0,21,1,0.71
"20240702","1783","6160","6160",中國信託,7,39,32,-1,1.09
"20240702","1783","003500390032005a","5920",元富-安南,21,0,21,1,0.71
"20240702","1783","9659","9600",富邦-高雄,11,38,27,-1,0.92
"20240702","1783","7001","7000",兆豐-嘉義,21,0,21,1,0.71
"20240702","1783","0039003100380073","9100",群益金鼎-丹鳳,0,23,23,-1,0.78
"20240702","1783","8880","8880",國泰證券,23,2,21,1,0.71
"20240702","1783","6161","6160",中國信託-三重,1,20,19,-1,0.64
"20240703","1783","5602","5600",永興-水湳,20,0,20,1,1.23
"20240703","1783","5852","5850",統一-敦南,3,63,60,-1,3.68
"20240703","1783","5850","5850",統一,20,0,20,1,1.23
"20240703","1783","9268","9200",凱基-台北,49,97,48,-1,2.94
"20240703","1783","9654","9600",富邦-永和,20,2,18,1,1.10
"20240703","1783","9899","9800",元大-淡水,0,42,42,-1,2.57
"20240703","1783","003900380031005a","9800",元大-潮州,18,0,18,1,1.10
"20240703","1783","1440","1440",美林,18,51,33,-1,2.02
"20240703","1783","1560","1560",港商野村,20,3,17,1,1.04
"20240703","1783","0038003800340041","8840",玉山-士林,0,30,30,-1,1.84
"20240703","1783","9814","9800",元大-大益,17,1,16,1,0.98
"20240703","1783","7795","7790",國票-南港,0,25,25,-1,1.53
"20240703","1783","0039004100300030","9A00",永豐金證券,17,2,15,1,0.92
"20240703","1783","6160","6160",中國信託,4,25,21,-1,1.29
"20240703","1783","6460","6460",大昌,15,0,15,1,0.92
"20240703","1783","0039003100380065","9100",群益金鼎-大安,0,20,20,-1,1.23
"20240703","1783","9659","9600",富邦-高雄,12,0,12,1,0.74
"20240703","1783","8880","8880",國泰證券,4,22,18,-1,1.10
"20240703","1783","0037003000300050","7000",兆豐-南京,11,0,11,1,0.67
"20240703","1783","9229","9200",凱基-中山,2,20,18,-1,1.10
"20240703","1783","0038003100350059","8150",台新-新營,12,1,11,1,0.67
"20240703","1783","6161","6160",中國信託-三重,2,16,14,-1,0.86
"20240703","1783","0039003800310055","9800",元大-華山,11,0,11,1,0.67
"20240703","1783","0037003700390056","7790",國票-天祥,0,12,12,-1,0.74
"20240703","1783","9833","9800",元大-敦化,13,2,11,1,0.67
"20240703","1783","9647","9600",富邦-新竹,0,12,12,-1,0.74
"20240703","1783","0037003700390058","7790",國票-中和,11,0,11,1,0.67
"20240703","1783","9315","9300",華南永昌-大甲,0,11,11,-1,0.67
"20240704","1783","0038003400350055","8450",康和-台北,22,0,22,1,2.93
"20240704","1783","1440","1440",美林,3,40,37,-1,4.93
"20240704","1783","9812","9800",元大-台中,15,0,15,1,2.00
"20240704","1783","1650","1650",新加坡商瑞銀,23,57,34,-1,4.53
"20240704","1783","9869","9800",元大-新盛,12,0,12,1,1.60
"20240704","1783","9268","9200",凱基-台北,20,54,34,-1,4.53
"20240704","1783","9891","9800",元大-永和,11,0,11,1,1.47
"20240704","1783","6161","6160",中國信託-三重,1,34,33,-1,4.40
"20240704","1783","0035003900320050","5920",元富-同大,10,0,10,1,1.33
"20240704","1783","0039004100390072","9A00",永豐金-北高雄,1,24,23,-1,3.07
"20240704","1783","0039003600320045","9600",富邦-樹林,10,0,10,1,1.33
"20240704","1783","1560","1560",港商野村,0,20,20,-1,2.67
"20240704","1783","0039003800390053","9800",元大-鹿港,10,0,10,1,1.33
"20240704","1783","9825","9800",元大-新營,0,12,12,-1,1.60
"20240704","1783","0039004100390039","9A00",永豐金-中壢,10,0,10,1,1.33
"20240704","1783","9894","9800",元大-桃興,0,12,12,-1,1.60
"20240704","1783","8440","8440",摩根大通,14,5,9,1,1.20
"20240704","1783","0039004100390071","9A00",永豐金-潮州,0,12,12,-1,1.60
"20240704","1783","8560","8560",新光,10,1,9,1,1.20
"20240704","1783","9319","9300",華南永昌-鶯歌,0,10,10,-1,1.33
"20240704","1783","9822","9800",元大-土城學府,10,1,9,1,1.20
"20240704","1783","0035003800350052","5850",統一-汐止,0,10,10,-1,1.33
"20240704","1783","003500390032006f","5920",元富-新興,13,5,8,1,1.07
"20240704","1783","003700300030006a","7000",兆豐-大安,0,10,10,-1,1.33
"20240704","1783","0037003000300070","7000",兆豐-復興,8,0,8,1,1.07
"20240704","1783","9189","9100",群益金鼎-桃園,1,11,10,-1,1.33
"20240704","1783","9859","9800",元大-新竹經國,10,2,8,1,1.07
"20240704","1783","8563","8560",新光-新竹,1,10,9,-1,1.20
"20240705","1783","003500390032005a","5920",元富-安南,24,0,24,1,4.98
"20240705","1783","6161","6160",中國信託-三重,0,23,23,-1,4.77
"20240705","1783","9138","9100",群益金鼎-中港,23,0,23,1,4.77
"20240705","1783","9879","9800",元大-板橋三民,0,18,18,-1,3.73
"20240705","1783","0038003100350041","8150",台新-高雄,19,0,19,1,3.94
"20240705","1783","003900380039004e","9800",元大-內湖,0,15,15,-1,3.11
"20240705","1783","9655","9600",富邦-板橋,19,0,19,1,3.94
"20240705","1783","0039004100390039","9A00",永豐金-中壢,0,10,10,-1,2.07
"20240705","1783","0038003800380041","8880",國泰-館前,12,0,12,1,2.49
"20240705","1783","0035003800350063","5850",統一-仁愛,1,10,9,-1,1.87
"20240705","1783","9105","9100",群益金鼎-高盛,12,0,12,1,2.49
"20240705","1783","1650","1650",新加坡商瑞銀,5,14,9,-1,1.87
"20240705","1783","0035003900320055","5920",元富-宜蘭,10,0,10,1,2.07
"20240705","1783","8159","8150",台新-台南,2,10,8,-1,1.66
"20240705","1783","0037003000300062","7000",兆豐-中壢,10,0,10,1,2.07
"20240705","1783","0039003600310043","9600",富邦-南京,0,8,8,-1,1.66
"20240705","1783","8156","8150",台新-三民,10,0,10,1,2.07
"20240705","1783","8564","8560",新光-台南,0,7,7,-1,1.45
"20240705","1783","9327","9300",華南永昌-斗六,10,0,10,1,2.07
"20240705","1783","0037003700390065","7790",國票-南科,0,7,7,-1,1.45
"20240705","1783","0039003800310079","9800",元大-善化,10,0,10,1,2.07
"20240705","1783","003900380031006e","9800",元大-旗山,0,6,6,-1,1.24
"20240705","1783","1440","1440",美林,10,2,8,1,1.66
"20240705","1783","8888","8880",國泰-敦南,5,11,6,-1,1.24
"20240705","1783","9677","9600",富邦-三重,8,0,8,1,1.66
"20240705","1783","0035003300380050","5380",第一金-路竹,2,8,6,-1,1.24
"20240705","1783","0035003900320071","5920",元富-屏東,7,0,7,1,1.45
"20240705","1783","0039003800300064","9800",元大-沙鹿,0,6,6,-1,1.24
"20240708","1783","0039003600320045","9600",富邦-樹林,19,2,17,1,2.16
"20240708","1783","6168","6160",中國信託-嘉義,0,48,48,-1,6.09
"20240708","1783","9831","9800",元大-四維,17,0,17,1,2.16
"20240708","1783","1650","1650",新加坡商瑞銀,22,47,25,-1,3.17
"20240708","1783","003700300030006a","7000",兆豐-大安,15,0,15,1,1.90
"20240708","1783","003900310038007a","9100",群益金鼎-宜蘭,0,25,25,-1,3.17
"20240708","1783","0039003800390050","9800",元大-敦南,15,0,15,1,1.90
"20240708","1783","6161","6160",中國信託-三重,3,27,24,-1,3.05
"20240708","1783","0035003900320071","5920",元富-屏東,11,0,11,1,1.40
"20240708","1783","003500390032005a","5920",元富-安南,1,24,23,-1,2.92
"20240708","1783","8887","8880",國泰-忠孝,11,0,11,1,1.40
"20240708","1783","9235","9200",凱基-永華,0,16,16,-1,2.03
"20240708","1783","7750","7750",北城證券,11,0,11,1,1.40
"20240708","1783","8888","8880",國泰-敦南,11,23,12,-1,1.52
"20240708","1783","9103","9100",群益金鼎-松山,10,0,10,1,1.27
"20240708","1783","9186","9100",群益金鼎-新竹,0,11,11,-1,1.40
"20240708","1783","0035003900320062","5920",元富-板橋,10,0,10,1,1.27
"20240708","1783","0031003200360044","1260",宏遠-台南,0,10,10,-1,1.27
"20240708","1783","7001","7000",兆豐-嘉義,10,0,10,1,1.27
"20240708","1783","0035003200360041","5260",美好-中和,0,10,10,-1,1.27
"20240708","1783","8585","8580",聯邦-三重,10,0,10,1,1.27
"20240708","1783","9308","9300",華南永昌-麻豆,0,10,10,-1,1.27
"20240708","1783","003900380039004a","9800",元大-彰化民生,10,0,10,1,1.27
"20240708","1783","0039003800390053","9800",元大-鹿港,0,10,10,-1,1.27
"20240708","1783","0037003700390058","7790",國票-中和,10,1,9,1,1.14
"20240708","1783","0039003800390057","9800",元大-豐原站前,0,10,10,-1,1.27
"20240708","1783","8156","8150",台新-三民,9,0,9,1,1.14
"20240708","1783","0039003600310043","9600",富邦-南京,4,13,9,-1,1.14
"20240709","1783","1650","1650",新加坡商瑞銀,107,6,101,1,8.93
"20240709","1783","8849","8840",玉山-景美,0,31,31,-1,2.74
"20240709","1783","0038003800380041","8880",國泰-館前,36,0,36,1,3.18
"20240709","1783","0038003100350041","8150",台新-高雄,2,16,14,-1,1.24
"20240709","1783","1440","1440",美林,63,36,27,1,2.39
"20240709","1783","9623","9600",富邦-台北,0,13,13,-1,1.15
"20240709","1783","8888","8880",國泰-敦南,28,3,25,1,2.21
"20240709","1783","9256","9200",凱基-南崁,0,11,11,-1,0.97
"20240709","1783","003900380039004c","9800",元大-成功,25,0,25,1,2.21
"20240709","1783","5381","5380",第一金-員林,0,10,10,-1,0.88
"20240709","1783","1480","1480",美商高盛,24,0,24,1,2.12
"20240709","1783","0035003800350045","5850",統一-新營,0,10,10,-1,0.88
"20240709","1783","0035003900320050","5920",元富-同大,24,0,24,1,2.12
"20240709","1783","6460","6460",大昌,0,10,10,-1,0.88
"20240709","1783","1560","1560",港商野村,23,0,23,1,2.03
"20240709","1783","9833","9800",元大-敦化,0,10,10,-1,0.88
"20240709","1783","1111","1110",台灣企銀-台中,22,0,22,1,1.95
"20240709","1783","8158","8150",台新-松江,0,9,9,-1,0.80
"20240709","1783","9257","9200",凱基-林口,26,5,21,1,1.86
"20240709","1783","8843","8840",玉山-高雄,1,10,9,-1,0.80
"20240709","1783","0039003600320045","9600",富邦-樹林,18,0,18,1,1.59
"20240709","1783","9867","9800",元大-內湖民權,0,8,8,-1,0.71
"20240709","1783","003900380031006e","9800",元大-旗山,16,0,16,1,1.41
"20240709","1783","0038003400350041","8450",康和-內湖,0,7,7,-1,0.62
"20240709","1783","8887","8880",國泰-忠孝,15,0,15,1,1.33
"20240709","1783","0037003000300050","7000",兆豐-南京,0,6,6,-1,0.53
"20240709","1783","003900380039005a","9800",元大-小港,15,0,15,1,1.33
"20240709","1783","0039003800350043","9800",元大-鳳中,0,6,6,-1,0.53
"20240710","1783","1440","1440",美林,25,2,23,1,9.75
"20240710","1783","9852","9800",元大-永春,0,13,13,-1,5.51
"20240710","1783","9268","9200",凱基-台北,23,8,15,1,6.36
"20240710","1783","9103","9100",群益金鼎-松山,0,10,10,-1,4.24
"20240710","1783","1560","1560",港商野村,9,0,9,1,3.81
"20240710","1783","8440","8440",摩根大通,3,12,9,-1,3.81
"20240710","1783","0039003100380045","9100",群益金鼎-南京,7,0,7,1,2.97
"20240710","1783","9257","9200",凱基-林口,0,9,9,-1,3.81
"20240710","1783","1650","1650",新加坡商瑞銀,11,5,6,1,2.54
"20240710","1783","8887","8880",國泰-忠孝,1,8,7,-1,2.97
"20240710","1783","0039004100300030","9A00",永豐金證券,5,0,5,1,2.12
"20240710","1783","9655","9600",富邦-板橋,0,6,6,-1,2.54
"20240710","1783","0038003800380041","8880",國泰-館前,5,0,5,1,2.12
"20240710","1783","0031003000320041","1020",合庫-新竹,0,5,5,-1,2.12
"20240710","1783","003900360031004b","9600",富邦-七賢,5,0,5,1,2.12
"20240710","1783","0035003900320062","5920",元富-板橋,3,8,5,-1,2.12
"20240710","1783","9636","9600",富邦-中壢,5,0,5,1,2.12
"20240710","1783","8380","8380",安泰,0,5,5,-1,2.12
"20240710","1783","8888","8880",國泰-敦南,5,1,4,1,1.69
"20240710","1783","8459","8450",康和-嘉義,0,5,5,-1,2.12
"20240710","1783","003800340035004a","8450",康和-高雄,4,0,4,1,1.69
"20240710","1783","0039003800390051","9800",元大-汐止,0,5,5,-1,2.12
"20240710","1783","0037003000300077","7000",兆豐-新莊,3,0,3,1,1.27
"20240710","1783","0039004100390038","9A00",永豐金-大園,0,5,5,-1,2.12
"20240710","1783","0038003400350045","8450",康和-澎湖,3,0,3,1,1.27
"20240710","1783","0035003900320069","5920",元富-中港,0,4,4,-1,1.69
"20240710","1783","0039004100390057","9A00",永豐金-市政,2,0,2,1,0.85
"20240710","1783","003500390032006f","5920",元富-新興,0,4,4,-1,1.69
"20240711","1783","9235","9200",凱基-永華,16,0,16,1,7.44
"20240711","1783","9268","9200",凱基-台北,2,20,18,-1,8.37
"20240711","1783","0039003800310061","9800",元大-歸仁,10,0,10,1,4.65
"20240711","1783","1650","1650",新加坡商瑞銀,6,17,11,-1,5.12
"20240711","1783","0035003900320077","5920",元富-佳里,8,0,8,1,3.72
"20240711","1783","9677","9600",富邦-三重,0,10,10,-1,4.65
"20240711","1783","003900380031005a","9800",元大-潮州,8,0,8,1,3.72
"20240711","1783","9655","9600",富邦-板橋,0,7,7,-1,3.26
"20240711","1783","1560","1560",港商野村,8,1,7,1,3.26
"20240711","1783","9659","9600",富邦-高雄,0,6,6,-1,2.79
"20240711","1783","8882","8880",國泰-台中,8,1,7,1,3.26
"20240711","1783","9867","9800",元大-內湖民權,0,5,5,-1,2.33
"20240711","1783","0037003000300067","7000",兆豐-南門,6,0,6,1,2.79
"20240711","1783","9871","9800",元大-忠孝,0,5,5,-1,2.33
"20240711","1783","003900380039004c","9800",元大-成功,5,0,5,1,2.33
"20240711","1783","003500390032006f","5920",元富-新興,0,4,4,-1,1.86
"20240711","1783","9854","9800",元大-文心興安,4,0,4,1,1.86
"20240711","1783","1028","1020",合庫-彰化,0,3,3,-1,1.40
"20240711","1783","8888","8880",國泰-敦南,5,2,3,1,1.40
"20240711","1783","6114","6110",台中銀-員林,0,3,3,-1,1.40
"20240711","1783","5321","5320",高橋-龍潭,3,0,3,1,1.40
"20240711","1783","0039003800300052","9800",元大-南海,0,3,3,-1,1.40
"20240711","1783","0039003600320045","9600",富邦-樹林,3,0,3,1,1.40
"20240711","1783","9893","9800",元大-大天母,0,3,3,-1,1.40
"20240711","1783","0039003800310045","9800",元大-發財,3,0,3,1,1.40
"20240711","1783","0039004100390051","9A00",永豐金-豐原,0,3,3,-1,1.40
"20240711","1783","9884","9800",元大-斗信,3,0,3,1,1.40
"20240711","1783","1480","1480",美商高盛,0,2,2,-1,0.93
"20240712","1783","9875","9800",元大-土城永寧,10,0,10,1,6.10
"20240712","1783","9655","9600",富邦-板橋,0,12,12,-1,7.32
"20240712","1783","0039003600320045","9600",富邦-樹林,8,0,8,1,4.88
"20240712","1783","003800380038004b","8880",國泰-板橋,0,10,10,-1,6.10
"20240712","1783","0035003900320077","5920",元富-佳里,7,0,7,1,4.27
"20240712","1783","9257","9200",凱基-林口,2,12,10,-1,6.10
"20240712","1783","5266","5260",美好-中壢,5,0,5,1,3.05
"20240712","1783","9677","9600",富邦-三重,0,10,10,-1,6.10
"20240712","1783","1650","1650",新加坡商瑞銀,5,1,4,1,2.44
"20240712","1783","9608","9600",富邦-台東,0,9,9,-1,5.49
"20240712","1783","9667","9600",富邦-台南,4,0,4,1,2.44
"20240712","1783","1042","1040",臺銀-臺南,0,6,6,-1,3.66
"20240712","1783","9814","9800",元大-大益,4,0,4,1,2.44
"20240712","1783","0039004100390057","9A00",永豐金-市政,1,7,6,-1,3.66
"20240712","1783","9863","9800",元大-和平,3,0,3,1,1.83
"20240712","1783","9138","9100",群益金鼎-中港,0,4,4,-1,2.44
"20240712","1783","0039003800390053","9800",元大-鹿港,3,0,3,1,1.83
"20240712","1783","9834","9800",元大-中壢,0,4,4,-1,2.44
"20240712","1783","1033","1030",土銀-高雄,2,0,2,1,1.22
"20240712","1783","0037003000300077","7000",兆豐-新莊,0,3,3,-1,1.83
"20240712","1783","1560","1560",港商野村,2,0,2,1,1.22
"20240712","1783","1480","1480",美商高盛,0,2,2,-1,1.22
"20240712","1783","0037003000300061","7000",兆豐-忠孝,2,0,2,1,1.22
"20240712","1783","5323","5320",高橋-內壢,0,2,2,-1,1.22
"20240712","1783","0037003000300043","7000",兆豐-來福,2,0,2,1,1.22
"20240712","1783","0037003700390075","7790",國票-長城,0,2,2,-1,1.22
"20240712","1783","8156","8150",台新-三民,3,1,2,1,1.22
"20240712","1783","9101","9100",群益金鼎-敦南,0,2,2,-1,1.22
"20240715","1783","9276","9200",凱基-苗栗,10,0,10,1,5.62
"20240715","1783","6161","6160",中國信託-三重,0,10,10,-1,5.62
"20240715","1783","9831","9800",元大-四維,9,0,9,1,5.06
"20240715","1783","003900380039005a","9800",元大-小港,0,10,10,-1,5.62
"20240715","1783","0039003600320045","9600",富邦-樹林,6,0,6,1,3.37
"20240715","1783","1650","1650",新加坡商瑞銀,1,10,9,-1,5.06
"20240715","1783","1440","1440",美林,9,4,5,1,2.81
"20240715","1783","0039004100390057","9A00",永豐金-市政,0,7,7,-1,3.93
"20240715","1783","0035003900320051","5920",元富-敦南,5,0,5,1,2.81
"20240715","1783","003500390032006f","5920",元富-新興,0,6,6,-1,3.37
"20240715","1783","9875","9800",元大-土城永寧,4,0,4,1,2.25
"20240715","1783","9101","9100",群益金鼎-敦南,0,6,6,-1,3.37
"20240715","1783","0039004100300030","9A00",永豐金證券,4,0,4,1,2.25
"20240715","1783","0039004100380046","9A00",永豐金-敦南,0,6,6,-1,3.37
"20240715","1783","5922","5920",元富-新店,3,0,3,1,1.69
"20240715","1783","9677","9600",富邦-三重,0,5,5,-1,2.81
"20240715","1783","0031003200360069","1260",宏遠-光隆,3,0,3,1,1.69
"20240715","1783","0039003800310045","9800",元大-發財,0,5,5,-1,2.81
"20240715","1783","1560","1560",港商野村,3,0,3,1,1.69
"20240715","1783","0039004100390042","9A00",永豐金-中和,0,5,5,-1,2.81
"20240715","1783","0035003900320071","5920",元富-屏東,3,0,3,1,1.69
"20240715","1783","1480","1480",美商高盛,0,3,3,-1,1.69
"20240715","1783","003900380033004b","9800",元大-學甲,3,0,3,1,1.69
"20240715","1783","6461","6460",大昌-樹林,0,3,3,-1,1.69
"20240715","1783","9874","9800",元大-雙和,3,0,3,1,1.69
"20240715","1783","0039003600320043","9600",富邦-東門,0,3,3,-1,1.69
"20240715","1783","6950","6950",福勝,2,0,2,1,1.12
"20240715","1783","003900380031006e","9800",元大-旗山,0,3,3,-1,1.69
"20240716","1783","0039003800310055","9800",元大-華山,12,0,12,1,5.94
"20240716","1783","9268","9200",凱基-台北,4,34,30,-1,14.85
"20240716","1783","0039003100380047","9100",群益金鼎-新莊,11,0,11,1,5.45
"20240716","1783","1480","1480",美商高盛,0,15,15,-1,7.43
"20240716","1783","9898","9800",元大-新莊,10,0,10,1,4.95
"20240716","1783","6161","6160",中國信託-三重,0,10,10,-1,4.95
"20240716","1783","0035003900320077","5920",元富-佳里,10,0,10,1,4.95
"20240716","1783","9655","9600",富邦-板橋,0,9,9,-1,4.46
"20240716","1783","6912","6910",德信-中正,8,0,8,1,3.96
"20240716","1783","0039003800310065","9800",元大-佳里,0,8,8,-1,3.96
"20240716","1783","0039003600320045","9600",富邦-樹林,6,0,6,1,2.97
"20240716","1783","1440","1440",美林,3,10,7,-1,3.47
"20240716","1783","0039003800310045","9800",元大-發財,5,0,5,1,2.48
"20240716","1783","0039003100330059","9100",群益金鼎-館前,0,5,5,-1,2.48
"20240716","1783","0038003100350041","8150",台新-高雄,4,0,4,1,1.98
"20240716","1783","7790","7790",國票證券,0,5,5,-1,2.48
"20240716","1783","9202","9200",凱基-中港,4,0,4,1,1.98
"20240716","1783","9608","9600",富邦-台東,0,4,4,-1,1.98
"20240716","1783","003900380039004c","9800",元大-成功,5,1,4,1,1.98
"20240716","1783","1470","1470",台灣摩根士丹利,0,4,4,-1,1.98
"20240716","1783","0031003000320045","1020",合庫-桃園,3,0,3,1,1.49
"20240716","1783","9138","9100",群益金鼎-中港,0,4,4,-1,1.98
"20240716","1783","5862","5860",盈溢-楠梓,3,0,3,1,1.49
"20240716","1783","9654","9600",富邦-永和,0,4,4,-1,1.98
"20240716","1783","003500390032006c","5920",元富-大裕,3,0,3,1,1.49
"20240716","1783","9235","9200",凱基-永華,0,3,3,-1,1.49
"20240716","1783","0035003900320071","5920",元富-屏東,3,0,3,1,1.49
"20240716","1783","0039004100390071","9A00",永豐金-潮州,0,3,3,-1,1.49
"20240717","1783","8561","8560",新光-台中,7,0,7,1,5.60
"20240717","1783","9692","9600",富邦-嘉義,1,10,9,-1,7.20
"20240717","1783","003900410039004a","9A00",永豐金-板新,6,0,6,1,4.80
"20240717","1783","9138","9100",群益金鼎-中港,0,7,7,-1,5.60
"20240717","1783","1650","1650",新加坡商瑞銀,6,1,5,1,4.00
"20240717","1783","9303","9300",華南永昌-高雄,0,6,6,-1,4.80
"20240717","1783","0039003800320043","9800",元大-六合,5,0,5,1,4.00
"20240717","1783","003900380036004b","9800",元大-基隆孝二,0,6,6,-1,4.80
"20240717","1783","0037003000300069","7000",兆豐-松德,4,0,4,1,3.20
"20240717","1783","0031003000320041","1020",合庫-新竹,0,5,5,-1,4.00
"20240717","1783","9831","9800",元大-四維,3,0,3,1,2.40
"20240717","1783","9874","9800",元大-雙和,0,5,5,-1,4.00
"20240717","1783","0039003800310058","9800",元大-新生,3,0,3,1,2.40
"20240717","1783","9101","9100",群益金鼎-敦南,0,4,4,-1,3.20
"20240717","1783","9852","9800",元大-永春,3,0,3,1,2.40
"20240717","1783","003900320031004a","9200",凱基-土城,0,4,4,-1,3.20
"20240717","1783","0039003800310079","9800",元大-善化,2,0,2,1,1.60
"20240717","1783","003900380033006a","9800",元大-仁愛,0,4,4,-1,3.20
"20240717","1783","0035003300380059","5380",第一金-中壢,2,0,2,1,1.60
"20240717","1783","0031003200360069","1260",宏遠-光隆,0,3,3,-1,2.40
"20240717","1783","0035003800350063","5850",統一-仁愛,2,0,2,1,1.60
"20240717","1783","1040","1040",臺銀,0,3,3,-1,2.40
"20240717","1783","0037003700390058","7790",國票-中和,2,0,2,1,1.60
"20240717","1783","6110","6110",台中銀,0,3,3,-1,2.40
"20240717","1783","9667","9600",富邦-台南,2,0,2,1,1.60
"20240717","1783","003700300030006b","7000",兆豐-員林,0,3,3,-1,2.40
"20240717","1783","9686","9600",富邦-宜蘭,2,0,2,1,1.60
"20240717","1783","1028","1020",合庫-彰化,0,2,2,-1,1.60
"20240718","1783","9893","9800",元大-大天母,60,0,60,1,5.23
"20240718","1783","8560","8560",新光,6,27,21,-1,1.83
"20240718","1783","9255","9200",凱基-和平,61,3,58,1,5.06
"20240718","1783","9831","9800",元大-四維,1,20,19,-1,1.66
"20240718","1783","0039003100380073","9100",群益金鼎-丹鳳,54,0,54,1,4.71
"20240718","1783","9138","9100",群益金鼎-中港,0,18,18,-1,1.57
"20240718","1783","1440","1440",美林,50,6,44,1,3.84
"20240718","1783","003900380031006e","9800",元大-旗山,0,16,16,-1,1.39
"20240718","1783","0039004100390068","9A00",永豐金-台南,26,4,22,1,1.92
"20240718","1783","0039003100380067","9100",群益金鼎-大甲,0,15,15,-1,1.31
"20240718","1783","0035003900320050","5920",元富-同大,21,1,20,1,1.74
"20240718","1783","9215","9200",凱基-高美館,0,15,15,-1,1.31
"20240718","1783","003500390032004c","5920",元富-中壢,21,1,20,1,1.74
"20240718","1783","8150","8150",台新證券,3,18,15,-1,1.31
"20240718","1783","9331","9300",華南永昌-鳳山,36,17,19,1,1.66
"20240718","1783","1560","1560",港商野村,0,14,14,-1,1.22
"20240718","1783","0039003600360046","9600",富邦-左營,15,1,14,1,1.22
"20240718","1783","8887","8880",國泰-忠孝,0,11,11,-1,0.96
"20240718","1783","0039003800390044","9800",元大-左營,13,0,13,1,1.13
"20240718","1783","0035003900320049","5920",元富-嘉義,1,11,10,-1,0.87
"20240718","1783","9658","9600",富邦-建國,13,1,12,1,1.05
"20240718","1783","003700300030005a","7000",兆豐-高雄,0,10,10,-1,0.87
"20240718","1783","9899","9800",元大-淡水,10,0,10,1,0.87
"20240718","1783","8561","8560",新光-台中,3,13,10,-1,0.87
"20240718","1783","0035003800350050","5850",統一-板橋,10,0,10,1,0.87
"20240718","1783","8585","8580",聯邦-三重,0,10,10,-1,0.87
"20240718","1783","0035003800350053","5850",統一-宜蘭,10,0,10,1,0.87
"20240718","1783","9101","9100",群益金鼎-敦南,0,10,10,-1,0.87
"20240719","1783","9875","9800",元大-土城永寧,35,0,35,1,1.51
"20240719","1783","9255","9200",凱基-和平,0,64,64,-1,2.76
"20240719","1783","0039004100390031","9A00",永豐金-松山,30,2,28,1,1.21
"20240719","1783","9893","9800",元大-大天母,0,62,62,-1,2.67
"20240719","1783","0035003900320050","5920",元富-同大,25,1,24,1,1.03
"20240719","1783","0039003100380073","9100",群益金鼎-丹鳳,0,54,54,-1,2.33
"20240719","1783","9278","9200",凱基-永康,25,2,23,1,0.99
"20240719","1783","1260","1260",宏遠證券,0,50,50,-1,2.16
"20240719","1783","9655","9600",富邦-板橋,22,0,22,1,0.95
"20240719","1783","0038003800380041","8880",國泰-館前,4,38,34,-1,1.47
"20240719","1783","003900380039005a","9800",元大-小港,20,0,20,1,0.86
"20240719","1783","7001","7000",兆豐-嘉義,0,30,30,-1,1.29
"20240719","1783","8562","8560",新光-高雄,24,5,19,1,0.82
"20240719","1783","003900380039004c","9800",元大-成功,3,29,26,-1,1.12
"20240719","1783","9324","9300",華南永昌-岡山,18,0,18,1,0.78
"20240719","1783","1480","1480",美商高盛,0,22,22,-1,0.95
"20240719","1783","7005","7000",兆豐-台中港,29,11,18,1,0.78
"20240719","1783","1560","1560",港商野村,2,22,20,-1,0.86
"20240719","1783","0039003600350055","9600",富邦-彰化,17,0,17,1,0.73
"20240719","1783","9331","9300",華南永昌-鳳山,22,41,19,-1,0.82
"20240719","1783","003900380039006a","9800",元大-樹林,19,2,17,1,0.73
"20240719","1783","0039003600360046","9600",富邦-左營,0,18,18,-1,0.78
"20240719","1783","0039003800300068","9800",元大-台北,22,5,17,1,0.73
"20240719","1783","0039004100390068","9A00",永豐金-台南,14,32,18,-1,0.78
"20240719","1783","0039003100330044","9100",群益金鼎-潭子,16,1,15,1,0.65
"20240719","1783","003700300030004a","7000",兆豐-公益,0,17,17,-1,0.73
"20240719","1783","9654","9600",富邦-永和,17,3,14,1,0.60
"20240719","1783","5264","5260",美好-高雄,0,16,16,-1,0.69
"20240722","1783","1022","1020",合庫-台南,12,0,12,1,2.58
"20240722","1783","9268","9200",凱基-台北,9,30,21,-1,4.52
"20240722","1783","1440","1440",美林,23,12,11,1,2.37
"20240722","1783","9856","9800",元大-花蓮,1,21,20,-1,4.30
"20240722","1783","0038003100350041","8150",台新-高雄,11,0,11,1,2.37
"20240722","1783","0037003000300062","7000",兆豐-中壢,1,15,14,-1,3.01
"20240722","1783","003500390032005a","5920",元富-安南,10,0,10,1,2.15
"20240722","1783","9899","9800",元大-淡水,6,20,14,-1,3.01
"20240722","1783","9257","9200",凱基-林口,10,0,10,1,2.15
"20240722","1783","8560","8560",新光,4,17,13,-1,2.80
"20240722","1783","0039003800320041","9800",元大-羅東,10,0,10,1,2.15
"20240722","1783","1650","1650",新加坡商瑞銀,18,28,10,-1,2.15
"20240722","1783","0039004100390057","9A00",永豐金-市政,10,2,8,1,1.72
"20240722","1783","003900310038004c","9100",群益金鼎-建成,0,10,10,-1,2.15
"20240722","1783","0039003800350043","9800",元大-鳳中,7,0,7,1,1.51
"20240722","1783","0039004100300030","9A00",永豐金證券,1,11,10,-1,2.15
"20240722","1783","9136","9100",群益金鼎-西松,7,0,7,1,1.51
"20240722","1783","0039003800310051","9800",元大-太平,0,9,9,-1,1.94
"20240722","1783","5266","5260",美好-中壢,6,0,6,1,1.29
"20240722","1783","0039003100380067","9100",群益金鼎-大甲,0,8,8,-1,1.72
"20240722","1783","9623","9600",富邦-台北,6,0,6,1,1.29
"20240722","1783","0039003800390050","9800",元大-敦南,0,8,8,-1,1.72
"20240722","1783","9655","9600",富邦-板橋,9,3,6,1,1.29
"20240722","1783","1480","1480",美商高盛,6,12,6,-1,1.29
"20240722","1783","9800","9800",元大證券,9,4,5,1,1.08
"20240722","1783","9658","9600",富邦-建國,0,5,5,-1,1.08
"20240722","1783","6381","6380",光和-溪湖,5,0,5,1,1.08
"20240722","1783","8520","8520",中農,0,5,5,-1,1.08
"20240723","1783","6950","6950",福勝,10,0,10,1,4.41
"20240723","1783","0038003100350041","8150",台新-高雄,1,10,9,-1,3.96
"20240723","1783","0037003000300069","7000",兆豐-松德,10,0,10,1,4.41
"20240723","1783","0039003800390042","9800",元大-台中中港,0,9,9,-1,3.96
"20240723","1783","9647","9600",富邦-新竹,7,0,7,1,3.08
"20240723","1783","003900380031005a","9800",元大-潮州,0,8,8,-1,3.52
"20240723","1783","9332","9300",華南永昌-楠梓,6,0,6,1,2.64
"20240723","1783","0036003300380044","6380",光和-高雄,0,6,6,-1,2.64
"20240723","1783","8156","8150",台新-三民,6,1,5,1,2.20
"20240723","1783","8440","8440",摩根大通,1,7,6,-1,2.64
"20240723","1783","8849","8840",玉山-景美,5,0,5,1,2.20
"20240723","1783","8560","8560",新光,1,7,6,-1,2.64
"20240723","1783","0039003100330049","9100",群益金鼎-萬華,5,0,5,1,2.20
"20240723","1783","0039004100300030","9A00",永豐金證券,0,6,6,-1,2.64
"20240723","1783","9256","9200",凱基-南崁,5,0,5,1,2.20
"20240723","1783","9899","9800",元大-淡水,4,10,6,-1,2.64
"20240723","1783","9623","9600",富邦-台北,5,0,5,1,2.20
"20240723","1783","1020","1020",合庫證券,0,6,6,-1,2.64
"20240723","1783","0039003800310045","9800",元大-發財,5,0,5,1,2.20
"20240723","1783","1650","1650",新加坡商瑞銀,6,11,5,-1,2.20
"20240723","1783","0039004100390057","9A00",永豐金-市政,5,0,5,1,2.20
"20240723","1783","9268","9200",凱基-台北,7,12,5,-1,2.20
"20240723","1783","0037003000300067","7000",兆豐-南門,4,0,4,1,1.76
"20240723","1783","9333","9300",華南永昌-長虹,0,5,5,-1,2.20
"20240723","1783","9814","9800",元大-大益,4,0,4,1,1.76
"20240723","1783","0039003600320041","9600",富邦-南港,0,5,5,-1,2.20
"20240723","1783","9831","9800",元大-四維,5,1,4,1,1.76
"20240723","1783","0039004100380039","9A00",永豐金-敦北,0,5,5,-1,2.20
"20240726","1783","0039003600360046","9600",富邦-左營,21,0,21,1,6.84
"20240726","1783","7005","7000",兆豐-台中港,0,20,20,-1,6.51
"20240726","1783","9659","9600",富邦-高雄,20,0,20,1,6.51
"20240726","1783","9324","9300",華南永昌-岡山,0,18,18,-1,5.86
"20240726","1783","9898","9800",元大-新莊,15,0,15,1,4.89
"20240726","1783","1022","1020",合庫-台南,0,12,12,-1,3.91
"20240726","1783","0035003900320062","5920",元富-板橋,7,0,7,1,2.28
"20240726","1783","0031003200360044","1260",宏遠-台南,0,10,10,-1,3.26
"20240726","1783","8849","8840",玉山-景美,7,0,7,1,2.28
"20240726","1783","9134","9100",群益金鼎-開元,0,10,10,-1,3.26
"20240726","1783","003900360031005a","9600",富邦-永康,6,0,6,1,1.95
"20240726","1783","0039003800310051","9800",元大-太平,0,10,10,-1,3.26
"20240726","1783","9623","9600",富邦-台北,10,4,6,1,1.95
"20240726","1783","0039004100300030","9A00",永豐金證券,2,11,9,-1,2.93
"20240726","1783","6950","6950",福勝,5,0,5,1,1.63
"20240726","1783","0039003200300048","9200",凱基-基隆,0,8,8,-1,2.61
"20240726","1783","7032","7030",致和-佳里,5,0,5,1,1.63
"20240726","1783","0039003600320045","9600",富邦-樹林,0,8,8,-1,2.61
"20240726","1783","8886","8880",國泰-新莊,7,2,5,1,1.63
"20240726","1783","9800","9800",元大證券,6,12,6,-1,1.95
"20240726","1783","0039003100380067","9100",群益金鼎-大甲,5,0,5,1,1.63
"20240726","1783","8560","8560",新光,4,10,6,-1,1.95
"20240726","1783","9268","9200",凱基-台北,7,2,5,1,1.63
"20240726","1783","9888","9800",元大-鑫永和,0,6,6,-1,1.95
"20240726","1783","003900360031004b","9600",富邦-七賢,5,0,5,1,1.63
"20240726","1783","8151","8150",台新-建北,0,5,5,-1,1.63
"20240726","1783","0039003600320041","9600",富邦-南港,5,0,5,1,1.63
"20240726","1783","9256","9200",凱基-南崁,0,5,5,-1,1.63
"20240729","1783","0039003800310069","9800",元大-西螺,16,0,16,1,4.64
"20240729","1783","9303","9300",華南永昌-高雄,0,13,13,-1,3.77
"20240729","1783","0039004100300030","9A00",永豐金證券,9,0,9,1,2.61
"20240729","1783","9268","9200",凱基-台北,16,28,12,-1,3.48
"20240729","1783","003700300030006a","7000",兆豐-大安,8,0,8,1,2.32
"20240729","1783","9898","9800",元大-新莊,0,11,11,-1,3.19
"20240729","1783","8561","8560",新光-台中,8,0,8,1,2.32
"20240729","1783","8711","8710",陽信-石牌,0,10,10,-1,2.90
"20240729","1783","8840","8840",玉山證券,8,0,8,1,2.32
"20240729","1783","0039004100390057","9A00",永豐金-市政,0,10,10,-1,2.90
"20240729","1783","0038003800380041","8880",國泰-館前,9,1,8,1,2.32
"20240729","1783","0039004100390043","9A00",永豐金-員林,0,7,7,-1,2.03
"20240729","1783","9623","9600",富邦-台北,8,0,8,1,2.32
"20240729","1783","1560","1560",港商野村,0,6,6,-1,1.74
"20240729","1783","0039003100380067","9100",群益金鼎-大甲,9,2,7,1,2.03
"20240729","1783","0039003100330044","9100",群益金鼎-潭子,0,6,6,-1,1.74
"20240729","1783","0036003300380044","6380",光和-高雄,5,0,5,1,1.45
"20240729","1783","9834","9800",元大-中壢,2,8,6,-1,1.74
"20240729","1783","0037003000300067","7000",兆豐-南門,7,2,5,1,1.45
"20240729","1783","9874","9800",元大-雙和,0,6,6,-1,1.74
"20240729","1783","9831","9800",元大-四維,5,0,5,1,1.45
"20240729","1783","5266","5260",美好-中壢,0,5,5,-1,1.45
"20240729","1783","9676","9600",富邦-仁愛,4,0,4,1,1.16
"20240729","1783","0038003100350059","8150",台新-新營,0,5,5,-1,1.45
"20240729","1783","0035003800350052","5850",統一-汐止,4,0,4,1,1.16
"20240729","1783","0039004100380046","9A00",永豐金-敦南,0,5,5,-1,1.45
"20240729","1783","9211","9200",凱基-台南,4,0,4,1,1.16
"20240729","1783","0039004100390067","9A00",永豐金-內湖,0,5,5,-1,1.45
"20240730","1783","0038003800380041","8880",國泰-館前,21,0,21,1,9.91
"20240730","1783","003900310038004a","9100",群益金鼎-永和,0,20,20,-1,9.43
"20240730","1783","0035003900320050","5920",元富-同大,19,0,19,1,8.96
"20240730","1783","8560","8560",新光,4,18,14,-1,6.60
"20240730","1783","5854","5850",統一-城中,10,0,10,1,4.72
"20240730","1783","9186","9100",群益金鼎-新竹,0,12,12,-1,5.66
"20240730","1783","0038003400350052","8450",康和-石牌,10,0,10,1,4.72
"20240730","1783","0039004100300030","9A00",永豐金證券,1,9,8,-1,3.77
"20240730","1783","1440","1440",美林,17,8,9,1,4.25
"20240730","1783","0039003800390058","9800",元大-民生三民,0,6,6,-1,2.83
"20240730","1783","6912","6910",德信-中正,6,0,6,1,2.83
"20240730","1783","8561","8560",新光-台中,0,5,5,-1,2.36
"20240730","1783","9255","9200",凱基-和平,8,2,6,1,2.83
"20240730","1783","0039003100380045","9100",群益金鼎-南京,0,5,5,-1,2.36
"20240730","1783","0039003800320042","9800",元大-博愛,6,0,6,1,2.83
"20240730","1783","9647","9600",富邦-新竹,0,5,5,-1,2.36
"20240730","1783","0031003000320041","1020",合庫-新竹,3,0,3,1,1.42
"20240730","1783","0039003800300068","9800",元大-台北,0,5,5,-1,2.36
"20240730","1783","0035003300380043","5380",第一金-光復,3,0,3,1,1.42
"20240730","1783","8848","8840",玉山-嘉義,0,4,4,-1,1.89
"20240730","1783","1480","1480",美商高盛,2,0,2,1,0.94
"20240730","1783","1560","1560",港商野村,0,3,3,-1,1.42
"20240730","1783","1650","1650",新加坡商瑞銀,4,2,2,1,0.94
"20240730","1783","5856","5850",統一-台中,0,3,3,-1,1.42
"20240730","1783","003700300030004c","7000",兆豐-天母,2,0,2,1,0.94
"20240730","1783","0039003200310047","9200",凱基-五股,0,3,3,-1,1.42
"20240730","1783","0037003700390044","7790",國票-台南,2,0,2,1,0.94
"20240730","1783","0039003800390065","9800",元大-中和,0,3,3,-1,1.42
"20240731","1783","5269","5260",美好-台中,8,0,8,1,7.08
"20240731","1783","8562","8560",新光-高雄,0,19,19,-1,16.81
"20240731","1783","9655","9600",富邦-板橋,4,0,4,1,3.54
"20240731","1783","0039004100380039","9A00",永豐金-敦北,0,6,6,-1,5.31
"20240731","1783","9858","9800",元大-龍潭,4,0,4,1,3.54
"20240731","1783","0039004100390031","9A00",永豐金-松山,0,5,5,-1,4.42
"20240731","1783","9136","9100",群益金鼎-西松,3,0,3,1,2.65
"20240731","1783","003500390032005a","5920",元富-安南,0,3,3,-1,2.65
"20240731","1783","9278","9200",凱基-永康,3,0,3,1,2.65
"20240731","1783","0039003800310049","9800",元大-天母,0,3,3,-1,2.65
"20240731","1783","0039003600350055","9600",富邦-彰化,3,0,3,1,2.65
"20240731","1783","7790","7790",國票證券,0,2,2,-1,1.77
"20240731","1783","0039003800310046","9800",元大-福營,3,0,3,1,2.65
"20240731","1783","0037003000300067","7000",兆豐-南門,1,3,2,-1,1.77
"20240731","1783","9872","9800",元大-復北,3,0,3,1,2.65
"20240731","1783","8561","8560",新光-台中,1,3,2,-1,1.77
"20240731","1783","6110","6110",台中銀,2,0,2,1,1.77
"20240731","1783","003900310038004c","9100",群益金鼎-建成,0,2,2,-1,1.77
"20240731","1783","0035003900320057","5920",元富-吉利,2,0,2,1,1.77
"20240731","1783","9239","9200",凱基-市政,0,2,2,-1,1.77
"20240731","1783","5961","5960",日茂-埔里,2,0,2,1,1.77
"20240731","1783","9623","9600",富邦-台北,0,2,2,-1,1.77
"20240731","1783","0037003000300052","7000",兆豐-小港,2,0,2,1,1.77
"20240731","1783","9667","9600",富邦-台南,0,2,2,-1,1.77
"20240731","1783","8156","8150",台新-三民,3,1,2,1,1.77
"20240731","1783","5385","5380",第一金-桃園,0,1,1,-1,0.88
"20240731","1783","8440","8440",摩根大通,2,0,2,1,1.77
"20240731","1783","5853","5850",統一-中壢,0,1,1,-1,0.88
"20240801","1783","1440","1440",美林,14,0,14,1,8.09
"20240801","1783","003500390032005a","5920",元富-安南,0,10,10,-1,5.78
"20240801","1783","003700300030004c","7000",兆豐-天母,13,0,13,1,7.51
"20240801","1783","5269","5260",美好-台中,0,8,8,-1,4.62
"20240801","1783","0038003800380041","8880",國泰-館前,11,0,11,1,6.36
"20240801","1783","0035003900320050","5920",元富-同大,0,7,7,-1,4.05
"20240801","1783","5854","5850",統一-城中,10,0,10,1,5.78
"20240801","1783","9655","9600",富邦-板橋,0,6,6,-1,3.47
"20240801","1783","9871","9800",元大-忠孝,7,0,7,1,4.05
"20240801","1783","003900320030005a","9200",凱基-台東,0,5,5,-1,2.89
"20240801","1783","003900380033004b","9800",元大-學甲,7,1,6,1,3.47
"20240801","1783","5856","5850",統一-台中,0,4,4,-1,2.31
"20240801","1783","1650","1650",新加坡商瑞銀,11,6,5,1,2.89
"20240801","1783","9235","9200",凱基-永華,0,4,4,-1,2.31
"20240801","1783","0039004100390055","9A00",永豐金-中正,5,0,5,1,2.89
"20240801","1783","0037003000300043","7000",兆豐-來福,2,5,3,-1,1.73
"20240801","1783","0039004100390057","9A00",永豐金-市政,5,0,5,1,2.89
"20240801","1783","0035003300380049","5380",第一金-頭份,0,3,3,-1,1.73
"20240801","1783","0037003000300067","7000",兆豐-南門,4,0,4,1,2.31
"20240801","1783","0035003300380050","5380",第一金-路竹,0,3,3,-1,1.73
"20240801","1783","1480","1480",美商高盛,3,0,3,1,1.73
"20240801","1783","0039003800300068","9800",元大-台北,0,3,3,-1,1.73
"20240801","1783","7034","7030",致和-金華,3,0,3,1,1.73
"20240801","1783","1040","1040",臺銀,0,2,2,-1,1.16
"20240801","1783","9858","9800",元大-龍潭,2,0,2,1,1.16
"20240801","1783","5961","5960",日茂-埔里,0,2,2,-1,1.16
"20240801","1783","1590","1590",花旗環球,2,0,2,1,1.16
"20240801","1783","7006","7000",兆豐-台南,0,2,2,-1,1.16
"20240802","1783","0038003800380041","8880",國泰-館前,18,0,18,1,6.64
"20240802","1783","1650","1650",新加坡商瑞銀,3,15,12,-1,4.43
"20240802","1783","0039003800320042","9800",元大-博愛,11,1,10,1,3.69
"20240802","1783","0039004100360031","9A00",永豐金-鳳山,0,10,10,-1,3.69
"20240802","1783","9278","9200",凱基-永康,9,0,9,1,3.32
"20240802","1783","8440","8440",摩根大通,2,11,9,-1,3.32
"20240802","1783","6912","6910",德信-中正,6,0,6,1,2.21
"20240802","1783","003900360031004d","9600",富邦-木柵,0,8,8,-1,2.95
"20240802","1783","0038003400350045","8450",康和-澎湖,6,0,6,1,2.21
"20240802","1783","1440","1440",美林,2,8,6,-1,2.21
"20240802","1783","9814","9800",元大-大益,6,0,6,1,2.21
"20240802","1783","0039004100390057","9A00",永豐金-市政,0,5,5,-1,1.85
"20240802","1783","5269","5260",美好-台中,5,0,5,1,1.85
"20240802","1783","1560","1560",港商野村,0,4,4,-1,1.48
"20240802","1783","0035003800350059","5850",統一-土城,5,0,5,1,1.85
"20240802","1783","8157","8150",台新-左楠,0,4,4,-1,1.48
"20240802","1783","0031003100310047","1110",台灣企銀-埔墘,4,0,4,1,1.48
"20240802","1783","003900380039004a","9800",元大-彰化民生,0,4,4,-1,1.48
"20240802","1783","0039003100380047","9100",群益金鼎-新莊,4,0,4,1,1.48
"20240802","1783","0035003900320062","5920",元富-板橋,1,4,3,-1,1.11
"20240802","1783","9884","9800",元大-斗信,4,0,4,1,1.48
"20240802","1783","0037003000300043","7000",兆豐-來福,0,3,3,-1,1.11
"20240802","1783","0036003300380044","6380",光和-高雄,3,0,3,1,1.11
"20240802","1783","0035003300380057","5380",第一金-華江,0,2,2,-1,0.74
"20240802","1783","9136","9100",群益金鼎-西松,3,0,3,1,1.11
"20240802","1783","003700300030004c","7000",兆豐-天母,0,2,2,-1,0.74
"20240802","1783","0039003100380057","9100",群益金鼎-忠孝,3,0,3,1,1.11
"20240802","1783","003700300030005a","7000",兆豐-高雄,0,2,2,-1,0.74
"20240805","1783","8886","8880",國泰-新莊,18,0,18,1,4.10
"20240805","1783","0038003400350042","8450",康和-永和,0,30,30,-1,6.83
"20240805","1783","003900380031006e","9800",元大-旗山,12,1,11,1,2.51
"20240805","1783","0038003400350055","8450",康和-台北,1,12,11,-1,2.51
"20240805","1783","5321","5320",高橋-龍潭,10,0,10,1,2.28
"20240805","1783","003700300030006a","7000",兆豐-大安,0,10,10,-1,2.28
"20240805","1783","0037003000300072","7000",兆豐-寶成,10,0,10,1,2.28
"20240805","1783","0038003400350052","8450",康和-石牌,0,10,10,-1,2.28
"20240805","1783","7032","7030",致和-佳里,10,0,10,1,2.28
"20240805","1783","8885","8880",國泰-桃園,0,10,10,-1,2.28
"20240805","1783","9278","9200",凱基-永康,10,0,10,1,2.28
"20240805","1783","0039004100390057","9A00",永豐金-市政,1,10,9,-1,2.05
"20240805","1783","0039003800320042","9800",元大-博愛,12,2,10,1,2.28
"20240805","1783","0038003800340042","8840",玉山-台中,0,8,8,-1,1.82
"20240805","1783","0039003800390043","9800",元大-板橋,10,0,10,1,2.28
"20240805","1783","0038003100350059","8150",台新-新營,3,11,8,-1,1.82
"20240805","1783","9801","9800",元大-城東,8,0,8,1,1.82
"20240805","1783","8440","8440",摩根大通,0,8,8,-1,1.82
"20240805","1783","1560","1560",港商野村,15,9,6,1,1.37
"20240805","1783","003900380033004b","9800",元大-學甲,0,8,8,-1,1.82
"20240805","1783","9252","9200",凱基-嘉義,6,0,6,1,1.37
"20240805","1783","0039004100300030","9A00",永豐金證券,3,10,7,-1,1.59
"20240805","1783","0039004100360031","9A00",永豐金-鳳山,6,0,6,1,1.37
"20240805","1783","8156","8150",台新-三民,0,6,6,-1,1.37
"20240805","1783","9859","9800",元大-新竹經國,5,0,5,1,1.14
"20240805","1783","9200","9200",凱基,0,6,6,-1,1.37
"20240805","1783","0031003100310047","1110",台灣企銀-埔墘,5,0,5,1,1.14
"20240805","1783","9834","9800",元大-中壢,3,9,6,-1,1.37
"20240806","1783","1440","1440",美林,25,7,18,1,4.93
"20240806","1783","9300","9300",華南永昌,0,21,21,-1,5.75
"20240806","1783","1650","1650",新加坡商瑞銀,33,18,15,1,4.11
"20240806","1783","003700300030004c","7000",兆豐-天母,0,18,18,-1,4.93
"20240806","1783","8880","8880",國泰證券,14,0,14,1,3.84
"20240806","1783","8885","8880",國泰-桃園,0,15,15,-1,4.11
"20240806","1783","0039004100300030","9A00",永豐金證券,15,3,12,1,3.29
"20240806","1783","0039004100390059","9A00",永豐金-板盛,0,10,10,-1,2.74
"20240806","1783","8440","8440",摩根大通,14,2,12,1,3.29
"20240806","1783","0038003100350041","8150",台新-高雄,0,10,10,-1,2.74
"20240806","1783","1480","1480",美商高盛,11,0,11,1,3.01
"20240806","1783","9655","9600",富邦-板橋,4,13,9,-1,2.47
"20240806","1783","9268","9200",凱基-台北,19,10,9,1,2.47
"20240806","1783","0035003900320045","5920",元富-城中,0,8,8,-1,2.19
"20240806","1783","0037003000300067","7000",兆豐-南門,9,3,6,1,1.64
"20240806","1783","003900360031005a","9600",富邦-永康,0,8,8,-1,2.19
"20240806","1783","8560","8560",新光,20,15,5,1,1.37
"20240806","1783","0039003800310047","9800",元大-彰化,0,8,8,-1,2.19
"20240806","1783","0038003100350059","8150",台新-新營,5,0,5,1,1.37
"20240806","1783","9894","9800",元大-桃興,0,8,8,-1,2.19
"20240806","1783","9285","9200",凱基-中壢,5,0,5,1,1.37
"20240806","1783","0039003800330055","9800",元大-頭份,0,6,6,-1,1.64
"20240806","1783","8883","8880",國泰-松江,5,1,4,1,1.10
"20240806","1783","8882","8880",國泰-台中,0,5,5,-1,1.37
"20240806","1783","0039003100330044","9100",群益金鼎-潭子,4,0,4,1,1.10
"20240806","1783","0031003200360051","1260",宏遠-高雄,0,5,5,-1,1.37
"20240806","1783","0039003800310079","9800",元大-善化,4,0,4,1,1.10
"20240806","1783","1560","1560",港商野村,4,9,5,-1,1.37
"20240807","1783","1650","1650",新加坡商瑞銀,47,12,35,1,12.59
"20240807","1783","9655","9600",富邦-板橋,0,15,15,-1,5.40
"20240807","1783","1440","1440",美林,27,1,26,1,9.35
"20240807","1783","1029","1020",合庫-鳳山,0,10,10,-1,3.60
"20240807","1783","8440","8440",摩根大通,25,1,24,1,8.63
"20240807","1783","003900380039004a","9800",元大-彰化民生,0,10,10,-1,3.60
"20240807","1783","9186","9100",群益金鼎-新竹,12,0,12,1,4.32
"20240807","1783","0038003800380041","8880",國泰-館前,0,9,9,-1,3.24
"20240807","1783","0035003300380050","5380",第一金-路竹,10,0,10,1,3.60
"20240807","1783","0039004100300030","9A00",永豐金證券,0,8,8,-1,2.88
"20240807","1783","1470","1470",台灣摩根士丹利,6,0,6,1,2.16
"20240807","1783","0039004100390042","9A00",永豐金-中和,0,7,7,-1,2.52
"20240807","1783","1560","1560",港商野村,7,2,5,1,1.80
"20240807","1783","8883","8880",國泰-松江,0,6,6,-1,2.16
"20240807","1783","1480","1480",美商高盛,6,1,5,1,1.80
"20240807","1783","5854","5850",統一-城中,0,5,5,-1,1.80
"20240807","1783","9647","9600",富邦-新竹,5,0,5,1,1.80
"20240807","1783","8380","8380",安泰,0,5,5,-1,1.80
"20240807","1783","003900380039006a","9800",元大-樹林,5,0,5,1,1.80
"20240807","1783","003900380031006e","9800",元大-旗山,0,5,5,-1,1.80
"20240807","1783","9268","9200",凱基-台北,23,19,4,1,1.44
"20240807","1783","003700300030004c","7000",兆豐-天母,0,4,4,-1,1.44
"20240807","1783","003900380039004e","9800",元大-內湖,4,0,4,1,1.44
"20240807","1783","9334","9300",華南永昌-世貿,0,4,4,-1,1.44
"20240807","1783","5856","5850",統一-台中,5,2,3,1,1.08
"20240807","1783","003900380031006d","9800",元大-前金,0,4,4,-1,1.44
"20240807","1783","9654","9600",富邦-永和,3,0,3,1,1.08
"20240807","1783","0039004100360031","9A00",永豐金-鳳山,0,4,4,-1,1.44
"20240808","1783","0035003800350045","5850",統一-新營,10,0,10,1,5.68
"20240808","1783","0037003000300067","7000",兆豐-南門,0,10,10,-1,5.68
"20240808","1783","1440","1440",美林,9,0,9,1,5.11
"20240808","1783","9235","9200",凱基-永華,0,6,6,-1,3.41
"20240808","1783","1650","1650",新加坡商瑞銀,14,5,9,1,5.11
"20240808","1783","0039004100300030","9A00",永豐金證券,0,6,6,-1,3.41
"20240808","1783","1590","1590",花旗環球,9,1,8,1,4.55
"20240808","1783","5269","5260",美好-台中,0,5,5,-1,2.84
"20240808","1783","0035003900320077","5920",元富-佳里,5,0,5,1,2.84
"20240808","1783","5050","5050",大展,0,5,5,-1,2.84
"20240808","1783","0038003400350045","8450",康和-澎湖,4,0,4,1,2.27
"20240808","1783","0035003300380049","5380",第一金-頭份,0,5,5,-1,2.84
"20240808","1783","1480","1480",美商高盛,6,3,3,1,1.70
"20240808","1783","5854","5850",統一-城中,0,5,5,-1,2.84
"20240808","1783","6167","6160",中國信託-松江,3,0,3,1,1.70
"20240808","1783","5856","5850",統一-台中,1,4,3,-1,1.70
"20240808","1783","1560","1560",港商野村,2,0,2,1,1.14
"20240808","1783","0035003900320072","5920",元富-城東,0,3,3,-1,1.70
"20240808","1783","1023","1020",合庫-高雄,2,0,2,1,1.14
"20240808","1783","9814","9800",元大-大益,0,3,3,-1,1.70
"20240808","1783","5858","5850",統一-嘉義,2,0,2,1,1.14
"20240808","1783","0039004100390071","9A00",永豐金-潮州,0,3,3,-1,1.70
"20240808","1783","0038003800340043","8840",玉山-南京東路,1,0,1,1,0.57
"20240808","1783","0039004100380046","9A00",永豐金-敦南,0,2,2,-1,1.14
"20240808","1783","1470","1470",台灣摩根士丹利,1,0,1,1,0.57
"20240808","1783","1035","1030",土銀-新竹,0,2,2,-1,1.14
"20240808","1783","7750","7750",北城證券,1,0,1,1,0.57
"20240808","1783","5927","5920",元富-林園,3,5,2,-1,1.14
"20240809","1783","1560","1560",港商野村,10,3,7,1,4.61
"20240809","1783","1650","1650",新加坡商瑞銀,0,10,10,-1,6.58
"20240809","1783","0039004100300030","9A00",永豐金證券,4,0,4,1,2.63
"20240809","1783","9666","9600",富邦-南屯,0,8,8,-1,5.26
"20240809","1783","0035003300380057","5380",第一金-華江,3,0,3,1,1.97
"20240809","1783","0039003100380067","9100",群益金鼎-大甲,0,5,5,-1,3.29
"20240809","1783","1590","1590",花旗環球,3,0,3,1,1.97
"20240809","1783","003900380039006a","9800",元大-樹林,0,5,5,-1,3.29
"20240809","1783","0031003000320045","1020",合庫-桃園,3,0,3,1,1.97
"20240809","1783","003900380039004e","9800",元大-內湖,0,4,4,-1,2.63
"20240809","1783","8440","8440",摩根大通,6,3,3,1,1.97
"20240809","1783","9800","9800",元大證券,0,4,4,-1,2.63
"20240809","1783","0035003900320061","5920",元富-松德,3,0,3,1,1.97
"20240809","1783","0039003800390067","9800",元大-嘉義,0,4,4,-1,2.63
"20240809","1783","8156","8150",台新-三民,2,0,2,1,1.32
"20240809","1783","9834","9800",元大-中壢,0,3,3,-1,1.97
"20240809","1783","0039004100390059","9A00",永豐金-板盛,2,0,2,1,1.32
"20240809","1783","8843","8840",玉山-高雄,0,3,3,-1,1.97
"20240809","1783","9326","9300",華南永昌-南京,1,0,1,1,0.66
"20240809","1783","003800380034004d","8840",玉山-數位,0,3,3,-1,1.97
"20240809","1783","0031003200360055","1260",宏遠-館前,1,0,1,1,0.66
"20240809","1783","9655","9600",富邦-板橋,0,3,3,-1,1.97
"20240809","1783","1470","1470",台灣摩根士丹利,1,0,1,1,0.66
"20240809","1783","9871","9800",元大-忠孝,0,3,3,-1,1.97
"20240809","1783","0035003800350044","5850",統一-新台中,1,0,1,1,0.66
"20240809","1783","0031003000340043","1040",臺銀-高雄,0,2,2,-1,1.32
"20240809","1783","7007","7000",兆豐-竹北,1,0,1,1,0.66
"20240809","1783","0039004100390031","9A00",永豐金-松山,0,2,2,-1,1.32
"20240812","1783","0035003300380057","5380",第一金-華江,9,0,9,1,2.91
"20240812","1783","1111","1110",台灣企銀-台中,0,22,22,-1,7.12
"20240812","1783","8440","8440",摩根大通,13,4,9,1,2.91
"20240812","1783","9898","9800",元大-新莊,0,17,17,-1,5.50
"20240812","1783","1440","1440",美林,9,3,6,1,1.94
"20240812","1783","9831","9800",元大-四維,1,15,14,-1,4.53
"20240812","1783","8150","8150",台新證券,6,0,6,1,1.94
"20240812","1783","9254","9200",凱基-科園,0,10,10,-1,3.24
"20240812","1783","003800380038004b","8880",國泰-板橋,5,0,5,1,1.62
"20240812","1783","1560","1560",港商野村,0,7,7,-1,2.27
"20240812","1783","9235","9200",凱基-永華,5,0,5,1,1.62
"20240812","1783","0039004100390031","9A00",永豐金-松山,0,7,7,-1,2.27
"20240812","1783","003700370039005a","7790",國票-安和,4,0,4,1,1.29
"20240812","1783","0039003800350043","9800",元大-鳳中,0,6,6,-1,1.94
"20240812","1783","8156","8150",台新-三民,4,0,4,1,1.29
"20240812","1783","0035003900320057","5920",元富-吉利,0,6,6,-1,1.94
"20240812","1783","0039004100300030","9A00",永豐金證券,4,0,4,1,1.29
"20240812","1783","5321","5320",高橋-龍潭,0,5,5,-1,1.62
"20240812","1783","0035003900320050","5920",元富-同大,4,1,3,1,0.97
"20240812","1783","1480","1480",美商高盛,0,5,5,-1,1.62
"20240812","1783","8560","8560",新光,3,1,2,1,0.65
"20240812","1783","0035003800350059","5850",統一-土城,0,5,5,-1,1.62
"20240812","1783","0039003100330044","9100",群益金鼎-潭子,2,0,2,1,0.65
"20240812","1783","0036003000310064","6010",(牛牛牛)亞-鑫豐,0,4,4,-1,1.29
"20240812","1783","9889","9800",元大-員林,2,0,2,1,0.65
"20240812","1783","0037003000300067","7000",兆豐-南門,2,6,4,-1,1.29
"20240812","1783","9812","9800",元大-台中,1,0,1,1,0.32
"20240812","1783","0039003100380067","9100",群益金鼎-大甲,0,4,4,-1,1.29
"20240813","1783","8150","8150",台新證券,15,0,15,1,10.95
"20240813","1783","0039003800390045","9800",元大-草屯,0,10,10,-1,7.30
"20240813","1783","8561","8560",新光-台中,3,0,3,1,2.19
"20240813","1783","8156","8150",台新-三民,0,9,9,-1,6.57
"20240813","1783","0039003600310050","9600",富邦-和美,3,0,3,1,2.19
"20240813","1783","0039004100390059","9A00",永豐金-板盛,0,8,8,-1,5.84
"20240813","1783","1470","1470",台灣摩根士丹利,2,0,2,1,1.46
"20240813","1783","9831","9800",元大-四維,0,7,7,-1,5.11
"20240813","1783","5855","5850",統一-台南,1,0,1,1,0.73
"20240813","1783","9136","9100",群益金鼎-西松,0,4,4,-1,2.92
"20240813","1783","8880","8880",國泰證券,1,0,1,1,0.73
"20240813","1783","1560","1560",港商野村,0,3,3,-1,2.19
"20240813","1783","8886","8880",國泰-新莊,1,0,1,1,0.73
"20240813","1783","0037003000300067","7000",兆豐-南門,1,4,3,-1,2.19
"20240813","1783","0039004100390043","9A00",永豐金-員林,1,0,1,1,0.73
"20240813","1783","0039003600320052","9600",富邦-園區,0,2,2,-1,1.46
"20240813","1783","0035003900320061","5920",元富-松德,1,0,1,1,0.73
"20240813","1783","0035003300380057","5380",第一金-華江,0,2,2,-1,1.46
"20240813","1783","0038003400350044","8450",康和-板橋,0,0,0,1,0.00
"20240813","1783","5384","5380",第一金-台南,0,2,2,-1,1.46
"20240813","1783","7790","7790",國票證券,0,0,0,1,0.00
"20240813","1783","7791","7790",國票-台東,0,2,2,-1,1.46
"20240813","1783","8847","8840",玉山-台南,0,0,0,1,0.00
"20240813","1783","8560","8560",新光,0,2,2,-1,1.46
"20240813","1783","0038003100350041","8150",台新-高雄,0,0,0,1,0.00
"20240813","1783","0039003100330044","9100",群益金鼎-潭子,0,2,2,-1,1.46
"20240813","1783","6464","6460",大昌-新店,0,0,0,1,0.00
"20240813","1783","9281","9200",凱基-斗六,0,2,2,-1,1.46
"20240814","1783","0035003900320057","5920",元富-吉利,27,0,27,1,16.98
"20240814","1783","6210","6210",新百王,0,10,10,-1,6.29
"20240814","1783","8150","8150",台新證券,20,0,20,1,12.58
"20240814","1783","9801","9800",元大-城東,0,8,8,-1,5.03
"20240814","1783","9268","9200",凱基-台北,19,8,11,1,6.92
"20240814","1783","8848","8840",玉山-嘉義,0,7,7,-1,4.40
"20240814","1783","1650","1650",新加坡商瑞銀,17,13,4,1,2.52
"20240814","1783","9278","9200",凱基-永康,0,6,6,-1,3.77
"20240814","1783","1560","1560",港商野村,3,0,3,1,1.89
"20240814","1783","003500390032006c","5920",元富-大裕,0,5,5,-1,3.14
"20240814","1783","9108","9100",群益金鼎-海山,2,0,2,1,1.26
"20240814","1783","8840","8840",玉山證券,0,5,5,-1,3.14
"20240814","1783","0039004100300030","9A00",永豐金證券,6,4,2,1,1.26
"20240814","1783","003900310038004d","9100",群益金鼎-嘉義,0,5,5,-1,3.14
"20240814","1783","1470","1470",台灣摩根士丹利,1,0,1,1,0.63
"20240814","1783","0039003800390051","9800",元大-汐止,0,4,4,-1,2.52
"20240814","1783","1440","1440",美林,5,4,1,1,0.63
"20240814","1783","0035003900320048","5920",元富-信義,0,3,3,-1,1.89
"20240814","1783","1043","1040",臺銀-民權,1,0,1,1,0.63
"20240814","1783","0039003200310047","9200",凱基-五股,0,3,3,-1,1.89
"20240814","1783","8561","8560",新光-台中,1,0,1,1,0.63
"20240814","1783","9654","9600",富邦-永和,0,3,3,-1,1.89
"20240814","1783","0039003100330044","9100",群益金鼎-潭子,1,0,1,1,0.63
"20240814","1783","003500390032006f","5920",元富-新興,0,2,2,-1,1.26
"20240814","1783","0039003100380047","9100",群益金鼎-新莊,1,0,1,1,0.63
"20240814","1783","7032","7030",致和-佳里,0,2,2,-1,1.26
"20240814","1783","9234","9200",凱基-竹北,1,0,1,1,0.63
"20240814","1783","003700370039005a","7790",國票-安和,0,2,2,-1,1.26
"20240815","1783","0039004100300030","9A00",永豐金證券,9,1,8,1,6.61
"20240815","1783","0039003200300046","9200",凱基-站前,0,10,10,-1,8.26
"20240815","1783","8150","8150",台新證券,7,1,6,1,4.96
"20240815","1783","0039004100390039","9A00",永豐金-中壢,0,8,8,-1,6.61
"20240815","1783","6110","6110",台中銀,5,0,5,1,4.13
"20240815","1783","5854","5850",統一-城中,0,5,5,-1,4.13
"20240815","1783","1560","1560",港商野村,5,0,5,1,4.13
"20240815","1783","0038003100350059","8150",台新-新營,0,5,5,-1,4.13
"20240815","1783","003500390032006f","5920",元富-新興,4,2,2,1,1.65
"20240815","1783","9874","9800",元大-雙和,0,5,5,-1,4.13
"20240815","1783","0039003800340048","9800",元大-景美,2,0,2,1,1.65
"20240815","1783","0035003900320058","5920",元富-草屯,0,4,4,-1,3.31
"20240815","1783","7750","7750",北城證券,1,0,1,1,0.83
"20240815","1783","9834","9800",元大-中壢,0,4,4,-1,3.31
"20240815","1783","0038003400350045","8450",康和-澎湖,1,0,1,1,0.83
"20240815","1783","0039004100360031","9A00",永豐金-鳳山,0,3,3,-1,2.48
"20240815","1783","0039003200310046","9200",凱基-天母,1,0,1,1,0.83
"20240815","1783","0039004100390055","9A00",永豐金-中正,0,3,3,-1,2.48
"20240815","1783","0035003900320061","5920",元富-松德,1,0,1,1,0.83
"20240815","1783","0039003800310079","9800",元大-善化,0,3,3,-1,2.48
"20240815","1783","0038003400350044","8450",康和-板橋,0,0,0,1,0.00
"20240815","1783","0035003900320079","5920",元富-花蓮,0,1,1,-1,0.83
"20240815","1783","9623","9600",富邦-台北,0,0,0,1,0.00
"20240815","1783","0036003300380044","6380",光和-高雄,0,1,1,-1,0.83
"20240815","1783","7790","7790",國票證券,0,0,0,1,0.00
"20240815","1783","5856","5850",統一-台中,0,1,1,-1,0.83
"20240815","1783","8840","8840",玉山證券,0,0,0,1,0.00
"20240815","1783","1440","1440",美林,0,1,1,-1,0.83
"20240816","1783","0031003000330046","1030",土銀-南港,20,0,20,1,11.30
"20240816","1783","0039004100360031","9A00",永豐金-鳳山,0,10,10,-1,5.65
"20240816","1783","0037003000300067","7000",兆豐-南門,6,2,4,1,2.26
"20240816","1783","8158","8150",台新-松江,0,10,10,-1,5.65
"20240816","1783","0039003800330069","9800",元大-大雅,3,0,3,1,1.69
"20240816","1783","0039003200300046","9200",凱基-站前,0,10,10,-1,5.65
"20240816","1783","003500390032004d","5920",元富-彰化,2,0,2,1,1.13
"20240816","1783","9831","9800",元大-四維,0,10,10,-1,5.65
"20240816","1783","1470","1470",台灣摩根士丹利,2,0,2,1,1.13
"20240816","1783","1650","1650",新加坡商瑞銀,2,8,6,-1,3.39
"20240816","1783","9834","9800",元大-中壢,2,0,2,1,1.13
"20240816","1783","8560","8560",新光,0,6,6,-1,3.39
"20240816","1783","0039004100300030","9A00",永豐金證券,3,1,2,1,1.13
"20240816","1783","003500390032005a","5920",元富-安南,0,5,5,-1,2.82
"20240816","1783","9800","9800",元大證券,2,1,1,1,0.56
"20240816","1783","0037003000300043","7000",兆豐-來福,0,5,5,-1,2.82
"20240816","1783","0035003300380050","5380",第一金-路竹,1,0,1,1,0.56
"20240816","1783","7007","7000",兆豐-竹北,0,3,3,-1,1.69
"20240816","1783","0037003000300068","7000",兆豐-三民,1,0,1,1,0.56
"20240816","1783","9872","9800",元大-復北,0,3,3,-1,1.69
"20240816","1783","8440","8440",摩根大通,3,2,1,1,0.56
"20240816","1783","0035003800350044","5850",統一-新台中,1,4,3,-1,1.69
"20240816","1783","8564","8560",新光-台南,1,0,1,1,0.56
"20240816","1783","003600310036004b","6160",中國信託-高雄,0,3,3,-1,1.69
"20240816","1783","0039003100330045","9100",群益金鼎-基隆,1,0,1,1,0.56
"20240816","1783","003900320030005a","9200",凱基-台東,0,3,3,-1,1.69
"20240816","1783","9216","9200",凱基-信義,1,0,1,1,0.56
"20240816","1783","5858","5850",統一-嘉義,0,2,2,-1,1.13
"20240819","1783","9268","9200",凱基-台北,30,3,27,1,17.76
"20240819","1783","0035003300380057","5380",第一金-華江,0,11,11,-1,7.24
"20240819","1783","1470","1470",台灣摩根士丹利,5,0,5,1,3.29
"20240819","1783","0039004100390039","9A00",永豐金-中壢,0,7,7,-1,4.61
"20240819","1783","0039003800390056","9800",元大-北三重,5,0,5,1,3.29
"20240819","1783","8843","8840",玉山-高雄,0,6,6,-1,3.95
"20240819","1783","0035003900320062","5920",元富-板橋,3,0,3,1,1.97
"20240819","1783","5854","5850",統一-城中,0,5,5,-1,3.29
"20240819","1783","003700300030006a","7000",兆豐-大安,2,0,2,1,1.32
"20240819","1783","9332","9300",華南永昌-楠梓,0,5,5,-1,3.29
"20240819","1783","1650","1650",新加坡商瑞銀,6,5,1,1,0.66
"20240819","1783","9872","9800",元大-復北,0,5,5,-1,3.29
"20240819","1783","1480","1480",美商高盛,4,3,1,1,0.66
"20240819","1783","5261","5260",美好-蘆洲,0,4,4,-1,2.63
"20240819","1783","9858","9800",元大-龍潭,2,1,1,1,0.66
"20240819","1783","0039004100390037","9A00",永豐金-新竹,0,4,4,-1,2.63
"20240819","1783","0039003800390061","9800",元大-苑裡,1,0,1,1,0.66
"20240819","1783","003500390032006f","5920",元富-新興,0,3,3,-1,1.97
"20240819","1783","7790","7790",國票證券,1,0,1,1,0.66
"20240819","1783","9654","9600",富邦-永和,0,3,3,-1,1.97
"20240819","1783","0039004100300030","9A00",永豐金證券,0,0,0,1,0.00
"20240819","1783","1560","1560",港商野村,1,3,2,-1,1.32
"20240819","1783","0038003800340048","8840",玉山-新竹,0,0,0,1,0.00
"20240819","1783","0035003900320044","5920",元富-大昌,0,2,2,-1,1.32
"20240819","1783","9319","9300",華南永昌-鶯歌,0,0,0,1,0.00
"20240819","1783","0037003000300067","7000",兆豐-南門,2,4,2,-1,1.32
"20240819","1783","9693","9600",富邦-新營,0,0,0,1,0.00
"20240819","1783","0038003800340046","8840",玉山-桃園,0,2,2,-1,1.32
"20240820","1783","9600","9600",富邦證券,26,0,26,1,19.40
"20240820","1783","8843","8840",玉山-高雄,0,9,9,-1,6.72
"20240820","1783","1440","1440",美林,9,4,5,1,3.73
"20240820","1783","9235","9200",凱基-永華,0,7,7,-1,5.22
"20240820","1783","0031003000330046","1030",土銀-南港,5,0,5,1,3.73
"20240820","1783","0039004100390037","9A00",永豐金-新竹,0,7,7,-1,5.22
"20240820","1783","1560","1560",港商野村,5,0,5,1,3.73
"20240820","1783","9329","9300",華南永昌-朴子,0,6,6,-1,4.48
"20240820","1783","0038003400350055","8450",康和-台北,4,0,4,1,2.99
"20240820","1783","0039003600330041","9600",富邦-八德,0,6,6,-1,4.48
"20240820","1783","1650","1650",新加坡商瑞銀,10,7,3,1,2.24
"20240820","1783","0036003300380044","6380",光和-高雄,0,5,5,-1,3.73
"20240820","1783","0038003800340044","8840",玉山-左營,3,0,3,1,2.24
"20240820","1783","0039003100380047","9100",群益金鼎-新莊,0,5,5,-1,3.73
"20240820","1783","0039003800330056","9800",元大-竹南,3,0,3,1,2.24
"20240820","1783","9647","9600",富邦-新竹,0,5,5,-1,3.73
"20240820","1783","0035003300380050","5380",第一金-路竹,2,0,2,1,1.49
"20240820","1783","9831","9800",元大-四維,0,5,5,-1,3.73
"20240820","1783","0038003100350048","8150",台新-屏東,2,0,2,1,1.49
"20240820","1783","0039003800390041","9800",元大-北投,0,5,5,-1,3.73
"20240820","1783","0038003400350045","8450",康和-澎湖,2,0,2,1,1.49
"20240820","1783","8440","8440",摩根大通,1,5,4,-1,2.99
"20240820","1783","003900360031004e","9600",富邦-西壢,2,0,2,1,1.49
"20240820","1783","8565","8560",新光-桃園,0,4,4,-1,2.99
"20240820","1783","9834","9800",元大-中壢,2,0,2,1,1.49
"20240820","1783","6912","6910",德信-中正,0,2,2,-1,1.49
"20240820","1783","0031003000320045","1020",合庫-桃園,1,0,1,1,0.75
"20240820","1783","7750","7750",北城證券,0,2,2,-1,1.49
"20240821","1783","9256","9200",凱基-南崁,38,0,38,1,9.92
"20240821","1783","9623","9600",富邦-台北,0,32,32,-1,8.36
"20240821","1783","9600","9600",富邦證券,28,0,28,1,7.31
"20240821","1783","5384","5380",第一金-台南,0,21,21,-1,5.48
"20240821","1783","1560","1560",港商野村,24,1,23,1,6.01
"20240821","1783","9268","9200",凱基-台北,56,75,19,-1,4.96
"20240821","1783","0035003900320057","5920",元富-吉利,22,0,22,1,5.74
"20240821","1783","0039004100390037","9A00",永豐金-新竹,0,8,8,-1,2.09
"20240821","1783","8440","8440",摩根大通,13,0,13,1,3.39
"20240821","1783","9278","9200",凱基-永康,0,6,6,-1,1.57
"20240821","1783","1480","1480",美商高盛,11,0,11,1,2.87
"20240821","1783","9834","9800",元大-中壢,0,6,6,-1,1.57
"20240821","1783","1650","1650",新加坡商瑞銀,34,24,10,1,2.61
"20240821","1783","0035003900320062","5920",元富-板橋,0,5,5,-1,1.31
"20240821","1783","003700300030006a","7000",兆豐-大安,5,0,5,1,1.31
"20240821","1783","0037003000300067","7000",兆豐-南門,2,7,5,-1,1.31
"20240821","1783","1032","1030",土銀-台南,4,0,4,1,1.04
"20240821","1783","003900360031004b","9600",富邦-七賢,0,5,5,-1,1.31
"20240821","1783","1440","1440",美林,17,13,4,1,1.04
"20240821","1783","0039003800350046","9800",元大-岡山,0,5,5,-1,1.31
"20240821","1783","1470","1470",台灣摩根士丹利,3,0,3,1,0.78
"20240821","1783","9859","9800",元大-新竹經國,0,4,4,-1,1.04
"20240821","1783","1590","1590",花旗環球,3,0,3,1,0.78
"20240821","1783","9255","9200",凱基-和平,0,3,3,-1,0.78
"20240821","1783","0035003800350051","5850",統一-三多,3,0,3,1,0.78
"20240821","1783","0031003000320045","1020",合庫-桃園,0,3,3,-1,0.78
"20240821","1783","9692","9600",富邦-嘉義,4,1,3,1,0.78
"20240821","1783","0036003300380044","6380",光和-高雄,0,3,3,-1,0.78
"20240822","1783","9268","9200",凱基-台北,58,26,32,1,12.50
"20240822","1783","7009","7000",兆豐-景美,0,12,12,-1,4.69
"20240822","1783","6161","6160",中國信託-三重,20,0,20,1,7.81
"20240822","1783","9254","9200",凱基-科園,0,10,10,-1,3.91
"20240822","1783","8440","8440",摩根大通,10,0,10,1,3.91
"20240822","1783","003700300030006a","7000",兆豐-大安,0,8,8,-1,3.13
"20240822","1783","9256","9200",凱基-南崁,10,0,10,1,3.91
"20240822","1783","1480","1480",美商高盛,0,6,6,-1,2.34
"20240822","1783","1560","1560",港商野村,9,1,8,1,3.13
"20240822","1783","0038003400350046","8450",康和-仁愛,0,6,6,-1,2.34
"20240822","1783","0039003100300044","9100",群益金鼎-市府,7,0,7,1,2.73
"20240822","1783","0035003900320075","5920",元富-世貿,0,5,5,-1,1.95
"20240822","1783","9369","9300",華南永昌-三重,6,0,6,1,2.34
"20240822","1783","0035003900320077","5920",元富-佳里,0,5,5,-1,1.95
"20240822","1783","0039003100330044","9100",群益金鼎-潭子,4,0,4,1,1.56
"20240822","1783","003500390032005a","5920",元富-安南,0,5,5,-1,1.95
"20240822","1783","0035003300380057","5380",第一金-華江,1,0,1,1,0.39
"20240822","1783","9235","9200",凱基-永華,0,5,5,-1,1.95
"20240822","1783","5921","5920",元富-高雄,1,0,1,1,0.39
"20240822","1783","0039003800390041","9800",元大-北投,0,5,5,-1,1.95
"20240822","1783","0035003900320062","5920",元富-板橋,1,0,1,1,0.39
"20240822","1783","003900380039004a","9800",元大-彰化民生,0,5,5,-1,1.95
"20240822","1783","6452","6450",永全-八德,2,1,1,1,0.39
"20240822","1783","9136","9100",群益金鼎-西松,0,4,4,-1,1.56
"20240822","1783","003800380034004d","8840",玉山-數位,1,0,1,1,0.39
"20240822","1783","9211","9200",凱基-台南,0,4,4,-1,1.56
"20240822","1783","0039003200320043","9200",凱基-屏東,1,0,1,1,0.39
"20240822","1783","9676","9600",富邦-仁愛,0,4,4,-1,1.56
"20240823","1783","0035003900320057","5920",元富-吉利,29,0,29,1,13.36
"20240823","1783","0038003800380041","8880",國泰-館前,1,19,18,-1,8.29
"20240823","1783","5920","5920",元富,22,0,22,1,10.14
"20240823","1783","9211","9200",凱基-台南,0,13,13,-1,5.99
"20240823","1783","9268","9200",凱基-台北,22,2,20,1,9.22
"20240823","1783","0035003800350045","5850",統一-新營,0,10,10,-1,4.61
"20240823","1783","1480","1480",美商高盛,19,0,19,1,8.76
"20240823","1783","0037003700390044","7790",國票-台南,0,9,9,-1,4.15
"20240823","1783","9600","9600",富邦證券,17,0,17,1,7.83
"20240823","1783","0039003100380067","9100",群益金鼎-大甲,0,7,7,-1,3.23
"20240823","1783","9859","9800",元大-新竹經國,10,0,10,1,4.61
"20240823","1783","0031003000320041","1020",合庫-新竹,0,6,6,-1,2.76
"20240823","1783","9256","9200",凱基-南崁,10,1,9,1,4.15
"20240823","1783","003800340035004a","8450",康和-高雄,0,5,5,-1,2.30
"20240823","1783","8440","8440",摩根大通,10,2,8,1,3.69
"20240823","1783","9278","9200",凱基-永康,0,5,5,-1,2.30
"20240823","1783","1470","1470",台灣摩根士丹利,6,2,4,1,1.84
"20240823","1783","0039003800310070","9800",元大-松山,0,4,4,-1,1.84
"20240823","1783","0035003800350044","5850",統一-新台中,6,2,4,1,1.84
"20240823","1783","0037003000300067","7000",兆豐-南門,0,4,4,-1,1.84
"20240823","1783","0037003000300042","7000",兆豐-板橋,4,0,4,1,1.84
"20240823","1783","8492","8490",京城-嘉義,0,4,4,-1,1.84
"20240823","1783","9272","9200",凱基-竹科,2,0,2,1,0.92
"20240823","1783","0039004100390063","9A00",永豐金-永康,0,4,4,-1,1.84
"20240823","1783","5857","5850",統一-新竹,1,0,1,1,0.46
"20240823","1783","0031003000340043","1040",臺銀-高雄,0,3,3,-1,1.38
"20240823","1783","1043","1040",臺銀-民權,1,0,1,1,0.46
"20240823","1783","0031003200360069","1260",宏遠-光隆,0,3,3,-1,1.38
"20240826","1783","8440","8440",摩根大通,21,0,21,1,12.57
"20240826","1783","1480","1480",美商高盛,3,13,10,-1,5.99
"20240826","1783","0039003100380067","9100",群益金鼎-大甲,8,0,8,1,4.79
"20240826","1783","1650","1650",新加坡商瑞銀,1,9,8,-1,4.79
"20240826","1783","9288","9200",凱基-埔墘,3,0,3,1,1.80
"20240826","1783","9136","9100",群益金鼎-西松,0,8,8,-1,4.79
"20240826","1783","1590","1590",花旗環球,2,0,2,1,1.20
"20240826","1783","9825","9800",元大-新營,0,6,6,-1,3.59
"20240826","1783","8150","8150",台新證券,3,1,2,1,1.20
"20240826","1783","5266","5260",美好-中壢,0,5,5,-1,2.99
"20240826","1783","0035003900320061","5920",元富-松德,1,0,1,1,0.60
"20240826","1783","6950","6950",福勝,0,5,5,-1,2.99
"20240826","1783","0031003000340043","1040",臺銀-高雄,1,0,1,1,0.60
"20240826","1783","9859","9800",元大-新竹經國,0,5,5,-1,2.99
"20240826","1783","0039003800310068","9800",元大-屏東民生,1,0,1,1,0.60
"20240826","1783","1560","1560",港商野村,0,4,4,-1,2.40
"20240826","1783","9834","9800",元大-中壢,1,0,1,1,0.60
"20240826","1783","0039003800310046","9800",元大-福營,0,4,4,-1,2.40
"20240826","1783","7790","7790",國票證券,1,0,1,1,0.60
"20240826","1783","0039004100390072","9A00",永豐金-北高雄,0,4,4,-1,2.40
"20240826","1783","9693","9600",富邦-新營,0,0,0,1,0.00
"20240826","1783","9893","9800",元大-大天母,0,3,3,-1,1.80
"20240826","1783","8882","8880",國泰-台中,0,0,0,1,0.00
"20240826","1783","1440","1440",美林,0,3,3,-1,1.80
"20240826","1783","6620","6620",口袋證券,0,0,0,1,0.00
"20240826","1783","0035003900320072","5920",元富-城東,0,3,3,-1,1.80
"20240826","1783","9218","9200",凱基-大直,0,0,0,1,0.00
"20240826","1783","0037003000300063","7000",兆豐-民生,0,3,3,-1,1.80
"20240827","1783","8440","8440",摩根大通,35,0,35,1,13.31
"20240827","1783","9894","9800",元大-桃興,0,40,40,-1,15.21
"20240827","1783","1480","1480",美商高盛,35,1,34,1,12.93
"20240827","1783","9825","9800",元大-新營,0,14,14,-1,5.32
"20240827","1783","1650","1650",新加坡商瑞銀,25,1,24,1,9.13
"20240827","1783","9657","9600",富邦-苗栗,0,9,9,-1,3.42
"20240827","1783","9268","9200",凱基-台北,26,5,21,1,7.98
"20240827","1783","0039003100380067","9100",群益金鼎-大甲,2,10,8,-1,3.04
"20240827","1783","1560","1560",港商野村,15,0,15,1,5.70
"20240827","1783","0039003600310043","9600",富邦-南京,0,5,5,-1,1.90
"20240827","1783","6161","6160",中國信託-三重,11,0,11,1,4.18
"20240827","1783","0039003600320044","9600",富邦-新莊,0,5,5,-1,1.90
"20240827","1783","0035003900320057","5920",元富-吉利,10,0,10,1,3.80
"20240827","1783","0039003600360046","9600",富邦-左營,0,5,5,-1,1.90
"20240827","1783","9256","9200",凱基-南崁,10,0,10,1,3.80
"20240827","1783","003900380031006e","9800",元大-旗山,0,5,5,-1,1.90
"20240827","1783","8565","8560",新光-桃園,7,0,7,1,2.66
"20240827","1783","003900380039004c","9800",元大-成功,0,5,5,-1,1.90
"20240827","1783","8150","8150",台新證券,4,0,4,1,1.52
"20240827","1783","6163","6160",中國信託-永康,0,4,4,-1,1.52
"20240827","1783","1440","1440",美林,7,5,2,1,0.76
"20240827","1783","0037003000300049","7000",兆豐-北高雄,0,4,4,-1,1.52
"20240827","1783","003700370039005a","7790",國票-安和,2,0,2,1,0.76
"20240827","1783","9235","9200",凱基-永華,0,4,4,-1,1.52
"20240827","1783","0038003800380041","8880",國泰-館前,2,0,2,1,0.76
"20240827","1783","0039003800330047","9800",元大-上新莊,0,4,4,-1,1.52
"20240827","1783","8560","8560",新光,1,0,1,1,0.38
"20240827","1783","9288","9200",凱基-埔墘,0,3,3,-1,1.14
"20240828","1783","8440","8440",摩根大通,21,0,21,1,14.58
"20240828","1783","0037003000300069","7000",兆豐-松德,0,8,8,-1,5.56
"20240828","1783","9268","9200",凱基-台北,13,2,11,1,7.64
"20240828","1783","0039004100390041","9A00",永豐金-羅東,0,7,7,-1,4.86
"20240828","1783","6161","6160",中國信託-三重,9,0,9,1,6.25
"20240828","1783","0039003800310045","9800",元大-發財,0,5,5,-1,3.47
"20240828","1783","1650","1650",新加坡商瑞銀,7,0,7,1,4.86
"20240828","1783","9831","9800",元大-四維,0,5,5,-1,3.47
"20240828","1783","1560","1560",港商野村,7,0,7,1,4.86
"20240828","1783","003900380039006a","9800",元大-樹林,0,5,5,-1,3.47
"20240828","1783","0035003900320057","5920",元富-吉利,7,0,7,1,4.86
"20240828","1783","5266","5260",美好-中壢,0,4,4,-1,2.78
"20240828","1783","1440","1440",美林,3,0,3,1,2.08
"20240828","1783","1020","1020",合庫證券,0,3,3,-1,2.08
"20240828","1783","0039003100330045","9100",群益金鼎-基隆,2,0,2,1,1.39
"20240828","1783","8888","8880",國泰-敦南,0,3,3,-1,2.08
"20240828","1783","003900360032004a","9600",富邦-三峽,2,0,2,1,1.39
"20240828","1783","6910","6910",德信,0,2,2,-1,1.39
"20240828","1783","0039003800390061","9800",元大-苑裡,2,0,2,1,1.39
"20240828","1783","0031003000340043","1040",臺銀-高雄,0,2,2,-1,1.39
"20240828","1783","1480","1480",美商高盛,1,0,1,1,0.69
"20240828","1783","5602","5600",永興-水湳,0,2,2,-1,1.39
"20240828","1783","8150","8150",台新證券,1,0,1,1,0.69
"20240828","1783","0035003300380043","5380",第一金-光復,0,2,2,-1,1.39
"20240828","1783","0038003400350045","8450",康和-澎湖,1,0,1,1,0.69
"20240828","1783","003700370039005a","7790",國票-安和,0,2,2,-1,1.39
"20240828","1783","8492","8490",京城-嘉義,1,0,1,1,0.69
"20240828","1783","0038003100350041","8150",台新-高雄,0,2,2,-1,1.39
"20240829","1783","9268","9200",凱基-台北,18,1,17,1,13.82
"20240829","1783","003700300030006a","7000",兆豐-大安,0,12,12,-1,9.76
"20240829","1783","1650","1650",新加坡商瑞銀,15,2,13,1,10.57
"20240829","1783","003900380031006e","9800",元大-旗山,0,7,7,-1,5.69
"20240829","1783","5859","5850",統一-屏東,8,0,8,1,6.50
"20240829","1783","8150","8150",台新證券,0,6,6,-1,4.88
"20240829","1783","9647","9600",富邦-新竹,5,0,5,1,4.07
"20240829","1783","8888","8880",國泰-敦南,0,4,4,-1,3.25
"20240829","1783","1560","1560",港商野村,4,0,4,1,3.25
"20240829","1783","0035003300380049","5380",第一金-頭份,0,3,3,-1,2.44
"20240829","1783","6161","6160",中國信託-三重,2,0,2,1,1.63
"20240829","1783","9366","9300",華南永昌-豐原,0,2,2,-1,1.63
"20240829","1783","003700370039005a","7790",國票-安和,2,0,2,1,1.63
"20240829","1783","0039003800340045","9800",元大-南勢角,0,2,2,-1,1.63
"20240829","1783","8843","8840",玉山-高雄,2,0,2,1,1.63
"20240829","1783","0039004100300030","9A00",永豐金證券,1,3,2,-1,1.63
"20240829","1783","003900360032004a","9600",富邦-三峽,2,0,2,1,1.63
"20240829","1783","1440","1440",美林,4,6,2,-1,1.63
"20240829","1783","9667","9600",富邦-台南,2,0,2,1,1.63
"20240829","1783","8440","8440",摩根大通,0,2,2,-1,1.63
"20240829","1783","0039004100370039","9A00",永豐金-埔里,2,0,2,1,1.63
"20240829","1783","0038003800380041","8880",國泰-館前,0,2,2,-1,1.63
"20240829","1783","0035003900320041","5920",元富-緯城,1,0,1,1,0.81
"20240829","1783","003800380038004b","8880",國泰-板橋,0,2,2,-1,1.63
"20240829","1783","0037003000300067","7000",兆豐-南門,2,1,1,1,0.81
"20240829","1783","9206","9200",凱基-高雄,0,2,2,-1,1.63
"20240829","1783","0039003100330045","9100",群益金鼎-基隆,1,0,1,1,0.81
"20240829","1783","9211","9200",凱基-台南,0,2,2,-1,1.63
"20240830","1783","8158","8150",台新-松江,5,0,5,1,5.26
"20240830","1783","003900380039004e","9800",元大-內湖,0,9,9,-1,9.47
"20240830","1783","0037003000300067","7000",兆豐-南門,4,0,4,1,4.21
"20240830","1783","9268","9200",凱基-台北,3,9,6,-1,6.32
"20240830","1783","0039004100370039","9A00",永豐金-埔里,4,0,4,1,4.21
"20240830","1783","0039003600320041","9600",富邦-南港,0,6,6,-1,6.32
"20240830","1783","6161","6160",中國信託-三重,3,0,3,1,3.16
"20240830","1783","8840","8840",玉山證券,0,4,4,-1,4.21
"20240830","1783","0039003800390061","9800",元大-苑裡,3,0,3,1,3.16
"20240830","1783","0039003800300064","9800",元大-沙鹿,0,3,3,-1,3.16
"20240830","1783","1036","1030",土銀-玉里,2,0,2,1,2.11
"20240830","1783","0039003800390051","9800",元大-汐止,0,3,3,-1,3.16
"20240830","1783","1560","1560",港商野村,2,0,2,1,2.11
"20240830","1783","8888","8880",國泰-敦南,1,3,2,-1,2.11
"20240830","1783","8440","8440",摩根大通,3,1,2,1,2.11
"20240830","1783","1440","1440",美林,0,2,2,-1,2.11
"20240830","1783","1650","1650",新加坡商瑞銀,1,0,1,1,1.05
"20240830","1783","0038003800340042","8840",玉山-台中,0,2,2,-1,2.11
"20240830","1783","1590","1590",花旗環球,1,0,1,1,1.05
"20240830","1783","0039003100330045","9100",群益金鼎-基隆,0,2,2,-1,2.11
"20240830","1783","8492","8490",京城-嘉義,1,0,1,1,1.05
"20240830","1783","0039003200310043","9200",凱基-民權,0,2,2,-1,2.11
"20240830","1783","9215","9200",凱基-高美館,1,0,1,1,1.05
"20240830","1783","9273","9200",凱基-竹東,0,2,2,-1,2.11
"20240830","1783","003900360032004a","9600",富邦-三峽,1,0,1,1,1.05
"20240830","1783","0039004100390038","9A00",永豐金-大園,0,2,2,-1,2.11
"20240830","1783","9800","9800",元大證券,2,1,1,1,1.05
"20240830","1783","6110","6110",台中銀,0,1,1,-1,1.05
