"sdate","id","f_qty","i_qty","s_qty","t_qty","est_f_qty","est_i_qty","est_s_qty","est_t_qty","trs_f_percent","trs_3_percent"
"1120512","1783",-366,0,4,-362,10725,1902,594,13221,12.66,15.61
"1120511","1783",36,0,-182,-146,11064,1902,590,13556,13.06,16.00
"1120510","1783",-430,0,-6,-436,11001,1902,772,13675,12.98,16.14
"1120509","1783",41,0,41,82,11427,1902,777,14106,13.49,16.65
"1120508","1783",579,0,-23,556,11360,1902,736,13998,13.41,16.52
"1120505","1783",921,0,26,947,10735,1902,759,13396,12.67,15.81
"1120504","1783",-204,0,2,-202,9801,1902,733,12436,11.57,14.68
"1120503","1783",-30,0,2,-28,10012,1902,731,12645,11.82,14.93
"1120502","1783",692,0,25,717,10033,1902,729,12664,11.84,14.95
"1120428","1783",395,0,157,552,9319,1902,704,11925,11.00,14.08
"1120427","1783",-5,0,0,-5,8945,1902,547,11394,10.56,13.45
"1120426","1783",101,0,13,114,8962,1902,547,11411,10.58,13.47
"1120425","1783",-149,0,-39,-188,8854,1902,534,11290,10.45,13.33
"1120424","1783",701,0,-67,634,9023,1902,573,11498,10.65,13.57
"1120421","1783",141,0,-30,111,8302,1902,640,10844,9.80,12.80
"1120420","1783",-596,100,-77,-573,8148,1902,670,10720,9.61,12.65
"1120419","1783",259,400,-98,561,8742,1802,747,11291,10.32,13.33
"1120418","1783",-93,0,91,-2,8481,1402,845,10728,10.01,12.66
"1120417","1783",-2,0,29,27,8559,1402,754,10715,10.10,12.65
"1120414","1783",-75,0,-1,-76,8561,1402,725,10688,10.10,12.61
"1120413","1783",32,0,0,32,8636,1402,726,10764,10.19,12.70
"1120412","1783",107,0,9,116,8612,1402,726,10740,10.16,12.67
"1120411","1783",-193,0,14,-179,8505,1402,717,10624,10.04,12.54
"1120410","1783",-31,0,19,-12,8698,1402,703,10803,10.26,12.75
"1120407","1783",-169,0,65,-104,8742,1402,684,10828,10.32,12.78
"1120406","1783",277,0,10,287,8923,1402,619,10944,10.53,12.92
"1120331","1783",-18,0,7,-11,8649,1402,609,10660,10.21,12.58
"1120330","1783",-141,0,-9,-150,8706,1400,602,10708,10.27,12.63
"1120329","1783",169,0,-21,148,8813,1400,611,10824,10.40,12.77
"1120328","1783",27,0,52,79,8645,1400,632,10677,10.20,12.60
"1120327","1783",208,0,20,228,8891,1400,580,10871,10.49,12.83
"1120324","1783",-90,0,46,-44,8688,1400,560,10648,10.25,12.56
"1120323","1783",-272,200,4,-68,8875,1400,514,10789,10.47,12.73
"1120322","1783",-14,0,20,6,9154,1200,510,10864,10.80,12.82
"1120321","1783",-158,-300,-1,-459,9202,1200,490,10892,10.86,12.86
"1120320","1783",343,-313,-1,29,9383,1500,491,11374,11.07,13.42
"1120317","1783",36,-237,-17,-218,9027,1813,492,11332,10.65,13.37
"1120316","1783",634,0,-36,598,9106,2050,509,11665,10.75,13.77
"1120315","1783",164,0,7,171,8505,2050,545,11100,10.04,13.10
"1120314","1783",-342,0,-6,-348,8336,2050,538,10924,9.84,12.90
"1120313","1783",603,0,-41,562,8647,2050,544,11241,10.20,13.26
"1120310","1783",807,0,-56,751,8044,2050,585,10679,9.49,12.60
"1120309","1783",-70,0,3,-67,7236,2050,641,9927,8.54,11.72
"1120308","1783",-137,0,9,-128,7347,2050,638,10035,8.67,11.84
"1120307","1783",-260,0,5,-255,7477,2050,629,10156,8.82,11.98
"1120306","1783",-1881,0,-99,-1980,7710,2050,624,10384,9.10,12.26
"1120303","1783",661,0,20,681,9452,2050,723,12225,11.15,14.42
"1120302","1783",508,0,-2,506,8800,2050,703,11553,10.39,13.64
"1120301","1783",607,150,60,817,8292,2050,705,11047,9.79,13.04
"1120224","1783",103,200,-29,274,7661,1900,645,10206,9.04,12.04
"1120223","1783",-711,0,-4,-715,7477,1700,674,9851,8.82,11.62
"1120222","1783",627,250,4,881,7987,1700,678,10365,9.42,12.23
"1120221","1783",284,250,18,552,7355,1450,674,9479,8.68,11.19
"1120220","1783",-303,0,7,-296,7038,1200,656,8894,8.30,10.49
"1120217","1783",59,0,9,68,7293,1200,649,9142,8.61,10.79
"1120216","1783",18,0,0,18,7238,1200,640,9078,8.54,10.71
"1120215","1783",-280,0,6,-274,7213,1200,640,9053,8.51,10.68
"1120214","1783",-144,0,-63,-207,7505,1200,634,9339,8.86,11.03
"1120213","1783",-394,0,-4,-398,7653,1200,697,9550,9.03,11.27
"1120210","1783",-618,0,-23,-641,8026,1200,701,9927,9.47,11.71
"1120209","1783",-570,0,-179,-749,8642,1200,724,10566,10.20,12.47
"1120208","1783",-585,0,-13,-598,9164,1200,903,11267,10.81,13.29
"1120207","1783",925,0,161,1086,9704,1200,916,11820,11.45,13.95
"1120206","1783",1098,0,-340,758,8766,1200,755,10721,10.34,12.65
"1120203","1783",-25,0,345,320,7664,1200,1095,9959,9.04,11.75
"1120202","1783",171,0,1,172,7661,1200,750,9611,9.04,11.34
"1120201","1783",313,100,7,420,7502,1200,749,9451,8.85,11.15
"1120131","1783",103,100,93,296,7170,1100,742,9012,8.46,10.63
"1120130","1783",31,100,16,147,7067,1000,649,8716,8.34,10.29
"1120117","1783",-941,100,0,-841,7018,900,633,8551,8.28,10.09
"1120116","1783",337,0,0,337,8146,800,633,9579,9.61,11.30
"1120113","1783",1379,0,0,1379,7772,800,633,9205,9.17,10.86
"1120112","1783",126,167,-1,292,6533,800,633,7966,7.71,9.40
"1120111","1783",122,0,1,123,6407,633,634,7674,7.56,9.06
"1120110","1783",-153,0,0,-153,6285,633,633,7551,7.42,8.91
"1120109","1783",513,0,0,513,6438,633,633,7704,7.60,9.09
"1120106","1783",-585,200,4,-381,5963,633,633,7229,7.04,8.53
"1120105","1783",415,433,34,882,6559,433,629,7621,7.74,8.99
"1120104","1783",104,-331,13,-214,6138,0,595,6733,7.24,7.94
"1120103","1783",193,0,8,201,6034,331,582,6947,7.12,8.20
"1111230","1783",-154,0,0,-154,5823,331,574,6728,6.87,7.94
"1111229","1783",43,0,0,43,5980,294,574,6848,7.05,8.07
"1111228","1783",-225,0,-6,-231,5937,294,574,6805,7.00,8.02
"1111227","1783",-237,0,0,-237,6115,294,580,6989,7.22,8.25
"1111226","1783",-1412,0,3,-1409,6379,294,580,7253,7.53,8.56
"1111223","1783",-186,0,2,-184,7899,294,577,8770,9.32,10.35
"1111222","1783",333,0,-1,332,8132,294,575,9001,9.60,10.63
"1111221","1783",840,0,-3,837,7799,294,576,8669,9.20,10.23
"1111220","1783",-47,0,-2,-49,6959,294,579,7832,8.21,9.24
"1111219","1783",-92,0,-2,-94,6970,294,581,7845,8.22,9.25
"1111216","1783",80,0,0,80,7043,294,583,7920,8.31,9.35
"1111215","1783",-148,0,-1,-149,6930,294,583,7807,8.18,9.22
"1111214","1783",569,0,178,747,7037,294,584,7915,8.30,9.34
"1111213","1783",-405,0,2,-403,6493,294,406,7193,7.66,8.49
"1111212","1783",-10,0,0,-10,6887,294,404,7585,8.13,8.95
"1111209","1783",-6,0,-5,-11,6327,294,404,7025,8.21,9.03
"1111208","1783",-69,-64,-1,-134,6333,294,409,7036,8.22,9.05
"1111207","1783",67,0,0,67,6402,358,410,7170,8.31,9.22
"1111206","1783",257,0,-3,254,6335,358,410,7103,8.22,9.13
"1111205","1783",40,0,0,40,6078,358,413,6849,7.89,8.80
"1111202","1783",107,0,-4,103,6038,358,413,6809,7.84,8.75
"1111201","1783",104,0,-2,102,5931,358,417,6706,7.70,8.62
"1111130","1783",-26,0,0,-26,5827,358,419,6604,7.56,8.48
"1111129","1783",-5,0,0,-5,5873,358,419,6650,7.62,8.54
"1111128","1783",172,0,-2,170,5892,358,419,6669,7.65,8.57
"1111125","1783",62,0,0,62,5721,358,421,6500,7.42,8.34
"1111124","1783",-59,0,0,-59,5676,358,421,6455,7.37,8.29
"1111123","1783",116,0,0,116,5737,358,421,6516,7.45,8.37
"1111122","1783",-150,0,-6,-156,5621,358,421,6400,7.29,8.21
"1111121","1783",100,0,0,100,5770,358,427,6555,7.49,8.42
"1111118","1783",103,0,0,103,5670,358,427,6455,7.36,8.29
"1111117","1783",133,0,0,133,5567,358,427,6352,7.22,8.15
"1111116","1783",10,0,-23,-13,5434,358,427,6219,7.05,7.98
"1111115","1783",1,0,58,59,5385,358,450,6193,6.99,7.94
"1111114","1783",64,0,76,140,5384,358,392,6134,6.99,7.88
"1111111","1783",-71,0,0,-71,5320,358,316,5994,6.90,7.70
"1111110","1783",201,0,0,201,5391,358,316,6065,7.00,7.97
"1111109","1783",72,0,1,73,5190,358,316,5864,6.73,7.70
"1111108","1783",116,0,0,116,5118,358,315,5791,6.64,7.61
"1111107","1783",-45,0,0,-45,5002,358,315,5675,6.49,7.46
"1111104","1783",45,0,-1,44,5095,358,315,5768,6.61,7.58
"1111103","1783",81,0,0,81,5050,358,316,5724,6.55,7.52
"1111102","1783",-14,0,4,-10,4969,358,316,5643,6.45,7.42
"1111101","1783",85,0,0,85,4983,358,312,5653,6.47,7.43
"1111031","1783",45,0,0,45,4921,358,312,5591,6.39,7.35
"1111028","1783",-35,-91,10,-116,4918,358,312,5588,6.38,7.34
"1111027","1783",133,0,1,134,4961,449,302,5712,6.44,7.52
"1111026","1783",40,0,12,52,4862,449,301,5612,6.31,7.39
"1111025","1783",-67,0,10,-57,4760,449,289,5498,6.18,7.24
"1111024","1783",-3,0,3,0,4829,449,279,5557,6.27,7.32
"1111021","1783",-60,0,0,-60,4832,449,276,5557,6.27,7.31
"1111020","1783",-26,-22,0,-48,4892,449,276,5617,6.35,7.39
"1111019","1783",3,-51,3,-45,4918,471,276,5665,6.38,7.46
"1111018","1783",-38,-48,7,-79,4915,522,273,5710,6.38,7.52
"1111017","1783",25,0,1,26,4979,570,266,5815,6.46,7.66
"1111014","1783",79,0,0,79,4959,570,265,5794,6.43,7.63
"1111013","1783",285,0,0,285,4880,570,265,5715,6.33,7.53
"1111012","1783",34,0,0,34,4585,570,265,5420,5.95,7.15
"1111011","1783",-73,0,-1,-74,4531,570,265,5366,5.88,7.08
"1111007","1783",-57,0,-1,-58,4604,570,266,5440,5.97,7.17
"1111006","1783",69,0,0,69,4656,570,267,5493,6.04,7.24
"1111005","1783",-75,0,0,-75,4593,570,267,5430,5.96,7.16
"1111004","1783",47,0,2,49,4675,570,268,5513,6.07,7.28
"1111003","1783",-89,0,0,-89,4628,570,266,5464,6.01,7.21
"1110930","1783",-15,0,0,-15,4717,570,266,5553,6.12,7.32
"1110929","1783",159,0,1,160,4732,571,266,5569,6.14,7.34
"1110928","1783",-117,0,0,-117,4573,571,265,5409,5.93,7.13
"1110927","1783",44,0,1,45,4687,571,265,5523,6.08,7.28
"1110926","1783",-14,0,-5,-19,4642,571,264,5477,6.02,7.22
"1110923","1783",-67,0,-1,-68,4648,571,269,5488,6.03,7.24
"1110922","1783",-5,0,-3,-8,4695,571,270,5536,6.09,7.30
"1110921","1783",-22,0,-5,-27,4700,571,273,5544,6.10,7.32
"1110920","1783",-8,0,0,-8,4715,571,278,5564,6.12,7.34
"1110919","1783",-63,0,0,-63,4723,571,278,5572,6.13,7.35
"1110916","1783",-147,0,-4,-151,4779,571,278,5628,6.20,7.42
"1110915","1783",70,0,-5,65,4926,571,282,5779,6.39,7.62
"1110914","1783",-472,0,1,-471,4861,571,287,5719,6.31,7.55
"1110913","1783",285,50,0,335,5313,571,287,6171,6.89,8.13
"1110912","1783",236,21,0,257,5028,521,287,5836,6.52,7.68
"1110908","1783",103,50,0,153,4792,500,287,5579,6.22,7.35
"1110907","1783",-128,0,-11,-139,4689,450,287,5426,6.08,7.14
"1110906","1783",131,100,0,231,4807,450,298,5555,6.24,7.32
"1110905","1783",-304,50,1,-253,4676,350,298,5324,6.07,7.00
"1110902","1783",-44,200,-1,155,4980,300,297,5577,6.46,7.32
"1110901","1783",-359,100,-11,-270,5037,100,298,5435,6.54,7.11
"1110831","1783",-101,0,2,-99,5366,0,309,5675,6.96,7.40
"1110830","1783",207,0,0,207,5438,0,307,5745,7.06,7.50
"1110829","1783",-47,0,-4,-51,5274,0,307,5581,6.84,7.28
"1110826","1783",194,0,0,194,5321,0,311,5632,6.91,7.36
"1110825","1783",-141,0,1,-140,5127,0,311,5438,6.65,7.10
"1110824","1783",322,0,0,322,5268,0,310,5578,6.84,7.29
"1110823","1783",-156,0,-1,-157,4946,0,310,5256,6.42,6.87
"1110822","1783",32,0,0,32,5102,0,311,5413,6.62,7.07
"1110819","1783",75,0,0,75,5090,0,311,5401,6.61,7.06
"1110818","1783",-55,0,0,-55,5015,0,311,5326,6.51,6.96
"1110817","1783",101,0,0,101,5070,0,311,5381,6.58,7.03
"1110816","1783",66,0,0,66,4969,0,311,5280,6.45,6.90
"1110815","1783",32,0,-70,-38,4903,0,311,5214,6.36,6.81
"1110812","1783",30,0,70,100,4871,0,381,5252,6.32,6.87
"1110811","1783",-17,0,0,-17,4841,0,311,5152,6.28,6.73
"1110810","1783",10,0,-2,8,4858,0,311,5169,6.30,6.75
"1110809","1783",171,0,2,173,4848,0,313,5161,6.29,6.74
"1110808","1783",54,0,0,54,4667,0,312,4979,6.06,6.51
"1110805","1783",54,0,0,54,4612,0,312,4924,5.98,6.43
"1110804","1783",-18,0,-1,-19,4558,0,312,4870,5.91,6.36
"1110803","1783",18,0,-12,6,4576,0,313,4889,5.94,6.39
"1110802","1783",22,0,0,22,4548,0,325,4873,5.90,6.37
"1110801","1783",-39,0,0,-39,4526,0,325,4851,5.87,6.34
"1110729","1783",6,0,1,7,4565,0,325,4890,5.92,6.39
"1110728","1783",-59,0,0,-59,4585,0,324,4909,5.95,6.42
"1110727","1783",14,0,0,14,4620,0,324,4944,5.99,6.46
"1110726","1783",-118,0,0,-118,4581,0,324,4905,5.94,6.41
"1110725","1783",-20,0,0,-20,4667,0,324,4991,6.06,6.53
"1110722","1783",46,0,0,46,4687,0,324,5011,6.08,6.55
"1110721","1783",85,0,0,85,4697,0,325,5022,6.09,6.56
"1110720","1783",2,0,-1,1,4615,0,325,4940,5.99,6.46
"1110719","1783",-24,0,0,-24,4613,0,326,4939,5.99,6.46
"1110718","1783",-60,0,-1,-61,4637,0,326,4963,6.02,6.49
"1110715","1783",-148,0,0,-148,4677,0,327,5004,6.07,6.54
"1110714","1783",-151,0,0,-151,4805,0,327,5132,6.23,6.70
"1110713","1783",312,0,6,318,4926,0,327,5253,6.39,6.86
"1110712","1783",-273,0,0,-273,4614,0,321,4935,5.99,6.45
"1110711","1783",56,0,0,56,4887,0,321,5208,6.34,6.80
"1110708","1783",117,0,1,118,4831,0,321,5152,6.27,6.73
"1110707","1783",52,0,0,52,4684,0,320,5004,6.08,6.54
"1110706","1783",-87,0,0,-87,4577,0,320,4897,5.94,6.40
"1110705","1783",-118,0,4,-114,4664,0,320,4984,6.05,6.51
"1110704","1783",134,0,7,141,4838,0,316,5154,6.28,6.73
"1110701","1783",-521,0,9,-512,4704,0,309,5013,6.10,6.54
"1110630","1783",13,0,-3,10,5225,0,300,5525,6.78,7.21
"1110629","1783",143,0,-1,142,5157,0,303,5460,6.69,7.13
"1110628","1783",202,0,4,206,4988,0,304,5292,6.47,6.91
"1110627","1783",23,0,3,26,4786,0,300,5086,6.21,6.64
"1110624","1783",11,0,24,35,4763,0,297,5060,6.18,6.61
"1110623","1783",-434,0,11,-423,4746,0,273,5019,6.16,6.55
"1110622","1783",-67,0,3,-64,5132,0,262,5394,6.66,7.04
"1110621","1783",49,0,7,56,5197,0,259,5456,6.74,7.11
"1110620","1783",22,0,0,22,5148,0,252,5400,6.68,7.04
"1110617","1783",6,0,0,6,5124,0,252,5376,6.65,7.01
"1110616","1783",44,0,0,44,5118,0,252,5370,6.64,7.00
"1110615","1783",23,0,-1,22,5074,0,252,5326,6.58,6.94
"1110614","1783",-10,0,0,-10,5051,0,253,5304,6.55,6.91
"1110613","1783",12,0,0,12,5062,0,253,5315,6.57,6.93
"1110610","1783",37,0,1,38,5046,0,254,5300,6.55,6.92
"1110609","1783",15,0,0,15,5009,0,253,5262,6.50,6.86
"1110608","1783",13,0,4,17,4994,0,253,5247,6.48,6.84
"1110607","1783",13,0,-1,12,5001,0,249,5250,6.49,6.85
"1110606","1783",71,0,1,72,4986,0,250,5236,6.47,6.83
"1110602","1783",11,0,-1,10,4913,0,249,5162,6.38,6.74
"1110601","1783",8,0,0,8,4902,0,250,5152,6.36,6.72
"1110531","1783",7,0,0,7,4917,0,250,5167,6.38,6.74
"1110530","1783",25,0,1,26,4910,0,250,5160,6.37,6.73
"1110527","1783",10,0,2,12,4885,0,249,5134,6.34,6.70
"1110526","1783",9,0,0,9,4875,0,247,5122,6.33,6.69
"1110525","1783",12,0,7,19,4866,0,247,5113,6.31,6.67
"1110524","1783",-9,0,0,-9,4854,0,240,5094,6.30,6.65
"1110523","1783",41,0,2,43,4863,0,240,5103,6.31,6.66
"1110520","1783",-10,0,0,-10,4822,0,238,5060,6.26,6.60
"1110519","1783",0,0,0,0,4832,0,238,5070,6.27,6.61
"1110518","1783",29,0,0,29,4866,0,238,5104,6.31,6.65
"1110517","1783",19,0,3,22,4837,0,238,5075,6.28,6.62
"1110516","1783",4,0,2,6,4817,0,235,5052,6.25,6.59
"1110513","1783",84,0,0,84,4808,0,233,5041,6.24,6.58
"1110512","1783",5,0,-1,4,4723,0,233,4956,6.13,6.47
"1110511","1783",-37,0,0,-37,4718,0,234,4952,6.12,6.46
"1110510","1783",25,0,-1,24,4733,0,234,4967,6.14,6.48
"1110509","1783",-59,0,-1,-60,4708,0,235,4943,6.11,6.45
"1110506","1783",-34,0,0,-34,4761,0,236,4997,6.18,6.52
"1110505","1783",-32,0,0,-32,4797,0,236,5033,6.22,6.56
"1110504","1783",-4,0,0,-4,4809,0,236,5045,6.24,6.58
"1110503","1783",-22,0,0,-22,4816,0,236,5052,6.25,6.59
"1110429","1783",18,0,0,18,4822,0,236,5058,6.26,6.60
"1110428","1783",-80,0,0,-80,4801,0,237,5038,6.23,6.57
"1110427","1783",39,0,-3,36,4849,0,237,5086,6.29,6.63
"1110426","1783",-74,0,-1,-75,4748,0,240,4988,6.16,6.51
"1110425","1783",-207,0,1,-206,4795,0,241,5036,6.22,6.57
"1110422","1783",79,0,0,79,4960,0,240,5200,6.44,6.79
"1110421","1783",-3,0,0,-3,4881,0,240,5121,6.33,6.68
"1110420","1783",-44,0,-1,-45,4912,0,240,5152,6.37,6.72
"1110419","1783",-256,0,0,-256,4956,0,241,5197,6.43,6.78
"1110418","1783",107,0,0,107,5212,0,241,5453,6.76,7.11
"1110415","1783",-14,0,0,-14,5105,0,241,5346,6.62,6.97
"1110414","1783",106,0,0,106,5119,0,241,5360,6.64,6.99
"1110413","1783",-7,0,4,-3,4998,0,241,5239,6.49,6.84
"1110412","1783",16,0,0,16,5005,0,237,5242,6.49,6.83
"1110411","1783",-3,0,0,-3,4989,0,237,5226,6.47,6.81
"1110408","1783",5,0,1,6,4991,0,237,5228,6.48,6.82
"1110407","1783",3,0,-1,2,4987,0,236,5223,6.47,6.81
"1110406","1783",-15,0,0,-15,4984,0,237,5221,6.47,6.81
"1110401","1783",-62,0,0,-62,4999,0,237,5236,6.49,6.83
"1110331","1783",-17,0,0,-17,5066,0,237,5303,6.57,6.91
"1110330","1783",67,0,6,73,5083,0,237,5320,6.60,6.94
"1110329","1783",-14,0,0,-14,5016,0,231,5247,6.51,6.84
"1110328","1783",-11,0,0,-11,5030,0,231,5261,6.53,6.86
"1110325","1783",-74,0,0,-74,5039,0,231,5270,6.54,6.87
"1110324","1783",-51,0,0,-51,5091,0,231,5322,6.61,6.94
"1110323","1783",-74,0,4,-70,5142,0,231,5373,6.67,7.00
"1110322","1783",-110,0,0,-110,5259,0,227,5486,6.82,7.15
"1110321","1783",57,0,0,57,5343,0,227,5570,6.93,7.26
"1110318","1783",-17,0,0,-17,5286,0,227,5513,6.86,7.19
"1110317","1783",23,0,0,23,5303,0,227,5530,6.88,7.21
"1110316","1783",-1,0,0,-1,5278,0,227,5505,6.85,7.18
"1110315","1783",-43,0,0,-43,5278,0,227,5505,6.85,7.18
"1110314","1783",-28,0,0,-28,5321,0,227,5548,6.90,7.23
"1110311","1783",-34,0,0,-34,5354,0,227,5581,6.95,7.28
"1110310","1783",3,0,0,3,5397,0,227,5624,7.00,7.33
"1110309","1783",27,0,-1,26,5384,0,227,5611,6.99,7.32
"1110308","1783",-18,0,0,-18,5349,0,228,5577,6.94,7.27
"1110307","1783",-66,0,-1,-67,5356,0,228,5584,6.95,7.28
"1110304","1783",-31,0,0,-31,5396,0,229,5625,7.00,7.33
"1110303","1783",31,0,0,31,5425,0,229,5654,7.04,7.37
"1110302","1783",2,0,5,7,5396,0,229,5625,7.00,7.33
"1110301","1783",42,0,1,43,5394,0,224,5618,7.00,7.32
"1110225","1783",-2,0,0,-2,5350,0,223,5573,6.94,7.26
"1110224","1783",-23,0,-1,-24,5344,0,223,5567,6.93,7.25
"1110223","1783",-10,0,1,-9,5356,0,224,5580,6.95,7.27
"1110222","1783",-187,0,0,-187,5435,0,223,5658,7.05,7.37
"1110221","1783",31,0,-2,29,5602,0,223,5825,7.27,7.59
"1110218","1783",4,0,0,4,5627,0,225,5852,7.30,7.62
"1110217","1783",-11,0,0,-11,5623,0,225,5848,7.30,7.62
"1110216","1783",54,0,2,56,5633,0,225,5858,7.31,7.63
"1110215","1783",74,0,0,74,5574,0,223,5797,7.23,7.55
"1110214","1783",-51,0,0,-51,5502,0,223,5725,7.14,7.46
"1110211","1783",-24,0,0,-24,5537,0,223,5760,7.19,7.51
"1110210","1783",-66,0,-1,-67,5555,0,223,5778,7.21,7.53
"1110209","1783",-14,0,3,-11,5606,0,224,5830,7.28,7.60
"1110208","1783",-5,0,0,-5,5674,0,221,5895,7.36,7.68
"1110207","1783",-112,0,0,-112,5663,0,221,5884,7.35,7.67
"1110126","1783",15,0,0,15,5749,0,221,5970,7.46,7.78
"1110125","1783",-32,0,-1,-33,5872,0,221,6093,7.62,7.94
"1110124","1783",111,0,0,111,5900,0,222,6122,7.66,7.98
"1110121","1783",3,0,0,3,5817,0,222,6039,7.55,7.87
"1110120","1783",-8,0,0,-8,5812,0,222,6034,7.54,7.86
"1110119","1783",-92,0,-3,-95,5825,0,222,6047,7.56,7.88
"1110118","1783",-30,0,0,-30,6126,0,225,6351,7.95,8.27
"1110117","1783",217,0,-1,216,6184,0,225,6409,8.03,8.35
"1110114","1783",14,0,-1,13,6004,0,226,6230,7.79,8.12
"1110113","1783",50,0,0,50,5990,0,227,6217,7.77,8.10
"1110112","1783",37,0,1,38,5940,0,227,6167,7.71,8.04
"1110111","1783",-45,0,0,-45,5903,0,226,6129,7.66,7.99
"1110110","1783",5,0,0,5,5966,0,226,6192,7.74,8.07
"1110107","1783",-17,0,0,-17,5961,0,226,6187,7.74,8.07
"1110106","1783",6,0,0,6,5980,0,226,6206,7.76,8.09
"1110105","1783",-26,0,0,-26,5980,0,226,6206,7.76,8.09
"1110104","1783",-89,0,0,-89,6006,0,226,6232,7.79,8.12
"1110103","1783",-64,0,0,-64,6103,0,226,6329,7.92,8.25
"1101230","1783",-38,0,0,-38,6148,0,226,6374,7.98,8.31
"1101229","1783",47,0,2,49,6186,0,226,6412,8.03,8.36
"1101228","1783",-33,0,0,-33,6148,0,224,6372,7.98,8.30
"1101227","1783",5,0,0,5,6189,0,224,6413,8.03,8.35
"1101224","1783",82,0,0,82,6184,0,224,6408,8.03,8.35
"1101223","1783",-38,0,0,-38,6134,0,224,6358,7.96,8.28
"1101222","1783",-26,0,0,-26,6161,0,224,6385,8.00,8.32
"1101221","1783",3,0,0,3,6187,0,224,6411,8.03,8.35
"1101220","1783",-3,0,0,-3,6166,0,224,6390,8.00,8.32
"1101217","1783",-35,0,0,-35,6167,0,224,6391,8.00,8.32
"1101216","1783",9,0,0,9,6197,0,224,6421,8.04,8.36
"1101215","1783",-1,0,0,-1,6186,0,224,6410,8.03,8.35
"1101214","1783",-73,0,0,-73,6194,0,224,6418,8.04,8.36
"1101213","1783",-45,0,0,-45,6283,0,224,6507,8.15,8.47
"1101210","1783",-140,0,0,-140,6290,0,224,6514,8.16,8.48
"1101209","1783",-179,0,0,-179,6379,0,224,6603,8.28,8.60
"1101208","1783",259,0,1,260,6568,0,224,6792,8.52,8.84
"1101207","1783",-57,0,0,-57,6309,0,223,6532,8.19,8.51
"1101206","1783",-13,0,0,-13,6344,0,223,6567,8.23,8.55
"1101203","1783",53,0,-9,44,6344,0,223,6567,8.23,8.55
"1101202","1783",-705,0,-2,-707,6304,0,232,6536,8.18,8.51
"1101201","1783",147,0,6,153,6944,0,234,7178,9.01,9.35
"1101130","1783",166,0,9,175,6770,0,228,6998,8.79,9.12
"1101129","1783",-47,0,1,-46,6574,0,219,6793,8.53,8.85
"1101126","1783",-492,0,-1,-493,6603,0,218,6821,8.57,8.88
"1101125","1783",125,0,0,125,7087,0,219,7306,9.20,9.52
"1101124","1783",24,0,3,27,6971,0,219,7190,9.05,9.37
"1101123","1783",-122,0,0,-122,6928,0,216,7144,8.99,9.30
"1101122","1783",-117,0,2,-115,7008,0,216,7224,9.10,9.41
"1101119","1783",115,0,0,115,7086,0,214,7300,9.20,9.51
"1101118","1783",80,0,0,80,6959,0,214,7173,9.03,9.34
"1101117","1783",-5,0,0,-5,6874,0,214,7088,8.92,9.23
"1101116","1783",44,0,2,46,6844,0,214,7058,8.88,9.19
"1101115","1783",-184,0,0,-184,6793,0,212,7005,8.82,9.13
"1101112","1783",-334,0,2,-332,6863,0,212,7075,8.91,9.22
"1101111","1783",-214,0,0,-214,7163,0,210,7373,9.30,9.60
"1101110","1783",-981,0,3,-978,7367,0,210,7577,9.56,9.86
"1101109","1783",143,0,0,143,8186,0,207,8393,10.63,10.93
"1101108","1783",-84,0,0,-84,8043,0,207,8250,10.44,10.74
"1101105","1783",28,0,0,28,8119,0,207,8326,10.54,10.84
"1101104","1783",57,0,0,57,8091,0,207,8298,10.50,10.80
"1101103","1783",-42,0,0,-42,8047,0,207,8254,10.45,10.75
"1101102","1783",-219,0,0,-219,8089,0,207,8296,10.50,10.80
"1101101","1783",293,0,0,293,8308,0,207,8515,10.78,11.08
"1101029","1783",-96,0,0,-96,8065,0,207,8272,10.47,10.77
"1101028","1783",67,0,0,67,8269,0,207,8476,10.73,11.03
"1101027","1783",57,0,1,58,8202,0,207,8409,10.65,10.95
"1101026","1783",28,0,0,28,8145,0,206,8351,10.57,10.87
"1101025","1783",109,0,0,109,8117,0,206,8323,10.54,10.84
"1101022","1783",-118,0,0,-118,8008,0,206,8214,10.39,10.69
"1101021","1783",46,0,0,46,8106,0,206,8312,10.52,10.82
"1101020","1783",27,0,0,27,8059,0,206,8265,10.46,10.76
"1101019","1783",-87,0,2,-85,8032,0,206,8238,10.43,10.73
"1101018","1783",91,0,0,91,8117,0,204,8321,10.54,10.83
"1101015","1783",41,0,1,42,8012,0,204,8216,10.40,10.69
"1101014","1783",107,0,1,108,7965,0,203,8168,10.34,10.63
"1101013","1783",-236,0,1,-235,7858,0,202,8060,10.20,10.49
"1101012","1783",-622,0,-1,-623,8093,0,201,8294,10.50,10.79
"1101008","1783",-256,0,0,-256,8670,0,202,8872,11.25,11.54
"1101007","1783",128,0,4,132,8905,0,202,9107,11.56,11.85
"1101006","1783",-314,0,-5,-319,8767,0,198,8965,11.38,11.67
"1101005","1783",77,0,0,77,9075,0,203,9278,11.78,12.07
"1101004","1783",368,0,0,368,8998,0,203,9201,11.68,11.97
"1101001","1783",400,0,0,400,8630,0,203,8833,11.20,11.49
"1100930","1783",-142,0,0,-142,8228,0,203,8431,10.68,10.97
"1100929","1783",-259,0,-4,-263,8361,0,203,8564,10.85,11.14
"1100928","1783",-688,0,0,-688,8640,0,207,8847,11.22,11.52
"1100927","1783",34,0,0,34,9233,0,207,9440,11.99,12.29
"1100924","1783",-6,0,0,-6,9204,0,207,9411,11.95,12.25
"1100923","1783",-253,0,0,-253,9209,0,207,9416,11.95,12.25
"1100922","1783",170,0,-11,159,9462,0,207,9669,12.28,12.58
"1100917","1783",20,0,0,20,9292,0,218,9510,12.06,12.37
"1100916","1783",98,0,-2,96,9272,0,218,9490,12.04,12.35
"1100915","1783",29,0,-10,19,9243,0,220,9463,12.00,12.32
"1100914","1783",20,0,0,20,9226,0,230,9456,11.98,12.31
"1100913","1783",264,0,0,264,9210,0,230,9440,13.25,13.58
"1100910","1783",-247,0,1,-246,8946,0,230,9176,12.87,13.20
"1100909","1783",372,0,-2,370,9193,0,229,9422,13.23,13.56
"1100908","1783",-340,0,-8,-348,8872,0,231,9103,12.77,13.10
"1100907","1783",533,0,0,533,9177,0,239,9416,13.21,13.55
"1100906","1783",656,0,0,656,8644,0,239,8883,12.44,12.78
"1100903","1783",134,0,2,136,7990,0,239,8229,11.50,11.84
"1100902","1783",272,0,0,272,7850,0,237,8087,11.30,11.64
"1100901","1783",-489,0,-1,-490,7562,0,237,7799,10.88,11.22
"1100831","1783",31,0,0,31,8064,0,238,8302,11.60,11.94
"1100830","1783",192,0,0,192,8034,0,238,8272,11.56,11.90
"1100827","1783",-2,0,4,2,7813,0,238,8051,11.24,11.58
"1100826","1783",-716,0,0,-716,7800,0,234,8034,11.22,11.56
"1100825","1783",744,0,-8,736,8425,0,234,8659,12.12,12.46
"1100824","1783",-375,0,-18,-393,7669,0,242,7911,11.03,11.38
"1100823","1783",611,0,-24,587,7946,0,260,8206,11.43,11.80
"1100820","1783",-1779,0,0,-1779,7332,0,284,7616,10.55,10.96
"1100819","1783",709,0,-10,699,9111,0,284,9395,13.11,13.52
"1100818","1783",432,0,1,433,8402,0,294,8696,12.09,12.51
"1100817","1783",148,0,0,148,7956,0,293,8249,11.45,11.87
"1100816","1783",108,0,0,108,7808,0,293,8101,11.23,11.65
"1100813","1783",131,0,0,131,7774,0,293,8067,11.19,11.61
"1100812","1783",102,0,10,112,7643,0,293,7936,11.00,11.42
"1100811","1783",491,0,25,516,7541,0,283,7824,10.85,11.26
"1100810","1783",295,0,0,295,7068,0,258,7326,10.17,10.54
"1100809","1783",-109,0,26,-83,6759,0,258,7017,9.72,10.09
"1100806","1783",43,0,7,50,6868,0,232,7100,9.88,10.21
"1100805","1783",41,0,4,45,6836,0,225,7061,9.84,10.16
"1100804","1783",0,0,69,69,6890,0,221,7111,9.91,10.23
"1100803","1783",309,0,10,319,6890,0,152,7042,9.91,10.13
"1100802","1783",800,0,2,802,6581,0,142,6723,9.47,9.67
"1100730","1783",-256,0,0,-256,5781,0,140,5921,8.32,8.52
"1100729","1783",-212,0,0,-212,6093,0,140,6233,8.77,8.97
"1100728","1783",182,0,0,182,6362,0,140,6502,9.15,9.35
"1100727","1783",438,0,1,439,6274,0,140,6414,9.03,9.23
"1100726","1783",126,0,0,126,5829,0,139,5968,8.39,8.59
"1100723","1783",-71,0,0,-71,5697,0,139,5836,8.20,8.40
"1100722","1783",-296,0,1,-295,5768,0,139,5907,8.30,8.50
"1100721","1783",-276,0,0,-276,6057,0,138,6195,8.71,8.91
"1100720","1783",-171,0,0,-171,6237,0,138,6375,8.97,9.17
"1100719","1783",277,0,0,277,6464,0,138,6602,9.30,9.50
"1100716","1783",-220,0,0,-220,6188,0,138,6326,8.90,9.10
"1100715","1783",-423,0,0,-423,6401,0,138,6539,9.21,9.41
"1100714","1783",601,0,1,602,6822,0,138,6960,9.82,10.02
"1100713","1783",144,0,2,146,6217,0,137,6354,8.94,9.14
"1100712","1783",-405,0,0,-405,6103,0,135,6238,8.78,8.97
"1100709","1783",217,0,0,217,6508,0,135,6643,9.36,9.55
"1100708","1783",298,0,0,298,6302,0,135,6437,9.07,9.26
"1100707","1783",27,0,1,28,6007,0,135,6142,8.64,8.83
"1100706","1783",36,0,0,36,5977,0,134,6111,8.60,8.79
"1100705","1783",35,0,1,36,5948,0,134,6082,8.56,8.75
"1100702","1783",85,0,0,85,5965,0,133,6098,8.58,8.77
"1100701","1783",4,0,0,4,5880,0,133,6013,8.46,8.65
"1100630","1783",-184,0,0,-184,5886,0,133,6019,8.47,8.66
"1100629","1783",90,0,0,90,6099,0,133,6232,8.77,8.96
"1100628","1783",156,0,0,156,6009,0,133,6142,8.64,8.83
"1100625","1783",95,0,0,95,5887,0,133,6020,8.47,8.66
"1100624","1783",187,0,0,187,5852,0,133,5985,8.42,8.61
"1100623","1783",-15,0,0,-15,5658,0,133,5791,8.14,8.33
"1100622","1783",-108,0,0,-108,5673,0,133,5806,8.16,8.35
"1100621","1783",40,0,0,40,5781,0,133,5914,8.32,8.51
"1100618","1783",86,0,0,86,5741,0,133,5874,8.26,8.45
"1100617","1783",-9,0,0,-9,5653,0,133,5786,8.13,8.32
"1100616","1783",38,0,0,38,5662,0,133,5795,8.15,8.34
"1100615","1783",-25,0,0,-25,5624,0,133,5757,8.09,8.28
"1100611","1783",-42,0,0,-42,5643,0,133,5776,8.12,8.31
"1100610","1783",92,0,0,92,5685,0,133,5818,8.18,8.37
"1100609","1783",92,0,0,92,5664,0,133,5797,8.15,8.34
"1100608","1783",-4,0,0,-4,5570,0,133,5703,8.01,8.20
"1100607","1783",-68,0,0,-68,5584,0,133,5717,8.03,8.22
"1100604","1783",-286,0,0,-286,5638,0,133,5771,8.11,8.30
"1100603","1783",241,0,0,241,5875,0,133,6008,8.45,8.64
"1100602","1783",177,0,0,177,5644,0,133,5777,8.12,8.31
"1100601","1783",109,0,0,109,5461,0,133,5594,7.86,8.05
"1100531","1783",102,0,0,102,5475,0,133,5608,7.88,8.07
"1100528","1783",-165,0,0,-165,5298,0,133,5431,7.62,7.81
"1100527","1783",67,0,0,67,5378,0,133,5511,7.74,7.93
"1100526","1783",-167,0,0,-167,5348,0,133,5481,7.69,7.88
"1100525","1783",-53,0,0,-53,5498,0,133,5631,7.91,8.10
"1100524","1783",-532,0,0,-532,5589,0,133,5722,8.04,8.23
"1100521","1783",196,0,-9,187,6065,0,133,6198,8.73,8.92
"1100520","1783",487,0,0,487,5862,0,142,6004,8.43,8.63
"1100519","1783",-95,0,0,-95,5375,0,142,5517,7.73,7.93
"1100518","1783",-451,0,0,-451,5427,0,142,5569,7.81,8.01
"1100517","1783",623,0,-1,622,5841,0,142,5983,8.40,8.60
"1100514","1783",-9,0,0,-9,5222,0,143,5365,7.51,7.72
"1100513","1783",-537,0,-21,-558,5210,0,143,5353,7.49,7.70
"1100512","1783",45,0,23,68,5703,0,164,5867,8.20,8.44
"1100511","1783",-105,0,0,-105,5637,0,141,5778,8.11,8.31
"1100510","1783",130,0,0,130,5718,0,141,5859,8.23,8.43
"1100507","1783",81,0,0,81,5592,0,141,5733,8.04,8.24
"1100506","1783",47,0,1,48,5511,0,141,5652,7.93,8.13
"1100505","1783",202,0,0,202,5455,0,140,5595,7.85,8.05
"1100504","1783",-75,0,0,-75,5251,0,140,5391,7.55,7.75
"1100503","1783",-20,0,-1,-21,5304,0,140,5444,7.63,7.83
"1100429","1783",32,0,1,33,5267,0,141,5408,7.58,7.78
"1100428","1783",25,0,0,25,5235,0,140,5375,7.53,7.73
"1100427","1783",-7,0,0,-7,5215,0,140,5355,7.50,7.70
"1100426","1783",28,0,0,28,5253,0,140,5393,7.56,7.76
"1100423","1783",17,0,0,17,5225,0,140,5365,7.52,7.72
"1100422","1783",-38,0,0,-38,5098,0,140,5238,7.33,7.53
"1100421","1783",-109,0,0,-109,5124,0,140,5264,7.37,7.57
"1100420","1783",-571,0,2,-569,5221,0,140,5361,7.51,7.71
"1100419","1783",159,0,58,217,5786,0,138,5924,8.32,8.52
"1100416","1783",22,0,32,54,5667,0,80,5747,8.15,8.27
"1100415","1783",365,0,28,393,5645,0,48,5693,8.12,8.19
"1100414","1783",28,0,19,47,5280,0,20,5300,7.60,7.63
"1100413","1783",-67,0,1,-66,5267,0,1,5268,7.58,7.58
"1100412","1783",39,0,0,39,5334,0,0,5334,7.67,7.67
"1100409","1783",116,0,0,116,5295,0,0,5295,7.62,7.62
"1100408","1783",-99,0,0,-99,5178,0,0,5178,7.45,7.45
"1100407","1783",55,0,0,55,5236,0,0,5236,7.53,7.53
"1100406","1783",38,0,0,38,5181,0,0,5181,7.45,7.45
"1100401","1783",-36,0,0,-36,5143,0,0,5143,7.40,7.40
"1100331","1783",79,0,0,79,5177,0,0,5177,7.45,7.45
"1100330","1783",-51,0,0,-51,5098,0,0,5098,7.33,7.33
"1100329","1783",-48,0,-1,-49,5124,0,0,5124,7.37,7.37
"1100326","1783",-75,0,-2,-77,5171,0,1,5172,7.44,7.44
"1100325","1783",-65,0,0,-65,5246,0,3,5249,7.55,7.55
"1100324","1783",-110,0,3,-107,5301,0,3,5304,7.63,7.63
"1100323","1783",75,0,-2,73,5405,0,0,5405,7.78,7.78
"1100322","1783",-96,0,-5,-101,5332,0,0,5332,7.67,7.67
"1100319","1783",-25,0,-5,-30,5428,0,0,5428,7.81,7.81
"1100318","1783",228,0,-1,227,5453,0,5,5458,7.84,7.85
"1100317","1783",15,0,0,15,5233,0,6,5239,7.53,7.54
"1100316","1783",-24,0,0,-24,5218,0,6,5224,7.51,7.52
"1100315","1783",-15,0,0,-15,5239,0,6,5245,7.54,7.55
"1100312","1783",1,0,0,1,5254,0,6,5260,7.56,7.57
"1100311","1783",14,0,5,19,5244,0,6,5250,7.54,7.55
"1100310","1783",26,0,0,26,5243,0,1,5244,7.54,7.54
"1100309","1783",-3,0,0,-3,5205,0,1,5206,7.49,7.49
"1100308","1783",-3,0,-4,-7,5208,0,1,5209,7.49,7.49
"1100305","1783",7,0,0,7,5223,0,5,5228,7.51,7.52
"1100304","1783",-17,0,-5,-22,5216,0,5,5221,7.50,7.51
"1100303","1783",-4,0,1,-3,5233,0,10,5243,7.53,7.54
"1100302","1783",-37,0,0,-37,5237,0,9,5246,7.53,7.54
"1100226","1783",-19,0,0,-19,5274,0,9,5283,7.59,7.60
"1100225","1783",1,0,0,1,5293,0,9,5302,7.61,7.62
"1100224","1783",-20,0,-2,-22,5292,0,9,5301,7.61,7.62
"1100223","1783",14,0,0,14,5312,0,11,5323,7.64,7.66
"1100222","1783",29,0,-1,28,5299,0,11,5310,7.62,7.64
"1100219","1783",19,0,0,19,5269,0,12,5281,7.58,7.60
"1100218","1783",22,0,0,22,5250,0,12,5262,7.55,7.57
"1100217","1783",0,0,0,0,5228,0,12,5240,7.52,7.54
"1100205","1783",-4,0,0,-4,5228,0,12,5240,7.52,7.54
"1100204","1783",-4,0,-1,-5,5232,0,12,5244,7.53,7.55
"1100203","1783",-3,0,0,-3,5236,0,13,5249,7.53,7.55
"1100202","1783",5,0,2,7,5239,0,13,5252,7.54,7.56
"1100201","1783",13,0,2,15,5234,0,11,5245,7.53,7.55
"1100129","1783",-20,0,0,-20,5221,0,9,5230,7.51,7.52
"1100128","1783",-11,0,0,-11,5241,0,9,5250,7.54,7.55
"1100127","1783",-6,0,0,-6,5252,0,9,5261,7.56,7.57
"1100126","1783",-6,0,0,-6,5258,0,9,5267,7.56,7.57
"1100125","1783",4,0,0,4,5264,0,9,5273,7.57,7.58
"1100122","1783",9,0,0,9,5260,0,9,5269,7.57,7.58
"1100121","1783",6,0,0,6,5251,0,9,5260,7.55,7.56
"1100120","1783",-29,0,0,-29,5243,0,9,5252,7.54,7.55
"1100119","1783",-24,0,0,-24,5272,0,9,5281,7.58,7.59
"1100118","1783",-6,0,0,-6,5296,0,9,5305,7.62,7.63
"1100115","1783",-22,0,0,-22,5302,0,9,5311,7.63,7.64
"1100114","1783",-5,0,0,-5,5324,0,9,5333,7.66,7.67
"1100113","1783",24,0,-1,23,5329,0,9,5338,7.67,7.68
"1100112","1783",-10,0,0,-10,5305,0,10,5315,7.63,7.64
"1100111","1783",-16,0,0,-16,5315,0,10,5325,7.65,7.66
"1100108","1783",-3,0,2,-1,5331,0,10,5341,7.67,7.68
"1100107","1783",3,0,0,3,5334,0,8,5342,7.67,7.68
"1100106","1783",-28,0,0,-28,5331,0,8,5339,7.67,7.68
"1100105","1783",-2,0,0,-2,5359,0,8,5367,7.71,7.72
"1100104","1783",1,0,0,1,5378,0,8,5386,7.74,7.75
"1091231","1783",18,0,0,18,5377,0,8,5385,7.74,7.75
"1091230","1783",34,0,0,34,5359,0,8,5367,7.71,7.72
"1091229","1783",10,0,0,10,5325,0,8,5333,7.66,7.67
"1091228","1783",24,0,0,24,5315,0,8,5323,7.65,7.66
"1091225","1783",1,0,0,1,5291,0,8,5299,7.61,7.62
"1091224","1783",-2,0,0,-2,5290,0,8,5298,7.61,7.62
"1091223","1783",-7,0,0,-7,5292,0,8,5300,7.61,7.62
"1091222","1783",-4,0,0,-4,5299,0,8,5307,7.62,7.63
"1091221","1783",5,0,-1,4,5303,0,8,5311,7.63,7.64
"1091218","1783",-5,0,-1,-6,5300,0,9,5309,7.62,7.63
"1091217","1783",-2,0,-1,-3,5305,0,10,5315,7.63,7.64
"1091216","1783",14,0,1,15,5307,0,11,5318,7.63,7.65
"1091215","1783",-4,0,0,-4,5293,0,10,5303,7.61,7.62
"1091214","1783",7,0,0,7,5297,0,10,5307,7.62,7.63
"1091211","1783",-33,0,0,-33,5290,0,10,5300,7.61,7.62
"1091210","1783",0,0,0,0,5323,0,10,5333,7.66,7.67
"1091209","1783",20,0,0,20,5323,0,10,5333,7.66,7.67
"1091208","1783",-1,0,0,-1,5303,0,10,5313,7.63,7.64
"1091207","1783",-3,0,0,-3,5321,0,10,5331,7.65,7.66
"1091204","1783",2,0,0,2,5324,0,10,5334,7.66,7.67
"1091203","1783",10,0,0,10,5322,0,10,5332,7.66,7.67
"1091202","1783",-15,0,0,-15,5312,0,10,5322,7.64,7.65
"1091201","1783",-1,0,-1,-2,5327,0,10,5337,7.66,7.67
"1091130","1783",10,0,0,10,5328,0,11,5339,7.66,7.68
"1091127","1783",3,0,0,3,5324,0,11,5335,7.66,7.68
"1091126","1783",20,0,0,20,5331,0,11,5342,7.67,7.69
"1091125","1783",-10,0,0,-10,5301,0,11,5312,7.63,7.65
"1091124","1783",-5,0,0,-5,5311,0,11,5322,7.64,7.66
"1091123","1783",25,0,1,26,5319,0,11,5330,7.65,7.67
"1091120","1783",15,0,0,15,5294,0,10,5304,7.62,7.63
"1091119","1783",-3,0,0,-3,5279,0,10,5289,7.59,7.60
"1091118","1783",25,0,0,25,5282,0,10,5292,7.60,7.61
"1091117","1783",19,0,0,19,5257,0,10,5267,7.56,7.57
"1091116","1783",5,0,1,6,5238,0,10,5248,7.53,7.54
"1091113","1783",15,0,0,15,5236,0,9,5245,7.53,7.54
"1091112","1783",-1,0,-1,-2,5220,0,9,5229,7.51,7.52
"1091111","1783",-9,0,0,-9,5238,0,10,5248,7.53,7.54
"1091110","1783",-30,0,0,-30,5245,0,10,5255,7.54,7.55
"1091109","1783",8,0,2,10,5274,0,10,5284,7.59,7.60
"1091106","1783",7,0,0,7,5266,0,8,5274,7.58,7.59
"1091105","1783",1,0,8,9,5265,0,8,5273,7.57,7.58
"1091104","1783",2,0,0,2,5292,0,0,5292,7.61,7.61
"1091103","1783",6,0,-1,5,5290,0,0,5290,7.61,7.61
"1091102","1783",0,0,-2,-2,5293,0,0,5293,7.61,7.61
"1091030","1783",-2,0,0,-2,5301,0,0,5301,7.63,7.63
"1091029","1783",15,0,-9,6,5303,0,0,5303,7.63,7.63
"1091028","1783",-39,0,0,-39,5287,0,0,5287,7.61,7.61
"1091027","1783",1,0,0,1,5326,0,0,5326,7.66,7.66
"1091026","1783",-15,0,0,-15,5325,0,0,5325,7.66,7.66
"1091023","1783",17,0,0,17,5340,0,0,5340,7.68,7.68
"1091022","1783",-2,0,0,-2,5323,0,0,5323,7.66,7.66
"1091021","1783",-15,-6,0,-21,5325,0,0,5325,7.66,7.66
"1091020","1783",-11,0,0,-11,5340,6,0,5346,7.68,7.69
"1091019","1783",16,0,0,16,5351,6,0,5357,7.70,7.71
"1091016","1783",-24,0,0,-24,5335,6,0,5341,7.67,7.68
"1091015","1783",-19,0,0,-19,5372,6,0,5378,7.73,7.74
"1091014","1783",64,0,0,64,5393,6,0,5399,7.76,7.77
"1091013","1783",1,0,-1,0,5322,6,0,5328,7.66,7.67
"1091012","1783",-22,0,0,-22,5328,6,1,5335,7.66,7.67
"1091008","1783",-1,0,0,-1,5350,6,1,5357,7.70,7.71
"1091007","1783",10,0,1,11,5351,6,1,5358,7.70,7.71
"1091006","1783",39,0,0,39,5341,6,0,5347,7.68,7.69
"1091005","1783",11,0,0,11,5302,6,0,5308,7.63,7.64
"1090930","1783",40,0,0,40,5291,6,0,5297,7.61,7.62
"1090929","1783",-18,0,0,-18,5263,6,0,5269,7.57,7.58
"1090928","1783",-5,0,0,-5,5281,6,0,5287,7.60,7.61
"1090925","1783",-87,0,0,-87,5286,6,0,5292,7.60,7.61
"1090924","1783",-101,0,0,-101,5356,6,0,5362,7.70,7.71
"1090923","1783",-43,0,-15,-58,5457,6,0,5463,7.85,7.86
"1090922","1783",-50,0,1,-49,5500,6,1,5507,7.91,7.92
"1090921","1783",31,0,-1,30,5550,6,0,5556,7.98,7.99
"1090918","1783",40,0,0,40,5519,6,0,5525,7.94,7.95
"1090917","1783",52,0,-1,51,5479,6,0,5485,7.88,7.89
"1090916","1783",33,0,-2,31,5427,6,0,5433,7.81,7.82
"1090915","1783",79,0,0,79,5394,6,0,5400,7.76,7.77
"1090914","1783",14,0,0,14,5315,6,0,5321,7.65,7.66
"1090911","1783",-55,0,0,-55,5301,6,0,5307,7.63,7.64
"1090910","1783",-39,0,-6,-45,5355,6,0,5361,7.70,7.71
"1090909","1783",-26,0,-3,-29,5394,6,0,5400,7.76,7.77
"1090908","1783",-16,0,0,-16,5422,6,2,5430,7.80,7.81
"1090907","1783",20,0,2,22,5437,6,2,5445,7.82,7.83
"1090904","1783",3,0,-30,-27,5417,6,0,5423,7.79,7.80
"1090903","1783",-17,0,-11,-28,5429,6,0,5435,7.81,7.82
"1090902","1783",66,0,-1,65,5446,6,1,5453,7.83,7.84
"1090901","1783",-48,0,0,-48,5380,6,2,5388,7.74,7.75
"1090831","1783",-67,0,0,-67,5428,6,2,5436,7.81,7.82
"1090828","1783",35,0,0,35,5495,6,2,5503,7.90,7.91
"1090827","1783",-32,0,2,-30,5461,6,2,5469,7.86,7.87
"1090826","1783",112,0,0,112,5493,6,0,5499,7.90,7.91
"1090825","1783",-11,0,0,-11,5392,6,0,5398,7.76,7.77
"1090824","1783",59,0,0,59,5421,6,0,5427,7.80,7.81
"1090821","1783",149,0,-4,145,5362,6,0,5368,7.71,7.72
"1090820","1783",-117,0,0,-117,5172,6,0,5178,7.44,7.45
"1090819","1783",-55,0,0,-55,5261,6,0,5267,7.57,7.58
"1090818","1783",-13,0,-8,-21,5303,6,0,5309,7.63,7.64
"1090817","1783",64,0,-10,54,5300,6,0,5306,7.62,7.63
"1090814","1783",77,0,1,78,5241,6,1,5248,7.54,7.55
"1090813","1783",-19,0,-8,-27,5174,6,0,5180,7.44,7.45
"1090812","1783",31,0,-3,28,5248,6,0,5254,7.55,7.56
"1090811","1783",-30,0,-1,-31,5217,6,0,5223,7.50,7.51
"1090810","1783",2,0,-78,-76,5247,6,0,5253,7.55,7.56
"1090807","1783",86,0,0,86,5228,6,0,5234,7.52,7.53
"1090806","1783",112,0,-15,97,5178,6,0,5184,7.45,7.46
"1090805","1783",95,0,0,95,5066,6,0,5072,7.29,7.30
"1090804","1783",17,0,-20,-3,5174,6,0,5180,7.44,7.45
"1090803","1783",108,0,0,108,5162,6,12,5180,7.43,7.46
"1090731","1783",9,0,0,9,5060,6,12,5078,7.28,7.31
"1090730","1783",43,0,0,43,5240,6,12,5258,7.54,7.57
"1090729","1783",199,0,0,199,5273,6,12,5291,7.59,7.62
"1090728","1783",98,0,0,98,5107,6,12,5125,7.35,7.38
"1090727","1783",2,0,0,2,5019,6,12,5037,7.22,7.25
"1090724","1783",-17,0,0,-17,5061,6,12,5079,7.28,7.31
"1090723","1783",39,0,1,40,5028,6,12,5046,7.23,7.26
"1090722","1783",25,0,2,27,4970,6,11,4987,7.15,7.17
"1090721","1783",-48,0,0,-48,4989,6,9,5004,7.18,7.20
"1090720","1783",222,0,0,222,5066,6,9,5081,7.29,7.31
"1090717","1783",-11,0,0,-11,4834,6,9,4849,6.95,6.97
"1090716","1783",8,6,-1,13,4915,6,9,4930,7.07,7.09
"1090715","1783",31,0,0,31,4911,0,10,4921,7.06,7.07
"1090714","1783",-91,0,0,-91,4852,0,10,4862,6.98,6.99
"1090713","1783",0,0,1,1,4931,0,10,4941,7.09,7.10
"1090710","1783",-101,0,0,-101,4929,0,9,4938,7.09,7.10
"1090709","1783",-88,0,0,-88,5021,0,9,5030,7.22,7.23
"1090708","1783",265,0,-1,264,5133,0,9,5142,7.38,7.39
"1090707","1783",13,0,0,13,4864,0,10,4874,7.00,7.01
"1090706","1783",-6,0,1,-5,4833,0,10,4843,6.95,6.96
"1090703","1783",16,0,0,16,4856,0,9,4865,6.99,7.00
"1090702","1783",-162,0,0,-162,4822,0,9,4831,6.94,6.95
"1090701","1783",164,0,0,164,4981,0,9,4990,7.16,7.17
"1090630","1783",-11,0,0,-11,4795,0,9,4804,6.90,6.91
"1090629","1783",-44,0,0,-44,4782,0,9,4791,6.88,6.89
"1090624","1783",-82,0,0,-82,4796,0,9,4805,6.90,6.91
"1090623","1783",-261,0,-1,-262,4805,0,9,4814,6.91,6.92
"1090622","1783",66,0,0,66,5008,0,10,5018,7.20,7.21
"1090619","1783",-287,0,0,-287,4963,0,10,4973,7.14,7.15
"1090618","1783",-432,0,-1,-433,5133,0,10,5143,7.38,7.39
"1090617","1783",-88,0,0,-88,5506,0,11,5517,7.92,7.94
"1090616","1783",-168,0,0,-168,5647,0,11,5658,8.12,8.14
"1090615","1783",349,0,-2,347,5784,0,11,5795,8.32,8.34
"1090612","1783",49,0,0,49,5435,0,13,5448,7.82,7.84
"1090611","1783",-164,0,0,-164,5358,0,13,5371,7.71,7.73
"1090610","1783",55,0,0,55,5493,0,13,5506,7.90,7.92
"1090609","1783",-2,0,0,-2,5427,0,13,5440,7.81,7.83
"1090608","1783",-3,0,3,0,5384,0,13,5397,7.75,7.77
"1090605","1783",-304,0,0,-304,5367,0,10,5377,7.72,7.73
"1090604","1783",4,0,0,4,5644,0,10,5654,8.12,8.13
"1090603","1783",100,0,1,101,5640,0,10,5650,8.11,8.12
"1090602","1783",29,0,0,29,5540,0,9,5549,7.97,7.98
"1090601","1783",12,0,3,15,5466,0,9,5475,7.86,7.87
"1090529","1783",59,0,0,59,5338,0,6,5344,7.68,7.69
"1090528","1783",-19,0,-1,-20,5271,0,6,5277,7.58,7.59
"1090527","1783",54,0,2,56,5270,0,7,5277,7.58,7.59
"1090526","1783",-71,0,0,-71,5208,0,5,5213,7.49,7.50
"1090525","1783",-3,0,0,-3,5277,0,5,5282,7.59,7.60
"1090522","1783",-50,0,0,-50,5240,0,5,5245,7.54,7.55
"1090521","1783",-30,0,0,-30,5287,0,5,5292,7.61,7.62
"1090520","1783",-24,0,0,-24,5315,0,5,5320,7.65,7.66
"1090519","1783",-229,0,2,-227,5302,0,5,5307,7.63,7.64
"1090518","1783",-62,0,3,-59,5531,0,3,5534,7.96,7.96
"1090515","1783",35,0,0,35,5586,0,0,5586,8.04,8.04
"1090514","1783",-143,0,0,-143,5547,0,0,5547,7.98,7.98
"1090513","1783",-79,0,0,-79,5683,0,0,5683,8.18,8.18
"1090512","1783",-56,0,0,-56,5762,0,0,5762,8.29,8.29
"1090511","1783",108,0,0,108,5817,0,0,5817,8.37,8.37
"1090508","1783",247,0,0,247,5709,0,0,5709,8.21,8.21
"1090507","1783",27,0,0,27,5445,0,0,5445,7.83,7.83
"1090506","1783",131,0,0,131,5418,0,0,5418,7.79,7.79
"1090505","1783",-54,0,0,-54,5287,0,0,5287,7.61,7.61
"1090504","1783",10,0,0,10,5340,0,0,5340,7.68,7.68
"1090430","1783",-28,0,0,-28,5280,0,0,5280,7.60,7.60
"1090429","1783",40,0,0,40,5308,0,0,5308,7.64,7.64
"1090428","1783",-58,0,0,-58,5268,0,0,5268,7.58,7.58
"1090427","1783",25,0,0,25,5318,0,0,5318,7.65,7.65
"1090424","1783",6,0,0,6,5293,0,0,5293,7.61,7.61
"1090423","1783",3,0,0,3,5287,0,0,5287,7.61,7.61
"1090422","1783",53,0,0,53,5284,0,0,5284,7.60,7.60
"1090421","1783",-99,0,0,-99,5231,0,0,5231,7.52,7.52
"1090420","1783",40,0,0,40,5330,0,0,5330,7.67,7.67
"1090417","1783",-57,0,0,-57,5290,0,0,5290,7.61,7.61
"1090416","1783",34,0,0,34,5347,0,0,5347,7.69,7.69
"1090415","1783",-140,0,0,-140,5313,0,0,5313,7.64,7.64
"1090414","1783",13,0,-5,8,5453,0,0,5453,7.84,7.84
"1090413","1783",-100,0,0,-100,5440,0,5,5445,7.83,7.84
"1090410","1783",37,0,-3,34,5513,0,5,5518,7.93,7.94
"1090409","1783",-19,0,0,-19,5476,0,8,5484,7.88,7.89
"1090408","1783",0,0,0,0,5495,0,8,5503,7.90,7.91
"1090407","1783",1,0,0,1,5495,0,8,5503,7.90,7.91
"1090406","1783",36,0,0,36,5494,0,8,5502,7.90,7.91
"1090401","1783",5,0,0,5,5458,0,8,5466,7.85,7.86
"1090331","1783",-63,0,0,-63,5453,0,8,5461,7.84,7.85
"1090330","1783",-2,0,-7,-9,5516,0,8,5524,7.94,7.95
"1090327","1783",-11,0,-1,-12,5518,0,15,5533,7.94,7.96
"1090326","1783",-1,0,0,-1,5529,0,16,5545,7.95,7.97
"1090325","1783",56,0,0,56,5554,0,16,5570,7.99,8.01
"1090324","1783",33,0,0,33,5498,0,16,5514,7.91,7.93
"1090323","1783",25,0,0,25,5466,0,16,5482,7.86,7.88
"1090320","1783",79,0,-1,78,5441,0,16,5457,7.83,7.85
"1090319","1783",43,0,1,44,5361,0,17,5378,7.71,7.73
"1090318","1783",-15,0,4,-11,5316,0,16,5332,7.65,7.67
"1090317","1783",32,0,0,32,5329,0,12,5341,7.67,7.69
"1090316","1783",-18,0,0,-18,5297,0,12,5309,7.62,7.64
"1090313","1783",1,0,0,1,5315,0,12,5327,7.65,7.67
"1090312","1783",-7,0,0,-7,5314,0,12,5326,7.64,7.66
"1090311","1783",-19,0,0,-19,5320,0,12,5332,7.65,7.67
"1090310","1783",-5,0,0,-5,5339,0,12,5351,7.68,7.70
"1090309","1783",-30,0,0,-30,5344,0,12,5356,7.69,7.71
"1090306","1783",-6,0,-1,-7,5375,0,12,5387,7.73,7.75
"1090305","1783",-4,0,0,-4,5381,0,13,5394,7.74,7.76
"1090304","1783",0,0,0,0,5386,0,13,5399,7.75,7.77
"1090303","1783",-3,0,-2,-5,5386,0,13,5399,7.75,7.77
"1090302","1783",52,0,3,55,13299,0,15,13314,17.18,17.20
"1090227","1783",-21,0,0,-21,13247,0,12,13259,17.12,17.14
"1090226","1783",-4,0,0,-4,13271,0,12,13283,17.15,17.17
"1090225","1783",-2,0,0,-2,13275,0,12,13287,17.15,17.17
"1090224","1783",24,0,0,24,13277,0,12,13289,17.15,17.17
"1090221","1783",12,0,0,12,13253,0,12,13265,17.12,17.14
"1090220","1783",4,0,0,4,13257,0,12,13269,17.13,17.15
"1090219","1783",9,0,0,9,13253,0,12,13265,17.12,17.14
"1090218","1783",-4,0,0,-4,13244,0,12,13256,17.11,17.13
"1090217","1783",2,0,0,2,13248,0,12,13260,17.12,17.14
"1090214","1783",3,0,0,3,13245,0,12,13257,17.11,17.13
"1090213","1783",-8,0,0,-8,13241,0,12,13253,17.11,17.13
"1090212","1783",0,0,0,0,13249,0,12,13261,17.12,17.14
"1090211","1783",-2,0,0,-2,13249,0,12,13261,17.12,17.14
"1090210","1783",0,0,0,0,13251,0,12,13263,17.12,17.14
"1090207","1783",-21,0,0,-21,13252,0,12,13264,17.12,17.14
"1090206","1783",-2,0,0,-2,13273,0,12,13285,17.15,17.17
"1090205","1783",-7,0,-1,-8,13276,0,12,13288,17.15,17.17
"1090204","1783",3,0,0,3,13268,0,13,13281,17.14,17.16
"1090203","1783",-1,0,1,0,13265,0,13,13278,17.14,17.16
"1090131","1783",-5,0,0,-5,13265,0,12,13277,17.14,17.16
"1090130","1783",11,0,0,11,13267,0,12,13279,17.14,17.16
"1090120","1783",-3,0,0,-3,13256,0,12,13268,17.13,17.15
"1090117","1783",4,0,0,4,13259,0,12,13271,17.13,17.15
"1090116","1783",-2,0,0,-2,13255,0,12,13267,17.13,17.15
"1090115","1783",1,0,0,1,13257,0,12,13269,17.13,17.15
"1090114","1783",1,0,0,1,13241,0,12,13253,17.11,17.13
"1090113","1783",-5,0,0,-5,13239,0,12,13251,17.10,17.12
"1090110","1783",7,0,0,7,13244,0,12,13256,17.11,17.13
"1090109","1783",0,0,0,0,13236,0,12,13248,17.10,17.12
"1090108","1783",-5,0,0,-5,13235,0,12,13247,17.10,17.12
"1090107","1783",-37,0,0,-37,13240,0,12,13252,17.11,17.13
"1090106","1783",-62,0,0,-62,13277,0,12,13289,17.15,17.17
"1090103","1783",-11,0,-1,-12,13339,0,12,13351,17.23,17.25
"1090102","1783",3,0,0,3,13350,0,13,13363,17.25,17.27
"1120517","1783",-624,0,77,-547,9883,1902,680,12465,11.66,14.71
"1120516","1783",-217,0,8,-209,10485,1902,603,12990,12.37,15.33
"1120515","1783",-7,0,1,-6,10708,1902,596,13206,12.64,15.59
"1120518","1783",-238,0,37,-201,9667,1902,717,12286,11.41,14.50
"1120519","1783",-762,0,27,-735,8908,1902,744,11554,10.51,13.63
"1120522","1783",-20,0,-1,-21,8904,1902,743,11549,10.51,13.63
"1120523","1783",-67,0,18,-49,8849,1902,761,11512,10.44,13.58
"1120529","1783",32,0,-9,23,6730,1602,753,9085,7.94,10.72
"1120526","1783",-695,-300,-1,-996,6693,1602,763,9058,7.90,10.69
"1120525","1783",-696,0,0,-696,7390,1902,764,10056,8.72,11.87
"1120524","1783",-814,0,3,-811,8067,1902,764,10733,9.52,12.67
"1120615","1783",89,0,-15,74,5564,1602,669,7835,6.56,9.24
"1120614","1783",-24,0,2,-22,5473,1602,684,7759,6.46,9.16
"1120613","1783",27,0,16,43,5493,1602,682,7777,6.48,9.18
"1120612","1783",-376,0,-46,-422,5437,1602,666,7705,6.41,9.09
"1120609","1783",6,0,0,6,5798,1602,712,8112,6.84,9.57
"1120608","1783",-295,0,-1,-296,5795,1602,712,8109,6.84,9.57
"1120607","1783",169,0,1,170,6090,1602,713,8405,7.18,9.91
"1120606","1783",-132,0,0,-132,5918,1602,712,8232,6.98,9.71
"1120605","1783",-56,0,6,-50,6055,1602,712,8369,7.14,9.87
"1120602","1783",-133,0,-4,-137,6113,1602,706,8421,7.21,9.93
"1120601","1783",-278,0,0,-278,6122,1602,710,8434,7.22,9.95
"1120531","1783",-212,0,34,-178,6333,1602,710,8645,7.47,10.20
"1120530","1783",-199,0,-77,-276,6546,1602,676,8824,7.72,10.41
"1120621","1783",-143,0,0,-143,5621,1602,619,7842,6.63,9.25
"1120620","1783",108,0,0,108,5764,1602,619,7985,6.80,9.42
"1120619","1783",-156,0,-39,-195,5656,1602,619,7877,6.67,9.29
"1120616","1783",248,0,-11,237,5812,1602,658,8072,6.86,9.53
"1120630","1783",250,0,13,263,5711,1602,658,7971,6.74,9.41
"1120629","1783",46,0,11,57,5462,1602,645,7709,6.44,9.09
"1120628","1783",-532,0,8,-524,5419,1602,634,7655,6.39,9.03
"1120627","1783",217,0,6,223,5951,1602,627,8180,7.02,9.65
"1120626","1783",130,0,2,132,5751,1602,621,7974,6.78,9.40
"1120706","1783",-60,0,-3,-63,6235,1602,688,8525,7.36,10.06
"1120705","1783",175,0,8,183,6367,1602,691,8660,7.51,10.22
"1120707","1783",357,0,36,393,6517,1602,724,8843,7.69,10.44
"1120703","1783",481,0,20,501,6192,1602,678,8472,7.31,10.00
"1120704","1783",14,0,4,18,6206,1602,682,8490,7.32,10.02
"1120710","1783",-29,0,121,92,6355,1602,845,8802,7.50,10.39
"1120711","1783",-121,0,0,-121,6260,1602,845,8707,7.39,10.28
"1120712","1783",-98,0,-58,-156,6140,1602,787,8529,7.24,10.06
"1120714","1783",-76,0,0,-76,6123,1602,703,8428,7.22,9.94
"1120719","1783",106,0,-1,105,5977,1602,620,8199,7.05,9.67
"1120720","1783",-335,0,-23,-358,5678,1602,597,7877,6.70,9.30
"1120713","1783",-33,0,-84,-117,6182,1602,703,8487,7.29,10.01
"1120718","1783",-438,0,-32,-470,5869,1602,621,8092,6.92,9.54
"1120717","1783",113,0,-50,63,6249,1602,653,8504,7.37,10.03
"1120721","1783",-382,0,-9,-391,5399,1598,588,7585,6.37,8.95
"1120727","1783",809,-200,3,612,6312,1398,633,8343,7.45,9.85
"1120726","1783",-93,0,18,-75,5443,1598,630,7671,6.42,9.05
"1120728","1783",-153,-89,17,-225,6175,1309,650,8134,7.29,9.60
"1120724","1783",-34,0,1,-33,5423,1598,589,7610,6.40,8.98
"1120725","1783",142,0,23,165,5557,1598,612,7767,6.56,9.17
"1120804","1783",9,-157,-26,-174,6006,998,674,7678,7.09,9.06
"1120810","1783",-186,0,2,-184,5756,998,576,7330,6.79,8.65
"1120818","1783",-134,0,0,-134,5323,998,637,6958,6.28,8.21
"1120809","1783",-33,0,-6,-39,5935,998,574,7507,7.00,8.86
"1120811","1783",-186,0,-19,-205,5570,998,557,7125,6.57,8.41
"1120802","1783",-286,-43,25,-304,6052,1155,700,7907,7.14,9.33
"1120731","1783",-278,-10,-4,-292,5897,1299,646,7842,6.96,9.26
"1120814","1783",-193,0,-6,-199,5379,998,552,6929,6.35,8.18
"1120817","1783",30,0,57,87,5444,998,637,7079,6.42,8.35
"1120807","1783",90,0,-46,44,6107,998,629,7734,7.21,9.13
"1120801","1783",441,-101,29,369,6338,1198,675,8211,7.48,9.69
"1120815","1783",35,0,5,40,5420,998,556,6974,6.39,8.22
"1120808","1783",-120,0,-48,-168,5956,998,581,7535,7.03,8.89
"1120816","1783",-28,0,23,-5,5392,998,580,6970,6.36,8.22
"1120822","1783",-112,0,-1,-113,5204,998,653,6855,6.14,8.09
"1120907","1783",-168,0,29,-139,5435,998,691,7124,6.41,8.31
"1120901","1783",90,0,36,126,5408,998,664,7070,6.38,8.34
"1120830","1783",112,0,16,128,5396,998,612,7006,6.37,8.27
"1120825","1783",-10,0,-1,-11,5379,998,631,7008,6.35,8.27
"1120904","1783",-8,0,2,-6,5401,998,666,7065,6.37,8.33
"1120829","1783",88,0,0,88,5422,998,596,7016,6.40,8.28
"1120908","1783",-48,0,0,-48,5386,998,691,7075,6.35,8.25
"1120906","1783",87,0,-4,83,5713,998,662,7373,6.74,8.70
"1120821","1783",-36,0,17,-19,5299,998,654,6951,6.25,8.20
"1120905","1783",225,0,0,225,5626,998,666,7290,6.64,8.60
"1120823","1783",17,0,-11,6,5227,998,641,6866,6.17,8.11
"1120831","1783",-48,0,16,-32,5382,998,628,7008,6.35,8.27
"1120824","1783",134,0,-10,124,5361,998,632,6991,6.33,8.25
"1120828","1783",-31,0,-35,-66,5331,998,596,6925,6.29,8.17
"1120914","1783",65,0,0,65,5440,943,606,6989,6.42,8.16
"1120919","1783",-27,-51,-2,-80,5535,812,602,6949,6.53,8.12
"1120921","1783",-49,-31,-7,-87,5511,748,596,6855,6.50,8.01
"1120911","1783",-84,0,-28,-112,5289,998,663,6950,6.24,8.11
"1120922","1783",26,0,0,26,5537,748,596,6881,6.53,8.04
"1120912","1783",-4,0,-31,-35,5287,998,632,6917,6.24,8.07
"1120920","1783",19,-33,1,-13,5554,779,603,6936,6.55,8.10
"1120915","1783",39,0,-1,38,5480,943,605,7028,6.47,8.21
"1120918","1783",84,-80,-1,3,5561,863,604,7028,6.56,8.21
"1120913","1783",88,-55,-26,7,5375,943,606,6924,6.34,8.08
"1120925","1783",88,0,0,88,5628,748,596,6972,6.64,8.15
"1121002","1783",30,0,0,30,5843,748,583,7174,6.89,8.39
"1121003","1783",-20,0,8,-12,5823,748,591,7162,6.87,8.38
"1120927","1783",52,0,-10,42,5664,748,584,6996,6.68,8.18
"1120928","1783",130,0,-1,129,5813,748,583,7144,6.86,8.36
"1121004","1783",-8,0,-5,-13,5766,748,586,7100,6.80,8.30
"1121011","1783",-352,0,-5,-357,5583,748,582,6913,6.59,8.09
"1121005","1783",9,0,0,9,5775,748,586,7109,6.81,8.31
"1120926","1783",-14,0,-2,-16,5618,748,594,6960,6.63,8.14
"1121006","1783",116,0,1,117,5891,748,587,7226,6.95,8.45
"1121025","1783",19,0,1,20,5504,198,576,6278,6.49,7.36
"1121016","1783",88,-180,1,-91,5649,260,573,6482,6.67,7.61
"1121026","1783",-63,0,-4,-67,5442,253,571,6266,6.42,7.35
"1121018","1783",4,-62,5,-53,5444,198,578,6220,6.42,7.29
"1121020","1783",-11,0,-1,-12,5455,198,573,6226,6.44,7.31
"1121012","1783",-74,-200,-8,-282,5559,548,574,6681,6.56,7.82
"1121024","1783",12,0,-1,11,5481,198,575,6254,6.47,7.34
"1121023","1783",34,0,3,37,5461,198,576,6235,6.44,7.31
"1121027","1783",15,0,0,15,5499,253,571,6323,6.49,7.42
"1121017","1783",-78,0,-1,-79,5587,260,572,6419,6.59,7.53
"1121013","1783",-89,-108,-2,-199,5483,440,572,6495,6.47,7.61
"1121019","1783",15,0,-4,11,5460,198,574,6232,6.44,7.31
"1121030","1783",-21,0,6,-15,5492,253,577,6322,6.48,7.41
"1121107","1783",-8,0,-4,-12,5571,253,578,6402,6.57,7.50
"1121108","1783",61,0,-1,60,5793,253,577,6623,6.51,7.44
"1121115","1783",66,-45,-22,-1,5637,158,506,6301,6.33,7.08
"1121106","1783",56,0,-8,48,5581,253,582,6416,6.58,7.52
"1121031","1783",9,0,2,11,5518,253,579,6350,6.51,7.45
"1121103","1783",-16,0,2,-14,5548,253,591,6392,6.55,7.50
"1121114","1783",-8,-50,-39,-97,5569,203,529,6301,6.26,7.08
"1121109","1783",-259,0,-2,-261,5581,253,575,6409,6.27,7.20
"1121101","1783",24,0,-1,23,5544,253,578,6375,6.54,7.47
"1121113","1783",-15,0,0,-15,5552,253,568,6373,6.24,7.16
"1121110","1783",-57,0,-7,-64,5562,253,568,6383,6.25,7.17
"1121102","1783",16,0,11,27,5563,253,589,6405,6.56,7.51
"1121130","1783",18,0,5,23,5781,3,504,6288,6.50,7.07
"1121116","1783",67,-35,1,33,5707,123,507,6337,6.41,7.12
"1121122","1783",-37,0,0,-37,5774,3,498,6275,6.49,7.05
"1121201","1783",115,0,0,115,5874,3,503,6380,6.60,7.17
"1121121","1783",41,-73,-1,-33,5867,3,498,6368,6.59,7.15
"1121127","1783",-77,0,0,-77,5753,3,497,6253,6.46,7.02
"1121120","1783",78,0,-1,77,5822,76,499,6397,6.54,7.19
"1121124","1783",-49,0,0,-49,5811,3,497,6311,6.53,7.09
"1121128","1783",-29,0,1,-28,5750,3,499,6252,6.46,7.02
"1121117","1783",85,-47,-7,31,5776,76,500,6352,6.49,7.14
"1121123","1783",71,0,-1,70,5849,3,497,6349,6.57,7.13
"1121129","1783",13,0,0,13,5763,3,499,6265,6.47,7.03
"1121205","1783",-151,0,0,-151,5810,3,503,6316,6.53,7.10
"1121211","1783",4,0,0,4,5729,3,503,6235,6.44,7.01
"1121204","1783",111,0,0,111,5988,3,503,6494,6.73,7.30
"1121213","1783",-41,0,0,-41,5728,3,497,6228,6.44,7.00
"1121206","1783",-54,0,0,-54,5785,3,503,6291,6.50,7.07
"1121219","1783",-46,0,0,-46,5728,3,495,6226,6.44,7.00
"1121212","1783",-64,0,-6,-70,5698,3,496,6197,6.40,6.96
"1121207","1783",-66,0,0,-66,5740,3,503,6246,6.45,7.02
"1121208","1783",-56,0,0,-56,5705,3,503,6211,6.41,6.98
"1121218","1783",-16,0,-2,-18,5753,3,495,6251,6.46,7.02
"1121215","1783",98,0,1,99,5834,3,498,6335,6.55,7.11
"1121214","1783",16,0,0,16,5721,3,497,6221,6.43,6.99
"1121227","1783",144,0,0,144,5936,3,500,6439,6.67,7.24
"1121220","1783",-21,0,0,-21,5725,3,495,6223,6.43,6.99
"1121226","1783",63,0,5,68,5791,3,500,6294,6.51,7.08
"1121228","1783",-7,0,-3,-10,5927,3,497,6427,6.66,7.22
"1121221","1783",13,0,-1,12,5748,3,494,6245,6.46,7.02
"1121222","1783",-12,0,1,-11,5740,3,495,6238,6.45,7.01
"1121225","1783",-26,0,0,-26,5726,3,495,6224,6.43,6.99
"1121229","1783",-25,0,-2,-27,5894,3,495,6392,6.62,7.18
"1130110","1783",-115,0,0,-115,5734,3,480,6217,6.44,6.98
"1130102","1783",56,0,-9,47,5951,3,486,6440,6.69,7.24
"1130111","1783",17,0,-2,15,5756,3,478,6237,6.47,7.01
"1130109","1783",-69,0,1,-68,5861,3,481,6345,6.58,7.12
"1130108","1783",-116,0,-1,-117,5853,3,480,6336,6.58,7.12
"1130104","1783",2,0,0,2,5962,3,481,6446,6.70,7.24
"1130112","1783",2,0,0,2,5762,3,478,6243,6.47,7.01
"1130103","1783",-24,0,-5,-29,5951,3,481,6435,6.69,7.23
"1130105","1783",-41,0,0,-41,5923,3,481,6407,6.65,7.19
"1130123","1783",43,0,1,44,5845,3,491,6339,6.57,7.13
"1130117","1783",-112,0,11,-101,5676,3,490,6169,6.38,6.93
"1130125","1783",-17,0,-1,-18,5721,3,487,6211,6.43,6.98
"1130115","1783",30,0,0,30,5814,3,478,6295,6.53,7.07
"1130124","1783",3,0,-3,0,5857,3,488,6348,6.58,7.13
"1130119","1783",17,0,0,17,5713,3,490,6206,6.42,6.97
"1130126","1783",58,0,1,59,5781,3,488,6272,6.50,7.05
"1130129","1783",21,0,0,21,5802,3,488,6293,6.52,7.07
"1130122","1783",70,0,0,70,5789,3,490,6282,6.50,7.05
"1130118","1783",18,0,0,18,5696,3,490,6189,6.40,6.95
"1130116","1783",-38,0,1,-37,5776,3,479,6258,6.49,7.03
"1130205","1783",-21,0,0,-21,5824,3,486,6313,6.54,7.09
"1130222","1783",15,0,1,16,5998,3,492,6493,6.74,7.30
"1130202","1783",-46,0,-2,-48,5834,3,487,6324,6.56,7.11
"1130201","1783",35,0,1,36,5862,3,489,6354,6.59,7.14
"1130219","1783",-15,0,3,-12,6063,3,491,6557,6.81,7.37
"1130215","1783",152,0,0,152,5988,3,486,6477,6.73,7.28
"1130130","1783",13,0,0,13,5825,3,488,6316,6.55,7.10
"1130131","1783",78,0,0,78,5903,3,488,6394,6.63,7.18
"1130220","1783",-12,0,-1,-13,5988,3,490,6481,6.73,7.28
"1130216","1783",102,0,2,104,6077,3,488,6568,6.83,7.38
"1130221","1783",-2,0,1,-1,5989,3,491,6483,6.73,7.29
"1130229","1783",46,0,1,47,6054,3,493,6550,6.80,7.36
"1130223","1783",-4,0,-1,-5,5997,3,491,6491,6.74,7.30
"1130313","1783",-52,0,-1,-53,6071,3,490,6564,6.82,7.37
"1130319","1783",-20,0,-1,-21,5984,3,489,6476,6.72,7.27
"1130301","1783",12,0,-1,11,6073,3,492,6568,6.82,7.38
"1130227","1783",-6,0,0,-6,6046,3,492,6541,6.79,7.35
"1130325","1783",40,0,0,40,6036,3,492,6531,6.78,7.34
"1130312","1783",132,0,-1,131,6123,3,491,6617,6.88,7.44
"1130226","1783",73,0,1,74,6070,3,493,6566,6.82,7.38
"1130314","1783",6,0,0,6,6047,3,490,6540,6.79,7.34
"1130307","1783",4,0,0,4,6046,3,493,6542,6.79,7.35
"1130304","1783",-9,0,0,-9,6069,3,493,6565,6.82,7.38
"1130321","1783",1,0,2,3,5994,3,492,6489,6.73,7.29
"1130305","1783",3,0,0,3,6062,3,493,6558,6.81,7.37
"1130306","1783",-6,0,0,-6,6042,3,493,6538,6.79,7.35
"1130320","1783",16,0,1,17,6000,3,490,6493,6.74,7.29
"1130308","1783",-62,0,0,-62,6025,3,492,6520,6.77,7.33
"1130326","1783",-11,0,1,-10,6025,3,493,6521,6.77,7.33
"1130311","1783",-5,0,0,-5,5988,3,492,6483,6.73,7.29
"1130322","1783",1,0,0,1,5996,3,492,6491,6.74,7.30
"1130318","1783",-27,0,0,-27,6009,3,490,6502,6.75,7.30
"1130327","1783",13,0,0,13,6038,3,493,6534,6.78,7.34
"1130315","1783",-8,0,0,-8,6039,3,490,6532,6.79,7.34
"1130328","1783",15,0,-1,14,6053,3,492,6548,6.80,7.36
"1130402","1783",-8,0,-1,-9,6097,3,491,6591,6.85,7.41
"1130403","1783",5,0,0,5,6102,3,491,6596,6.86,7.42
"1130401","1783",57,0,0,57,6105,3,492,6600,6.86,7.42
"1130408","1783",5,0,0,5,6107,3,491,6601,6.86,7.42
"1130329","1783",-2,0,0,-2,6048,3,492,6543,6.80,7.36
"1130412","1783",-8,0,-1,-9,6187,3,492,6682,6.95,7.51
"1130409","1783",44,0,0,44,6151,3,491,6645,6.91,7.47
"1130410","1783",44,0,1,45,6195,3,493,6691,6.96,7.52
"1130411","1783",0,0,0,0,6195,3,493,6691,6.96,7.52
"1130517","1783",78,0,1,79,6086,3,502,6591,6.84,7.41
"1130426","1783",-21,0,0,-21,6015,3,494,6512,6.76,7.32
"1130415","1783",-23,0,0,-23,6164,3,492,6659,6.93,7.49
"1130422","1783",30,0,4,34,6067,3,490,6560,6.82,7.37
"1130510","1783",60,0,-1,59,6031,3,505,6539,6.78,7.35
"1130416","1783",-76,0,0,-76,6091,3,492,6586,6.84,7.40
"1130507","1783",1,0,0,1,5959,3,497,6459,6.70,7.26
"1130430","1783",20,0,1,21,5961,3,497,6461,6.70,7.26
"1130429","1783",53,0,2,55,5943,3,496,6442,6.68,7.24
"1130502","1783",19,0,1,20,5987,3,497,6487,6.73,7.29
"1130418","1783",16,0,0,16,6104,3,490,6597,6.86,7.41
"1130425","1783",0,0,1,1,6044,3,494,6541,6.79,7.35
"1130515","1783",3,0,5,8,6011,3,501,6515,6.75,7.32
"1130521","1783",-16,0,0,-16,6098,3,504,6605,6.85,7.42
"1130516","1783",2,0,0,2,6017,3,501,6521,6.76,7.33
"1130509","1783",-7,0,8,1,5972,3,505,6480,6.71,7.28
"1130508","1783",34,0,0,34,5992,3,497,6492,6.73,7.29
"1130506","1783",7,0,0,7,5964,3,497,6464,6.70,7.26
"1130423","1783",20,0,2,22,6077,3,492,6572,6.83,7.39
"1130417","1783",-3,0,-1,-4,6088,3,491,6582,6.84,7.40
"1130513","1783",9,0,-9,0,6018,3,496,6517,6.76,7.32
"1130424","1783",7,0,1,8,6046,3,493,6542,6.79,7.35
"1130514","1783",-1,0,0,-1,6014,3,496,6513,6.76,7.32
"1130419","1783",-80,0,-4,-84,6021,3,486,6510,6.76,7.31
"1130503","1783",-50,0,0,-50,5957,3,497,6457,6.69,7.25
"1130520","1783",50,0,2,52,6129,3,504,6636,6.89,7.46
"1130527","1783",112,0,0,112,6169,3,503,6675,6.93,7.50
"1130530","1783",-12,0,-1,-13,6200,3,502,6705,6.97,7.54
"1130523","1783",-68,0,-2,-70,6051,3,502,6556,6.80,7.37
"1130529","1783",27,0,1,28,6296,3,504,6803,7.07,7.64
"1130528","1783",110,0,0,110,6279,3,503,6785,7.05,7.62
"1130522","1783",8,0,0,8,6093,3,504,6600,6.85,7.42
"1130524","1783",13,0,1,14,6061,3,503,6567,6.81,7.38
"1130619","1783",-46,0,3,-43,6239,3,497,6739,7.00,7.56
"1130606","1783",-48,0,-1,-49,6133,3,499,6635,6.88,7.44
"1130624","1783",-8,0,0,-8,6306,3,499,6808,7.07,7.63
"1130607","1783",63,0,-7,56,6178,3,492,6673,6.93,7.49
"1130627","1783",-26,0,-1,-27,6405,3,498,6906,7.19,7.75
"1130604","1783",-103,0,-5,-108,6119,3,501,6623,6.86,7.43
"1130531","1783",86,0,3,89,6206,3,506,6715,6.97,7.54
"1130620","1783",83,0,2,85,6289,3,499,6791,7.06,7.62
"1130618","1783",73,0,1,74,6316,3,494,6813,7.09,7.65
"1130611","1783",23,0,-1,22,6192,3,492,6687,6.95,7.51
"1130621","1783",33,0,0,33,6332,3,499,6834,7.10,7.66
"1130605","1783",49,0,-1,48,6181,3,500,6684,6.93,7.50
"1130625","1783",29,0,0,29,6311,3,499,6813,7.08,7.64
"1130603","1783",29,0,0,29,6151,3,506,6660,6.91,7.48
"1130628","1783",39,0,2,41,6442,3,500,6945,7.23,7.80
"1130617","1783",86,0,1,87,6241,3,494,6738,7.00,7.56
"1130613","1783",0,0,1,1,6175,3,492,6670,6.93,7.49
"1130614","1783",-5,0,0,-5,6155,3,492,6650,6.91,7.47
"1130612","1783",-25,0,0,-25,6176,3,491,6670,6.93,7.49
"1130626","1783",108,0,0,108,6419,3,499,6921,7.20,7.76
"1130703","1783",-66,0,2,-64,6165,3,503,6671,6.92,7.49
"1130702","1783",-298,0,0,-298,6177,3,501,6681,6.93,7.50
"1130712","1783",0,0,0,0,6097,3,504,6604,6.84,7.41
"1130716","1783",-93,0,-1,-94,5961,3,503,6467,6.69,7.26
"1130719","1783",-176,0,0,-176,5960,3,500,6463,6.69,7.26
"1130705","1783",-1,0,0,-1,6173,3,504,6680,6.93,7.50
"1130718","1783",106,0,0,106,6117,3,500,6620,6.86,7.43
"1130701","1783",-81,0,1,-80,6400,3,501,6904,7.18,7.75
"1130715","1783",-5,0,0,-5,6095,3,504,6602,6.84,7.41
"1130708","1783",-133,0,0,-133,6034,3,505,6542,6.77,7.34
"1130704","1783",-110,0,1,-109,6164,3,504,6671,6.92,7.49
"1130711","1783",-21,0,-2,-23,6122,3,504,6629,6.87,7.44
"1130717","1783",32,0,-3,29,5991,3,500,6494,6.72,7.29
"1130709","1783",306,0,1,307,6227,3,506,6736,6.99,7.56
"1130710","1783",45,0,0,45,6238,3,506,6747,7.00,7.57
"1130806","1783",62,0,11,73,5938,3,502,6443,6.66,7.23
"1130731","1783",-10,0,0,-10,5780,3,507,6290,6.48,7.05
"1130808","1783",33,0,-7,26,6084,3,487,6574,6.83,7.38
"1130722","1783",-12,0,3,-9,5969,3,503,6475,6.70,7.27
"1130809","1783",-10,0,-4,-14,6076,3,484,6563,6.82,7.37
"1130807","1783",105,0,-8,97,6059,3,494,6556,6.80,7.36
"1130801","1783",48,0,-1,47,5962,3,506,6471,6.69,7.26
"1130813","1783",-10,0,14,4,6049,3,499,6551,6.79,7.35
"1130729","1783",-16,0,9,-7,5730,3,507,6240,6.43,7.00
"1130805","1783",20,0,-14,6,5875,3,491,6369,6.59,7.14
"1130802","1783",-125,0,-1,-126,5841,3,505,6349,6.55,7.12
"1130723","1783",-18,0,0,-18,5712,3,503,6218,6.41,6.98
"1130812","1783",-19,0,1,-18,6063,3,485,6551,6.80,7.35
"1130726","1783",11,0,-5,6,5703,3,498,6204,6.40,6.96
"1130730","1783",35,0,0,35,5781,3,508,6292,6.49,7.06
"1130829","1783",30,0,0,30,6436,3,564,7003,7.22,7.86
"1130821","1783",112,0,0,112,6249,3,538,6790,7.01,7.62
"1130827","1783",132,0,3,135,6396,3,564,6963,7.18,7.82
"1130828","1783",50,0,0,50,6433,3,564,7000,7.22,7.86
"1130814","1783",19,0,25,44,6044,3,524,6571,6.78,7.37
"1130819","1783",32,0,-1,31,6037,3,540,6580,6.77,7.38
"1130823","1783",51,0,20,71,6307,3,558,6868,7.08,7.71
"1130822","1783",43,0,0,43,6280,3,538,6821,7.05,7.66
"1130816","1783",-36,0,4,-32,6010,3,541,6554,6.74,7.35
"1130820","1783",41,0,-2,39,6077,3,538,6618,6.82,7.43
"1130826","1783",-13,0,3,-10,6303,3,561,6867,7.07,7.70
"1130830","1783",-13,0,1,-12,6333,3,565,6901,7.10,7.74
"1130815","1783",3,0,13,16,6047,3,537,6587,6.78,7.39
